year,state,county_name,DEMOCRAT,OTHER,REPUBLICAN,TOTAL,DEMOCRAT_%,REPUBLICAN_%,OTHER_%
2000,ALABAMA,AUTAUGA,4942,273,11993,17208,0.2871920037192004,0.6969432821943282,0.01586471408647141
2000,ALABAMA,BALDWIN,13997,1611,40872,56480,0.24782223796033995,0.7236543909348442,0.028523371104815863
2000,ALABAMA,BARBOUR,5188,111,5096,10395,0.4990860990860991,0.49023569023569025,0.010678210678210679
2000,ALABAMA,BIBB,2710,118,4273,7101,0.381636389240952,0.6017462329249401,0.016617377834107872
2000,ALABAMA,BLOUNT,4977,329,12667,17973,0.2769153730595894,0.704779391309186,0.018305235631224614
2000,ALABAMA,BULLOCK,3395,76,1433,4904,0.6922920065252854,0.29221044045676997,0.015497553017944535
2000,ALABAMA,BUTLER,3606,70,4127,7803,0.46212995001922336,0.5288991413558888,0.008970908624887863
2000,ALABAMA,CALHOUN,15781,822,22306,38909,0.40558739623223417,0.5732863861831453,0.021126217584620525
2000,ALABAMA,CHAMBERS,5616,181,6037,11834,0.47456481324995775,0.5101402737873922,0.015294912962649992
2000,ALABAMA,CHEROKEE,3497,172,4154,7823,0.4470152115556692,0.5309983382334142,0.02198645021091653
2000,ALABAMA,CHILTON,4806,220,10066,15092,0.3184468592631858,0.6669758812615956,0.014577259475218658
2000,ALABAMA,CHOCTAW,3707,67,3600,7374,0.5027122321670735,0.4882017900732303,0.00908597775969623
2000,ALABAMA,CLARKE,4679,85,5988,10752,0.43517485119047616,0.5569196428571429,0.007905505952380952
2000,ALABAMA,CLAY,2045,119,3719,5883,0.34761176270610233,0.6321604623491416,0.020227774944756076
2000,ALABAMA,CLEBURNE,1664,95,3333,5092,0.3267871170463472,0.6545561665357423,0.018656716417910446
2000,ALABAMA,COFFEE,5220,276,9938,15434,0.3382143319942983,0.6439030711416354,0.017882596864066347
2000,ALABAMA,COLBERT,10543,471,10518,21532,0.4896433215678989,0.4884822589634033,0.021874419468697753
2000,ALABAMA,CONECUH,2783,69,2699,5551,0.5013511079084849,0.4862186993334534,0.012430192758061611
2000,ALABAMA,COOSA,2104,81,2382,4567,0.46069629954017954,0.5215677687760018,0.0177359316838187
2000,ALABAMA,COVINGTON,4440,212,8961,13613,0.3261588187761698,0.6582678322192023,0.015573349004627928
2000,ALABAMA,CRENSHAW,1934,68,2793,4795,0.4033368091762252,0.5824817518248175,0.014181438998957248
2000,ALABAMA,CULLMAN,9758,610,19157,29525,0.3304995766299746,0.648839966130398,0.020660457239627436
2000,ALABAMA,DALE,4906,307,10593,15806,0.3103884600784512,0.6701885359989878,0.019423003922561053
2000,ALABAMA,DALLAS,10967,137,7360,18464,0.5939666377816292,0.3986135181975737,0.007419844020797227
2000,ALABAMA,DEKALB,7056,402,12827,20285,0.3478432339166872,0.6323391668720729,0.019817599211239833
2000,ALABAMA,ELMORE,6652,375,16777,23804,0.2794488321290539,0.7047975130230213,0.01575365484792472
2000,ALABAMA,ESCAMBIA,4523,162,6975,11660,0.3879073756432247,0.5981989708404802,0.013893653516295026
2000,ALABAMA,ETOWAH,17433,828,21087,39348,0.4430466605672461,0.5359103385178408,0.021043000914913082
2000,ALABAMA,FAYETTE,3064,162,4582,7808,0.39241803278688525,0.5868340163934426,0.02074795081967213
2000,ALABAMA,FRANKLIN,4793,191,6119,11103,0.43168513014500587,0.551112311987751,0.017202557867243087
2000,ALABAMA,GENEVA,2769,202,6588,9559,0.28967465216026783,0.6891934302751334,0.02113191756459881
2000,ALABAMA,GREENE,3504,42,850,4396,0.7970882620564149,0.19335759781619655,0.009554140127388535
2000,ALABAMA,HALE,4652,95,2984,7731,0.6017332815935843,0.3859785280041392,0.01228819040227655
2000,ALABAMA,HENRY,2782,96,4054,6932,0.4013271783035199,0.5848240046162724,0.013848817080207732
2000,ALABAMA,HOUSTON,9412,495,22150,32057,0.29360202139938235,0.6909567333187759,0.01544124528184172
2000,ALABAMA,JACKSON,9066,365,8475,17906,0.506310733832235,0.47330503741762536,0.020384228750139618
2000,ALABAMA,JEFFERSON,129889,5383,138491,273763,0.4744578339658756,0.5058791728611974,0.019662993172926947
2000,ALABAMA,LAMAR,2653,126,4470,7249,0.3659815146916816,0.6166367774865499,0.01738170782176852
2000,ALABAMA,LAUDERDALE,13875,784,17478,32137,0.4317453402620033,0.5438591032143635,0.024395556523633195
2000,ALABAMA,LAWRENCE,6296,218,5671,12185,0.5167008617152237,0.4654082888797702,0.017890849405006154
2000,ALABAMA,LEE,14574,1257,22433,38264,0.38088020071085094,0.5862690779845285,0.03285072130462053
2000,ALABAMA,LIMESTONE,8992,438,14204,23634,0.3804688161123805,0.600998561394601,0.018532622493018534
2000,ALABAMA,LOWNDES,4557,48,1638,6243,0.7299375300336377,0.2623738587217684,0.0076886112445939455
2000,ALABAMA,MACON,7665,75,1091,8831,0.8679651228626429,0.12354206771600046,0.008492809421356586
2000,ALABAMA,MADISON,48199,2968,62151,113318,0.42534284050195026,0.5484653806103179,0.02619177888773187
2000,ALABAMA,MARENGO,4841,77,4690,9608,0.5038509575353872,0.48813488759367196,0.008014154870940883
2000,ALABAMA,MARION,4600,246,6910,11756,0.39128955427015993,0.5877849608710446,0.020925484858795508
2000,ALABAMA,MARSHALL,10381,524,17084,27989,0.3708957090285469,0.6103826503269142,0.018721640644538927
2000,ALABAMA,MOBILE,58640,2943,78162,139745,0.4196214533614798,0.5593187591684855,0.021059787470034706
2000,ALABAMA,MONROE,3741,57,5153,8951,0.41794212937102,0.5756898670539604,0.006368003575019551
2000,ALABAMA,MONTGOMERY,40371,1130,38827,80328,0.5025769345682701,0.4833557414600139,0.014067323971715964
2000,ALABAMA,MORGAN,16060,847,25774,42681,0.37627984349007754,0.6038752606546238,0.01984489585529861
2000,ALABAMA,PERRY,4020,35,1732,5787,0.6946604458268533,0.299291515465699,0.0060480387074477275
2000,ALABAMA,PICKENS,4143,91,4306,8540,0.4851288056206089,0.5042154566744731,0.010655737704918032
2000,ALABAMA,PIKE,4357,129,6058,10544,0.4132207890743551,0.5745447647951442,0.012234446130500759
2000,ALABAMA,RANDOLPH,3094,159,4666,7919,0.3907058972092436,0.5892158100770299,0.020078292713726482
2000,ALABAMA,RUSSELL,8396,181,6198,14775,0.5682571912013537,0.41949238578680204,0.012250423011844331
2000,ALABAMA,SHELBY,13183,1294,47651,62128,0.2121909605974762,0.7669810713365954,0.020827968065928407
2000,ALABAMA,ST. CLAIR,6485,488,17117,24090,0.2691988376919884,0.7105437941054379,0.02025736820257368
2000,ALABAMA,SUMTER,4415,44,1629,6088,0.7251971090670171,0.26757555847568987,0.007227332457293035
2000,ALABAMA,TALLADEGA,11264,380,13807,25451,0.4425759302188519,0.5424934187261797,0.01493065105496837
2000,ALABAMA,TALLAPOOSA,6183,265,9805,16253,0.3804220759244447,0.6032732418630407,0.01630468221251461
2000,ALABAMA,TUSCALOOSA,24614,1497,34003,60114,0.40945536813387895,0.5656419469674285,0.024902684898692483
2000,ALABAMA,WALKER,11621,534,13486,25641,0.4532194532194532,0.525954525954526,0.020826020826020825
2000,ALABAMA,WASHINGTON,3386,93,4117,7596,0.4457609268035808,0.5419957872564508,0.012243285939968405
2000,ALABAMA,WILCOX,3444,21,1661,5126,0.6718689036285603,0.3240343347639485,0.004096761607491221
2000,ALABAMA,WINSTON,2692,213,6413,9318,0.28890319811118265,0.6882378192745224,0.022858982614294913
2000,ALASKA,DISTRICT 1,1284,691,4681,6656,0.19290865384615385,0.7032752403846154,0.10381610576923077
2000,ALASKA,DISTRICT 10,2194,1017,5673,8884,0.24696082845565062,0.6385637100405223,0.1144754615038271
2000,ALASKA,DISTRICT 11,2043,977,3960,6980,0.2926934097421203,0.5673352435530086,0.13997134670487105
2000,ALASKA,DISTRICT 12,2051,924,4626,7601,0.269832916721484,0.6086041310353901,0.12156295224312591
2000,ALASKA,DISTRICT 13,2661,1429,3853,7943,0.3350119602165429,0.48508120357547524,0.17990683620798187
2000,ALASKA,DISTRICT 14,1626,492,3750,5868,0.2770961145194274,0.6390593047034765,0.08384458077709611
2000,ALASKA,DISTRICT 15,2106,1311,2453,5870,0.35877342419080066,0.4178875638841567,0.2233390119250426
2000,ALASKA,DISTRICT 16,1969,736,1980,4685,0.42027748132337245,0.4226254002134472,0.15709711846318036
2000,ALASKA,DISTRICT 17,2230,910,4564,7704,0.28946002076843197,0.5924195223260644,0.11812045690550363
2000,ALASKA,DISTRICT 18,2739,1722,5421,9882,0.277170613236187,0.5485731633272617,0.1742562234365513
2000,ALASKA,DISTRICT 19,2350,982,4619,7951,0.2955603068796378,0.5809332159476795,0.12350647717268268
2000,ALASKA,DISTRICT 2,2081,1072,4235,7388,0.28167298321602596,0.573226854358419,0.14510016242555496
2000,ALASKA,DISTRICT 20,2259,1056,3648,6963,0.3244291253769927,0.5239121068504955,0.15165876777251186
2000,ALASKA,DISTRICT 21,2309,1057,3263,6629,0.3483179966812491,0.4922311057474732,0.15945089757127773
2000,ALASKA,DISTRICT 22,2656,959,4910,8525,0.3115542521994135,0.5759530791788856,0.11249266862170088
2000,ALASKA,DISTRICT 23,1282,387,2961,4630,0.27688984881209505,0.639524838012959,0.08358531317494601
2000,ALASKA,DISTRICT 24,1985,867,5063,7915,0.25078963992419456,0.6396715097915351,0.10953885028427038
2000,ALASKA,DISTRICT 25,1697,1015,5489,8201,0.20692598463602,0.6693086208998903,0.12376539446408974
2000,ALASKA,DISTRICT 26,1608,1113,5869,8590,0.18719441210710128,0.6832363213038417,0.12956926658905704
2000,ALASKA,DISTRICT 27,2199,1525,6714,10438,0.21067254263268825,0.6432266717762023,0.1461007855911094
2000,ALASKA,DISTRICT 28,2116,1811,7113,11040,0.19166666666666668,0.6442934782608696,0.16403985507246377
2000,ALASKA,DISTRICT 29,2806,1963,4054,8823,0.31803241527825005,0.45948090218746457,0.22248668253428538
2000,ALASKA,DISTRICT 3,3693,1397,3135,8225,0.4489969604863222,0.3811550151975684,0.16984802431610943
2000,ALASKA,DISTRICT 30,1698,763,3622,6083,0.2791385829360513,0.5954298865691271,0.12543153049482164
2000,ALASKA,DISTRICT 31,1831,808,3326,5965,0.30695725062866724,0.5575859178541492,0.13545683151718357
2000,ALASKA,DISTRICT 32,1389,466,4178,6033,0.23023371456986574,0.6925244488645782,0.07724183656555611
2000,ALASKA,DISTRICT 33,1765,1143,5804,8712,0.2025941230486685,0.6662075298438935,0.13119834710743802
2000,ALASKA,DISTRICT 34,1300,611,5243,7154,0.1817165222253285,0.7328767123287672,0.08540676544590439
2000,ALASKA,DISTRICT 35,1208,896,4278,6382,0.1892823566280163,0.6703227828267001,0.1403948605452836
2000,ALASKA,DISTRICT 36,1945,625,3007,5577,0.3487538102922718,0.5391787699480007,0.11206741975972745
2000,ALASKA,DISTRICT 37,1821,482,2725,5028,0.36217183770883055,0.5419649960222752,0.0958631662688942
2000,ALASKA,DISTRICT 38,2015,494,2467,4976,0.404943729903537,0.4957797427652733,0.0992765273311897
2000,ALASKA,DISTRICT 39,2282,585,2321,5188,0.43986121819583657,0.447378565921357,0.11276021588280648
2000,ALASKA,DISTRICT 4,2715,981,4127,7823,0.3470535600153394,0.527546976863096,0.1253994631215646
2000,ALASKA,DISTRICT 40,1024,371,1831,3226,0.3174209547427154,0.5675759454432734,0.11500309981401116
2000,ALASKA,DISTRICT 5,1931,961,3545,6437,0.299984464812801,0.5507223862047538,0.14929314898244525
2000,ALASKA,DISTRICT 6,1542,696,3862,6100,0.25278688524590165,0.6331147540983607,0.11409836065573771
2000,ALASKA,DISTRICT 7,1893,1916,4868,8677,0.21816295954823095,0.5610233951826669,0.22081364526910222
2000,ALASKA,DISTRICT 8,1498,1109,5371,7978,0.18776635748307846,0.6732263725244422,0.1390072699924793
2000,ALASKA,DISTRICT 9,1203,808,4789,6800,0.17691176470588235,0.7042647058823529,0.1188235294117647
2000,ALASKA,DISTRICT 99,0,0,0,0,,,
2000,ARIZONA,APACHE,13025,484,5947,19456,0.6694592927631579,0.3056640625,0.024876644736842105
2000,ARIZONA,COCHISE,13360,1701,18180,33241,0.40191329984055835,0.5469149544237538,0.051171745735687856
2000,ARIZONA,COCONINO,20280,3041,17562,40883,0.4960497028104591,0.4295673018124893,0.07438299537705159
2000,ARIZONA,GILA,7700,878,9158,17736,0.4341452413170952,0.5163509246729815,0.04950383400992332
2000,ARIZONA,GRAHAM,3355,302,6007,9664,0.34716473509933776,0.6215852649006622,0.03125
2000,ARIZONA,GREENLEE,1216,125,1619,2960,0.41081081081081083,0.5469594594594595,0.04222972972972973
2000,ARIZONA,LA PAZ,1769,171,2543,4483,0.3946018291322775,0.567254070934642,0.03814409993308052
2000,ARIZONA,MARICOPA,386683,35049,479967,901699,0.42883822650352277,0.5322918180013508,0.038869955495126424
2000,ARIZONA,MOHAVE,17470,2285,24386,44141,0.39577716861874446,0.5524568994812079,0.05176593190004757
2000,ARIZONA,NAVAJO,11794,967,12386,25147,0.4690022666719688,0.49254384220781805,0.03845389112021315
2000,ARIZONA,PIMA,147688,15373,124579,287640,0.5134473647615074,0.4331073564177444,0.053445278820748156
2000,ARIZONA,PINAL,19650,1518,20122,41290,0.47590215548558973,0.4873334947929281,0.0367643497214822
2000,ARIZONA,SANTA CRUZ,5233,316,3344,8893,0.5884403463398178,0.3760260879343304,0.03553356572585179
2000,ARIZONA,YAVAPAI,24063,4021,40144,68228,0.3526851146157003,0.5883801371870786,0.05893474819722108
2000,ARIZONA,YUMA,12055,889,15708,28652,0.4207385173809856,0.548233980175904,0.03102750244311043
2000,ARKANSAS,ARKANSAS,2877,142,3353,6372,0.4515065913370998,0.5262084118016321,0.022284996861268048
2000,ARKANSAS,ASHLEY,4253,142,3876,8271,0.5142062628460887,0.4686253173739572,0.017168419779954057
2000,ARKANSAS,BAXTER,6516,654,9538,16708,0.38999281781182665,0.570864256643524,0.03914292554464927
2000,ARKANSAS,BENTON,17277,1531,34838,53646,0.3220556984677329,0.6494053610707229,0.028538940461544197
2000,ARKANSAS,BOONE,4493,573,8569,13635,0.3295196186285295,0.6284561789512284,0.042024202420242025
2000,ARKANSAS,BRADLEY,2122,64,1793,3979,0.5332998240764011,0.4506157325961297,0.016084443327469212
2000,ARKANSAS,CALHOUN,1017,40,1128,2185,0.4654462242562929,0.5162471395881006,0.018306636155606407
2000,ARKANSAS,CARROLL,3595,439,5556,9590,0.3748696558915537,0.5793534932221064,0.04577685088633994
2000,ARKANSAS,CHICOT,2820,68,1564,4452,0.633423180592992,0.35130278526504943,0.015274034141958671
2000,ARKANSAS,CLARK,4661,189,3776,8626,0.5403431486204499,0.43774634824947833,0.021910503130071875
2000,ARKANSAS,CLAY,3527,119,2254,5900,0.5977966101694915,0.3820338983050847,0.02016949152542373
2000,ARKANSAS,CLEBURNE,4120,357,5730,10207,0.40364455765651025,0.5613794454785931,0.03497599686489664
2000,ARKANSAS,CLEVELAND,1414,89,1678,3181,0.44451430367808864,0.5275070732474064,0.027978623074504872
2000,ARKANSAS,COLUMBIA,4003,286,5018,9307,0.430106371548297,0.5391640700547975,0.030729558396905554
2000,ARKANSAS,CONWAY,3496,193,3545,7234,0.4832734310201825,0.4900470002764722,0.026679568703345313
2000,ARKANSAS,CRAIGHEAD,12376,623,12158,25157,0.4919505505425925,0.48328497038597606,0.024764479071431412
2000,ARKANSAS,CRAWFORD,6288,533,10804,17625,0.3567659574468085,0.6129929078014185,0.03024113475177305
2000,ARKANSAS,CRITTENDEN,7224,153,5857,13234,0.5458667069669034,0.4425721626114553,0.011561130421641226
2000,ARKANSAS,CROSS,3096,86,3033,6215,0.49814963797264683,0.48801287208366856,0.013837489943684634
2000,ARKANSAS,DALLAS,1710,44,1571,3325,0.5142857142857142,0.4724812030075188,0.013233082706766918
2000,ARKANSAS,DESHA,2776,116,1603,4495,0.617575083426029,0.35661846496106786,0.025806451612903226
2000,ARKANSAS,DREW,3060,106,2756,5922,0.5167173252279635,0.46538331644714626,0.01789935832489024
2000,ARKANSAS,FAULKNER,11950,1211,16055,29216,0.4090224534501643,0.5495276560788609,0.04144989047097481
2000,ARKANSAS,FRANKLIN,2674,189,3277,6140,0.43550488599348536,0.53371335504886,0.030781758957654722
2000,ARKANSAS,FULTON,1976,96,2036,4108,0.4810126582278481,0.495618305744888,0.023369036027263874
2000,ARKANSAS,GARLAND,15840,997,19098,35935,0.4407958814526228,0.5314595797968554,0.027744538750521776
2000,ARKANSAS,GRANT,2535,193,3285,6013,0.4215865624480293,0.5463163146515883,0.0320971229003825
2000,ARKANSAS,GREENE,6319,334,5831,12484,0.506167894905479,0.46707785966036525,0.026754245434155718
2000,ARKANSAS,HEMPSTEAD,3937,95,3257,7289,0.5401289614487584,0.44683770064480727,0.013033337906434354
2000,ARKANSAS,HOT SPRING,5527,412,5042,10981,0.503323923139969,0.45915672525270923,0.03751935160732174
2000,ARKANSAS,HOWARD,2063,70,2326,4459,0.46265978919040146,0.52164162368244,0.015698587127158554
2000,ARKANSAS,INDEPENDENCE,5146,303,6145,11594,0.44385026737967914,0.5300155252716923,0.0261342073486286
2000,ARKANSAS,IZARD,2587,144,2301,5032,0.5141096979332274,0.4572734499205087,0.028616852146263912
2000,ARKANSAS,JACKSON,3651,141,2280,6072,0.6012845849802372,0.37549407114624506,0.023221343873517788
2000,ARKANSAS,JEFFERSON,17716,720,8765,27201,0.6512995845740965,0.3222308003382229,0.0264696150876806
2000,ARKANSAS,JOHNSON,3270,234,3657,7161,0.4566401340594889,0.5106828655215752,0.032677000418935905
2000,ARKANSAS,LAFAYETTE,1806,39,1538,3383,0.5338456990836535,0.4546260715341413,0.011528229382205143
2000,ARKANSAS,LAWRENCE,3255,159,2626,6040,0.5389072847682119,0.4347682119205298,0.02632450331125828
2000,ARKANSAS,LEE,2727,43,1351,4121,0.6617325891773841,0.32783305023052656,0.010434360592089298
2000,ARKANSAS,LINCOLN,1957,63,1526,3546,0.5518894529046813,0.43034404963338974,0.017766497461928935
2000,ARKANSAS,LITTLE RIVER,2883,97,2283,5263,0.5477864335930078,0.4337830134904047,0.018430552916587496
2000,ARKANSAS,LOGAN,3283,326,4487,8096,0.4055088932806324,0.5542243083003953,0.040266798418972335
2000,ARKANSAS,LONOKE,6851,486,10606,17943,0.38182020843783093,0.5910940199520704,0.027085771610098647
2000,ARKANSAS,MADISON,2055,186,3387,5628,0.36513859275053306,0.6018123667377399,0.03304904051172708
2000,ARKANSAS,MARION,2233,380,3402,6015,0.371238570241064,0.5655860349127182,0.06317539484621779
2000,ARKANSAS,MILLER,6278,191,7276,13745,0.45674790833030193,0.5293561295016369,0.013895962168061113
2000,ARKANSAS,MISSISSIPPI,7107,280,5199,12586,0.5646750357540123,0.4130780232003814,0.02224694104560623
2000,ARKANSAS,MONROE,1910,54,1329,3293,0.5800182204676587,0.4035833586395384,0.016398420892802915
2000,ARKANSAS,MONTGOMERY,1438,173,2128,3739,0.38459481144691093,0.5691361326557903,0.046269055897298746
2000,ARKANSAS,NEVADA,1867,75,1796,3738,0.4994649545211343,0.48047084002140183,0.020064205457463884
2000,ARKANSAS,NEWTON,1205,193,2529,3927,0.3068500127323657,0.6440030557677616,0.049146931499872676
2000,ARKANSAS,OUACHITA,5464,192,4739,10395,0.5256373256373257,0.4558922558922559,0.01847041847041847
2000,ARKANSAS,PERRY,1648,245,2114,4007,0.41128025954579484,0.5275767407037684,0.06114299975043674
2000,ARKANSAS,PHILLIPS,6018,141,3154,9313,0.6461934929668206,0.33866638032857294,0.015140126704606464
2000,ARKANSAS,PIKE,1604,92,2275,3971,0.40392848149080834,0.5729035507428859,0.023167967766305718
2000,ARKANSAS,POINSETT,4102,145,2988,7235,0.5669661368348307,0.41299239806496196,0.020041465100207326
2000,ARKANSAS,POLK,2315,278,4600,7193,0.3218406784373697,0.6395106353399138,0.03864868622271653
2000,ARKANSAS,POPE,6669,509,11244,18422,0.36201281076973185,0.610357181630659,0.027630007599609162
2000,ARKANSAS,PRAIRIE,1563,82,1862,3507,0.44568006843455943,0.530938123752495,0.023381807812945538
2000,ARKANSAS,PULASKI,68320,2965,55866,127151,0.5373139023680505,0.4393673663596826,0.023318731272266833
2000,ARKANSAS,RANDOLPH,3019,185,2673,5877,0.5136974646928705,0.4548238897396631,0.03147864556746639
2000,ARKANSAS,SALINE,12700,1074,18617,32391,0.3920842209255657,0.5747584205489179,0.03315735852551635
2000,ARKANSAS,SCOTT,1444,138,2399,3981,0.3627229339361969,0.6026124089424768,0.0346646571213263
2000,ARKANSAS,SEARCY,1229,219,2610,4058,0.3028585510103499,0.6431739773287334,0.053967471660916706
2000,ARKANSAS,SEBASTIAN,15555,1121,23483,40159,0.3873353420154884,0.5847506163002066,0.027914041684304888
2000,ARKANSAS,SEVIER,2095,87,2111,4293,0.4880037269974377,0.49173072443512694,0.02026554856743536
2000,ARKANSAS,SHARP,3236,192,3698,7126,0.4541117036205445,0.5189447095144541,0.026943586865001402
2000,ARKANSAS,ST. FRANCIS,4986,96,3414,8496,0.586864406779661,0.4018361581920904,0.011299435028248588
2000,ARKANSAS,STONE,2043,194,2623,4860,0.4203703703703704,0.5397119341563786,0.03991769547325103
2000,ARKANSAS,UNION,6261,701,8647,15609,0.4011147414952912,0.5539752706771734,0.04490998782753539
2000,ARKANSAS,VAN BUREN,3202,297,3485,6984,0.45847651775486825,0.49899770904925544,0.04252577319587629
2000,ARKANSAS,WASHINGTON,21425,1803,28231,51459,0.4163508812841291,0.5486115159641657,0.03503760275170524
2000,ARKANSAS,WHITE,8342,638,13170,22150,0.3766139954853273,0.5945823927765237,0.028803611738148983
2000,ARKANSAS,WOODRUFF,1699,54,898,2651,0.6408902301018483,0.33874009807619765,0.02036967182195398
2000,ARKANSAS,YELL,3062,194,3223,6479,0.4726037968822349,0.49745331069609505,0.02994289242167001
2000,CALIFORNIA,ALAMEDA,342889,32168,119279,494336,0.6936355029777318,0.2412913483946142,0.06507314862765406
2000,CALIFORNIA,ALPINE,265,40,281,586,0.4522184300341297,0.47952218430034127,0.06825938566552901
2000,CALIFORNIA,AMADOR,5906,792,8766,15464,0.38191929643041905,0.5668649767201241,0.0512157268494568
2000,CALIFORNIA,BUTTE,31338,6799,45584,83721,0.37431468807109325,0.544475101826304,0.0812102101026027
2000,CALIFORNIA,CALAVERAS,7093,1184,10599,18876,0.37576817122271666,0.5615066751430388,0.06272515363424454
2000,CALIFORNIA,COLUSA,1745,216,3629,5590,0.31216457960644006,0.6491949910554562,0.03864042933810376
2000,CALIFORNIA,CONTRA COSTA,224338,15767,141373,381478,0.5880758523427301,0.3705927995847729,0.04133134807249697
2000,CALIFORNIA,DEL NORTE,3117,651,4526,8294,0.3758138413310827,0.5456956836267182,0.07849047504219918
2000,CALIFORNIA,EL DORADO,26220,3871,42045,72136,0.3634800931573694,0.5828573805034934,0.053662526339137186
2000,CALIFORNIA,FRESNO,95059,8434,117342,220835,0.43045260035773314,0.531355989766115,0.038191409876151876
2000,CALIFORNIA,GLENN,2498,418,5795,8711,0.2867638617839513,0.665250832281024,0.04798530593502468
2000,CALIFORNIA,HUMBOLDT,24851,7902,23219,55972,0.4439898520688916,0.41483241620810407,0.14117773172300435
2000,CALIFORNIA,IMPERIAL,15489,924,12524,28937,0.5352662680996648,0.4328022946400802,0.03193143726025504
2000,CALIFORNIA,INYO,2652,450,4713,7815,0.3393474088291747,0.6030710172744722,0.05758157389635317
2000,CALIFORNIA,KERN,66003,5642,110663,182308,0.3620411611119644,0.6070112117954232,0.030947627092612503
2000,CALIFORNIA,KINGS,11041,917,16377,28335,0.3896594317981295,0.5779777660137639,0.03236280218810658
2000,CALIFORNIA,LAKE,10717,1503,8699,20919,0.5123093838137578,0.41584205745972563,0.07184855872651656
2000,CALIFORNIA,LASSEN,2982,524,7080,10586,0.28169280181371625,0.6688078594369923,0.049499338749291515
2000,CALIFORNIA,LOS ANGELES,1710505,112719,871930,2695154,0.6346594665833567,0.32351769138238484,0.041822842034258526
2000,CALIFORNIA,MADERA,11650,1462,20283,33395,0.34885461895493336,0.6073663722114089,0.043779008833657734
2000,CALIFORNIA,MARIN,79135,9148,34872,123155,0.6425642483049815,0.2831553733100564,0.07428037838496204
2000,CALIFORNIA,MARIPOSA,2816,531,4727,8074,0.34877384196185285,0.5854594996284369,0.06576665840971017
2000,CALIFORNIA,MENDOCINO,16634,5504,12272,34410,0.48340598663179307,0.35664051147922116,0.15995350188898577
2000,CALIFORNIA,MERCED,22726,1590,26102,50418,0.4507517156571066,0.5177119282795827,0.03153635606331072
2000,CALIFORNIA,MODOC,945,193,2969,4107,0.23009495982468955,0.7229121012904797,0.046992938884830776
2000,CALIFORNIA,MONO,1788,287,2296,4371,0.40905971173644473,0.5252802562342713,0.06566003202928392
2000,CALIFORNIA,MONTEREY,67618,6155,43761,117534,0.5753058689400514,0.37232630557966206,0.05236782548028655
2000,CALIFORNIA,NAPA,28097,2994,20633,51724,0.5432101152269739,0.3989057304152811,0.05788415435774495
2000,CALIFORNIA,NEVADA,17670,3811,25998,47479,0.37216453590008214,0.5475683986604604,0.08026706543945744
2000,CALIFORNIA,ORANGE,391819,37787,541299,970905,0.4035605955268538,0.5575200457305297,0.03891935874261643
2000,CALIFORNIA,PLACER,42449,5515,69835,117799,0.36035110654589597,0.5928318576558375,0.046817035798266536
2000,CALIFORNIA,PLUMAS,3458,600,6343,10401,0.3324680319200077,0.6098452071916162,0.05768676088837612
2000,CALIFORNIA,RIVERSIDE,202576,16596,231955,451127,0.4490442824304464,0.5141678507382622,0.03678786683129141
2000,CALIFORNIA,SACRAMENTO,212792,23139,195619,431550,0.49308770710230565,0.4532939404472251,0.05361835245046924
2000,CALIFORNIA,SAN BENITO,9131,685,7015,16831,0.5425108430871606,0.4167904462004634,0.04069871071237597
2000,CALIFORNIA,SAN BERNARDINO,214749,18387,221757,454893,0.47208684240030074,0.4874926631097863,0.040420494489913014
2000,CALIFORNIA,SAN DIEGO,437666,45232,475736,958634,0.45655171838261527,0.4962644763277747,0.047183805289610005
2000,CALIFORNIA,SAN FRANCISCO,241578,26712,51496,319786,0.7554364481246834,0.16103269061184666,0.08353086126346995
2000,CALIFORNIA,SAN JOAQUIN,79776,5690,81773,167239,0.47701792046113645,0.4889589150855961,0.03402316445326748
2000,CALIFORNIA,SAN LUIS OBISPO,44526,7501,56859,108886,0.40892309387800085,0.5221883437723858,0.06888856234961335
2000,CALIFORNIA,SAN MATEO,166757,12346,80296,259399,0.6428590703896314,0.30954629740284273,0.047594632207525855
2000,CALIFORNIA,SANTA BARBARA,73411,10070,71493,154974,0.47369881399460556,0.4613225444268071,0.06497864157858738
2000,CALIFORNIA,SANTA CLARA,332490,26889,188750,548129,0.6065907842861809,0.344353245312691,0.049055970401128204
2000,CALIFORNIA,SANTA CRUZ,66618,12105,29627,108350,0.6148407937240424,0.2734379326257499,0.11172127365020766
2000,CALIFORNIA,SHASTA,20127,3139,43278,66544,0.3024615292137533,0.6503666746814138,0.047171796104832894
2000,CALIFORNIA,SIERRA,540,135,1172,1847,0.292365998917163,0.6345425013535463,0.07309149972929074
2000,CALIFORNIA,SISKIYOU,6323,1298,12198,19819,0.3190372874514355,0.6154700035319642,0.06549270901660023
2000,CALIFORNIA,SOLANO,75116,5015,51604,131735,0.5702053364709455,0.39172581318556193,0.03806885034349262
2000,CALIFORNIA,SONOMA,117295,16182,63529,197006,0.5953879577271758,0.3224724120077561,0.08213963026506807
2000,CALIFORNIA,STANISLAUS,56448,4631,67188,128267,0.44008201641887623,0.5238136075529949,0.036104376028128826
2000,CALIFORNIA,SUTTER,8416,798,17350,26564,0.31681975606083423,0.6531395874115344,0.030040656527631382
2000,CALIFORNIA,TEHAMA,6507,1077,13270,20854,0.3120264697420159,0.6363287618682267,0.05164476838975736
2000,CALIFORNIA,TRINITY,1932,525,3340,5797,0.3332758323270657,0.576160082801449,0.09056408487148525
2000,CALIFORNIA,TULARE,33006,2742,54070,89818,0.3674764523814826,0.6019951457391615,0.030528401879356033
2000,CALIFORNIA,TUOLUMNE,9359,1196,13172,23727,0.3944451468790829,0.5551481434652505,0.05040670965566654
2000,CALIFORNIA,VENTURA,133258,13261,136173,282692,0.4713893566142657,0.48170093246359996,0.046909710922134334
2000,CALIFORNIA,YOLO,33747,4632,23057,61436,0.5493033400612019,0.3753011263754151,0.07539553356338304
2000,CALIFORNIA,YUBA,5546,743,9838,16127,0.3438953308116823,0.6100328641408818,0.04607180504743598
2000,COLORADO,ADAMS,54132,6159,47561,107852,0.5019100248488669,0.4409839409561251,0.057106034195007975
2000,COLORADO,ALAMOSA,2455,347,2857,5659,0.43382223007598514,0.5048595158155151,0.06131825410849973
2000,COLORADO,ARAPAHOE,82614,9560,97768,189942,0.4349432984805888,0.5147255477988018,0.05033115372060945
2000,COLORADO,ARCHULETA,1432,338,2988,4758,0.30096679277007143,0.6279949558638083,0.07103825136612021
2000,COLORADO,BACA,531,84,1663,2278,0.233099209833187,0.7300263388937664,0.03687445127304653
2000,COLORADO,BENT,783,84,1096,1963,0.3988792664289353,0.5583290881304126,0.04279164544065207
2000,COLORADO,BOULDER,69983,18770,50873,139626,0.5012175382808359,0.36435191153510094,0.13443055018406314
2000,COLORADO,CHAFFEE,2768,542,4300,7610,0.36373193166885676,0.5650459921156373,0.07122207621550591
2000,COLORADO,CHEYENNE,209,46,957,1212,0.17244224422442245,0.7896039603960396,0.037953795379537955
2000,COLORADO,CLEAR CREEK,2188,489,2247,4924,0.44435418359057677,0.456336311941511,0.09930950446791227
2000,COLORADO,CONEJOS,1749,150,1772,3671,0.476436938163988,0.4827022609643149,0.040860800871697085
2000,COLORADO,COSTILLA,1054,90,504,1648,0.6395631067961165,0.3058252427184466,0.05461165048543689
2000,COLORADO,CROWLEY,511,79,855,1445,0.35363321799307956,0.5916955017301038,0.05467128027681661
2000,COLORADO,CUSTER,507,153,1451,2111,0.24017053529133112,0.6873519658929418,0.07247749881572714
2000,COLORADO,DELTA,3264,1050,8372,12686,0.25729150244363863,0.659940091439382,0.08276840611697935
2000,COLORADO,DENVER,122693,14430,61224,198347,0.6185775433961693,0.30867116719688226,0.07275128940694843
2000,COLORADO,DOLORES,293,100,741,1134,0.2583774250440917,0.6534391534391535,0.08818342151675485
2000,COLORADO,DOUGLAS,27076,3142,56007,86225,0.3140156567120905,0.6495447955929254,0.03643954769498405
2000,COLORADO,EAGLE,6772,1251,7165,15188,0.44587832499341584,0.4717540163286805,0.0823676586779036
2000,COLORADO,EL PASO,61799,10664,128294,200757,0.30782986396489287,0.6390511912411523,0.05311894479395488
2000,COLORADO,ELBERT,2326,488,6151,8965,0.25945343000557725,0.6861126603457892,0.05443390964863357
2000,COLORADO,FREMONT,5293,849,9914,16056,0.3296586945690085,0.6174638764324863,0.052877428998505234
2000,COLORADO,GARFIELD,6087,1914,9103,17104,0.3558816651075772,0.5322146866230122,0.11190364826941067
2000,COLORADO,GILPIN,1099,360,1006,2465,0.445841784989858,0.4081135902636917,0.1460446247464503
2000,COLORADO,GRAND,2308,475,3570,6353,0.3632929324728475,0.5619392413033213,0.07476782622383125
2000,COLORADO,GUNNISON,3059,1049,3128,7236,0.42274737423991154,0.43228302929795465,0.14496959646213378
2000,COLORADO,HINSDALE,188,62,316,566,0.3321554770318021,0.558303886925795,0.10954063604240283
2000,COLORADO,HUERFANO,1495,213,1466,3174,0.47101449275362317,0.461877756773787,0.0671077504725898
2000,COLORADO,JACKSON,173,70,682,925,0.18702702702702703,0.7372972972972973,0.07567567567567568
2000,COLORADO,JEFFERSON,100970,14383,120138,235491,0.4287637319472931,0.5101596239346726,0.061076644118034235
2000,COLORADO,KIOWA,211,29,728,968,0.21797520661157024,0.7520661157024794,0.029958677685950414
2000,COLORADO,KIT CARSON,809,107,2542,3458,0.23395026026604973,0.735106998264893,0.030942741469057258
2000,COLORADO,LA PLATA,7864,2633,9993,20490,0.38379697413372377,0.487701317715959,0.12850170815031722
2000,COLORADO,LAKE,1296,276,1056,2628,0.4931506849315068,0.4018264840182648,0.1050228310502283
2000,COLORADO,LARIMER,46055,10053,62429,118537,0.38852847634072063,0.5266625610568851,0.08480896260239419
2000,COLORADO,LAS ANIMAS,3243,282,2569,6094,0.5321627830653102,0.42156219232031505,0.04627502461437479
2000,COLORADO,LINCOLN,510,59,1630,2199,0.23192360163710776,0.7412460209185994,0.026830377444292862
2000,COLORADO,LOGAN,2296,269,5531,8096,0.283596837944664,0.6831768774703557,0.03322628458498024
2000,COLORADO,MESA,15465,3193,32396,51054,0.3029145610530027,0.6345438163513143,0.06254162259568301
2000,COLORADO,MINERAL,168,24,294,486,0.345679012345679,0.6049382716049383,0.04938271604938271
2000,COLORADO,MOFFAT,1223,274,3840,5337,0.22915495596777216,0.7195053400786959,0.05133970395353195
2000,COLORADO,MONTEZUMA,2556,670,6158,9384,0.27237851662404094,0.6562233589087809,0.07139812446717818
2000,COLORADO,MONTROSE,4041,908,9266,14215,0.28427717200140695,0.651846640872318,0.06387618712627506
2000,COLORADO,MORGAN,2885,391,5722,8998,0.3206268059568793,0.6359190931318071,0.043454100911313624
2000,COLORADO,OTERO,2963,267,4082,7312,0.40522428884026257,0.5582603938730853,0.036515317286652076
2000,COLORADO,OURAY,705,249,1279,2233,0.31571876399462606,0.5727720555306762,0.11150918047469771
2000,COLORADO,PARK,2393,595,3677,6665,0.359039759939985,0.5516879219804951,0.08927231807951988
2000,COLORADO,PHILLIPS,564,83,1573,2220,0.25405405405405407,0.7085585585585585,0.03738738738738739
2000,COLORADO,PITKIN,4137,1098,2565,7800,0.5303846153846153,0.32884615384615384,0.14076923076923076
2000,COLORADO,PROWERS,1361,137,3026,4524,0.30083996463306806,0.6688770999115826,0.03028293545534925
2000,COLORADO,PUEBLO,28888,2231,22827,53946,0.5354984614243874,0.423145367589812,0.04135617098580061
2000,COLORADO,RIO BLANCO,543,127,2185,2855,0.1901926444833625,0.7653239929947461,0.04448336252189142
2000,COLORADO,RIO GRANDE,1707,257,3111,5075,0.3363546798029557,0.6130049261083744,0.05064039408866995
2000,COLORADO,ROUTT,4208,958,4472,9638,0.4366051047935256,0.46399667980908904,0.09939821539738534
2000,COLORADO,SAGUACHE,1145,306,1078,2529,0.4527481217872677,0.4262554369315935,0.12099644128113879
2000,COLORADO,SAN JUAN,149,77,210,436,0.34174311926605505,0.481651376146789,0.17660550458715596
2000,COLORADO,SAN MIGUEL,1598,614,1043,3255,0.490937019969278,0.3204301075268817,0.18863287250384025
2000,COLORADO,SEDGWICK,384,42,877,1303,0.29470452801227937,0.6730621642363775,0.03223330775134305
2000,COLORADO,SUMMIT,5304,1267,4497,11068,0.4792193711601012,0.4063064691001084,0.11447415973979039
2000,COLORADO,TELLER,2750,620,6477,9847,0.2792728749873058,0.6577637859246471,0.06296333908804712
2000,COLORADO,WASHINGTON,477,90,1878,2445,0.1950920245398773,0.7680981595092025,0.03680981595092025
2000,COLORADO,WELD,23436,3696,37409,64541,0.36311801800405946,0.5796160580096373,0.05726592398630328
2000,COLORADO,YUMA,1082,120,3156,4358,0.24827902707664065,0.7241854061496099,0.027535566773749427
2000,CONNECTICUT,FAIRFIELD,193769,16861,159659,370289,0.52329126709138,0.43117402893415685,0.045534703974463187
2000,CONNECTICUT,HARTFORD,221167,18921,127468,367556,0.6017232748207076,0.3467988551404412,0.05147787003885122
2000,CONNECTICUT,LITCHFIELD,41806,6360,39172,87338,0.4786690787515171,0.44851038494126266,0.07282053630722023
2000,CONNECTICUT,MIDDLESEX,43319,4819,29295,77433,0.5594384823008278,0.37832706985393827,0.062234447845233944
2000,CONNECTICUT,NEW HAVEN,197928,20252,122919,341099,0.5802655534023846,0.36036165453431407,0.05937279206330127
2000,CONNECTICUT,NEW LONDON,60449,7530,41168,109147,0.55383107185722,0.37717940025836716,0.06898952788441276
2000,CONNECTICUT,STATEWIDE WRITEIN,0,0,0,0,,,
2000,CONNECTICUT,TOLLAND,33554,4441,24705,62700,0.5351515151515152,0.3940191387559809,0.07082934609250399
2000,CONNECTICUT,WINDHAM,24023,3232,16708,43963,0.5464367763801379,0.38004685758478723,0.07351636603507494
2000,DELAWARE,KENT,22790,1376,24081,48247,0.47236097581196757,0.49911911621447963,0.02851990797355276
2000,DELAWARE,NEW CASTLE,127539,6869,78587,212995,0.5987887039601869,0.36896171271626094,0.0322495833235522
2000,DELAWARE,SUSSEX,29739,1928,34620,66287,0.44864000482749256,0.5222743524371295,0.02908564273537798
2000,DISTRICT OF COLUMBIA,DISTRICT OF COLUMBIA,171923,11898,18073,201894,0.8515508137933767,0.08951727143946824,0.05893191476715504
2000,FLORIDA,ALACHUA,47365,4240,34124,85729,0.5524968213789966,0.39804500227460954,0.04945817634639387
2000,FLORIDA,BAKER,2392,152,5610,8154,0.2933529556046112,0.6880058866813834,0.018641157714005395
2000,FLORIDA,BAY,18850,1318,38637,58805,0.32055097355667034,0.6570359663293938,0.02241306011393589
2000,FLORIDA,BRADFORD,3075,184,5414,8673,0.3545485991006572,0.6242361351320189,0.02121526576732388
2000,FLORIDA,BREVARD,97318,5892,115185,218395,0.44560543968497446,0.5274159206941551,0.02697863962087044
2000,FLORIDA,BROWARD,387703,9538,177902,575143,0.6740984416049574,0.30931785660261885,0.016583701792423796
2000,FLORIDA,CALHOUN,2155,146,2873,5174,0.416505604947816,0.5552763819095478,0.028218013142636257
2000,FLORIDA,CHARLOTTE,29645,1825,35426,66896,0.4431505620664913,0.5295682850992586,0.02728115283425018
2000,FLORIDA,CITRUS,25525,1914,29767,57206,0.44619445512708455,0.5203475159948258,0.03345802887808971
2000,FLORIDA,CLAY,14632,985,41736,57353,0.2551217896186773,0.7277038690216728,0.01717434135964989
2000,FLORIDA,COLLIER,29921,1791,60450,92162,0.3246565829734598,0.6559102450033636,0.01943317202317658
2000,FLORIDA,COLUMBIA,7047,497,10964,18508,0.3807542684244651,0.5923924789280312,0.02685325264750378
2000,FLORIDA,DESOTO,3320,241,4256,7817,0.4247153639503646,0.5444543942689011,0.030830241780734298
2000,FLORIDA,DIXIE,1826,143,2697,4666,0.39134162023146163,0.578011144449207,0.030647235319331334
2000,FLORIDA,DUVAL,107864,4674,152098,264636,0.40759382699254826,0.574744176907148,0.017661996100303813
2000,FLORIDA,ESCAMBIA,40943,2688,73017,116648,0.35099615938550166,0.6259601536245799,0.023043686989918388
2000,FLORIDA,FLAGLER,13897,601,12613,27111,0.5125963630998488,0.46523551326030027,0.022168123639850983
2000,FLORIDA,FRANKLIN,2046,144,2454,4644,0.4405684754521964,0.5284237726098191,0.031007751937984496
2000,FLORIDA,GADSDEN,9735,225,4767,14727,0.6610307598288857,0.3236911794662864,0.015278060704827868
2000,FLORIDA,GILCHRIST,1910,185,3300,5395,0.3540315106580167,0.6116774791473587,0.03429101019462465
2000,FLORIDA,GLADES,1442,82,1841,3365,0.42852897473997026,0.5471025260029718,0.02436849925705795
2000,FLORIDA,GULF,2397,197,3550,6144,0.39013671875,0.5777994791666666,0.032063802083333336
2000,FLORIDA,HAMILTON,1722,96,2146,3964,0.43440968718466194,0.541372351160444,0.024217961654894045
2000,FLORIDA,HARDEE,2339,129,3765,6233,0.3752607091288304,0.6040429969517086,0.020696293919460932
2000,FLORIDA,HENDRY,3240,152,4747,8139,0.3980833026170291,0.5832411844206905,0.01867551296228038
2000,FLORIDA,HERNANDO,32644,1929,30646,65219,0.5005289869516552,0.46989374262101535,0.02957727042732946
2000,FLORIDA,HIGHLANDS,14167,776,20206,35149,0.40305556345841986,0.574866994793593,0.02207744174798714
2000,FLORIDA,HILLSBOROUGH,169557,9978,180760,360295,0.47060603116890326,0.5016999958367448,0.02769397299435185
2000,FLORIDA,HOLMES,2177,207,5011,7395,0.29438810006761323,0.6776200135226504,0.027991886409736308
2000,FLORIDA,INDIAN RIVER,19768,1219,28635,49622,0.39837168997622024,0.5770625932046269,0.024565716819152796
2000,FLORIDA,JACKSON,6868,294,9138,16300,0.42134969325153376,0.5606134969325154,0.01803680981595092
2000,FLORIDA,JEFFERSON,3041,125,2478,5644,0.5388022678951099,0.4390503189227498,0.022147413182140325
2000,FLORIDA,LAFAYETTE,789,46,1670,2505,0.3149700598802395,0.6666666666666666,0.018363273453093812
2000,FLORIDA,LAKE,36571,2030,50010,88611,0.41271399713353873,0.5643768832312015,0.022909119635259732
2000,FLORIDA,LEE,73560,4676,106141,184377,0.39896516376771507,0.5756737554033312,0.02536108082895372
2000,FLORIDA,LEON,61427,2635,39062,103124,0.5956615336875994,0.3787867033862147,0.02555176292618595
2000,FLORIDA,LEVY,5398,468,6858,12724,0.4242376611128576,0.5389814523734675,0.03678088651367494
2000,FLORIDA,LIBERTY,1017,76,1317,2410,0.4219917012448133,0.5464730290456431,0.03153526970954357
2000,FLORIDA,MADISON,3014,110,3038,6162,0.48912690684842586,0.4930217461863031,0.017851346965271016
2000,FLORIDA,MANATEE,49177,3092,57952,110221,0.4461672458061531,0.5257800237704249,0.028052730423422035
2000,FLORIDA,MARION,44665,3150,55141,102956,0.4338261004701037,0.535578305295466,0.030595594234430243
2000,FLORIDA,MARTIN,26620,1423,33970,62013,0.42926483156757456,0.5477883669553159,0.02294680147710964
2000,FLORIDA,MIAMI-DADE,328808,7108,289533,625449,0.5257151262532996,0.4629202381009483,0.011364635645752092
2000,FLORIDA,MONROE,16483,1354,16059,33896,0.48628156714656595,0.473772716544725,0.039945716308708995
2000,FLORIDA,NASSAU,6952,424,16404,23780,0.29234650967199327,0.6898233809924306,0.017830109335576116
2000,FLORIDA,OKALOOSA,16948,1639,52093,70680,0.23978494623655913,0.7370260328239955,0.023189020939445387
2000,FLORIDA,OKEECHOBEE,4588,208,5057,9853,0.46564498122399267,0.5132446970465848,0.02111032172942251
2000,FLORIDA,ORANGE,140220,5388,134517,280125,0.5005622489959839,0.48020348058902274,0.019234270414993305
2000,FLORIDA,OSCEOLA,28181,1266,26212,55659,0.5063152410212185,0.47093911137462047,0.022745647604161052
2000,FLORIDA,PALM BEACH,269732,10503,152951,433186,0.6226701693960562,0.3530838946780367,0.024245935925907115
2000,FLORIDA,PASCO,69564,4585,68582,142731,0.4873783550875423,0.4804982799812234,0.03212336493123428
2000,FLORIDA,PINELLAS,200630,13017,184825,398472,0.5034983637495232,0.46383434720632816,0.032667289044148645
2000,FLORIDA,POLK,75200,3112,90295,168607,0.4460075797564751,0.5355352980599857,0.018457122183539235
2000,FLORIDA,PUTNAM,12102,673,13447,26222,0.4615208603462741,0.51281366791244,0.025665471741285945
2000,FLORIDA,SANTA ROSA,12802,1243,36274,50319,0.25441682068403587,0.7208807806196467,0.024702398696317494
2000,FLORIDA,SARASOTA,72853,4989,83100,160942,0.45266617787774477,0.5163350772327919,0.030998744889463286
2000,FLORIDA,SEMINOLE,59174,2783,75677,137634,0.4299373701265676,0.5498423354694334,0.02022029440399901
2000,FLORIDA,ST. JOHNS,19502,1698,39546,60746,0.321041714680802,0.6510058275442004,0.02795245777499753
2000,FLORIDA,ST. LUCIE,41559,1725,34705,77989,0.5328828424521407,0.4449986536562849,0.022118503891574454
2000,FLORIDA,SUMTER,9637,497,12127,22261,0.4329095727954719,0.544764386146175,0.022326041058353174
2000,FLORIDA,SUWANNEE,4075,392,8006,12473,0.3267056842780406,0.6418664314920227,0.03142788422993666
2000,FLORIDA,TAYLOR,2649,103,4056,6808,0.38910105757931845,0.5957696827262045,0.015129259694477086
2000,FLORIDA,UNION,1407,87,2332,3826,0.36774699424986934,0.6095138525875589,0.022739153162571878
2000,FLORIDA,VOLUSIA,97304,3993,82357,183654,0.5298223833948621,0.4484356452895118,0.021741971315626125
2000,FLORIDA,WAKULLA,3838,237,4512,8587,0.44695469896354956,0.5254454407825783,0.027599860253872132
2000,FLORIDA,WALTON,5642,494,12182,18318,0.30800305710230375,0.6650289332896604,0.02696800960803581
2000,FLORIDA,WASHINGTON,2798,237,4994,8029,0.3484867355835098,0.6219952671565575,0.029517997259932743
2000,GEORGIA,APPLING,2093,66,3940,6099,0.3431710116412527,0.6460075422200361,0.010821446138711265
2000,GEORGIA,ATKINSON,821,22,1228,2071,0.3964268469338484,0.5929502655721873,0.010622887493964268
2000,GEORGIA,BACON,956,29,2010,2995,0.3191986644407346,0.671118530884808,0.009682804674457429
2000,GEORGIA,BAKER,893,11,615,1519,0.5878867676102699,0.4048716260697828,0.007241606319947334
2000,GEORGIA,BALDWIN,5893,192,6041,12126,0.4859805376876134,0.49818571664192646,0.01583374567046017
2000,GEORGIA,BANKS,1220,111,3202,4533,0.26913743657621886,0.7063754687844694,0.024487094639311716
2000,GEORGIA,BARROW,3657,520,7925,12102,0.30218145761031234,0.6548504379441414,0.04296810444554619
2000,GEORGIA,BARTOW,7508,553,14720,22781,0.32957288968877574,0.6461524955006365,0.02427461481058777
2000,GEORGIA,BEN HILL,2234,46,2381,4661,0.47929628835013943,0.5108345848530358,0.009869126796824716
2000,GEORGIA,BERRIEN,1640,52,2718,4410,0.37188208616780044,0.6163265306122448,0.011791383219954649
2000,GEORGIA,BIBB,24996,709,24071,49776,0.5021697203471552,0.48358646737383476,0.014243812279009964
2000,GEORGIA,BLECKLEY,1273,40,2436,3749,0.33955721525740196,0.6497732728727661,0.010669511869831956
2000,GEORGIA,BRANTLEY,1372,76,3118,4566,0.3004818221638195,0.6828734121769602,0.016644765659220323
2000,GEORGIA,BROOKS,2096,49,2406,4551,0.46055811909470445,0.5286750164798946,0.01076686442540101
2000,GEORGIA,BRYAN,2172,52,4835,7059,0.3076923076923077,0.6849412098030883,0.007366482504604052
2000,GEORGIA,BULLOCH,5561,231,8990,14782,0.3762007847381951,0.6081721012041672,0.015627114057637666
2000,GEORGIA,BURKE,3720,34,3381,7135,0.5213735108619482,0.47386124737210933,0.004765241765942537
2000,GEORGIA,BUTTS,2281,156,3198,5635,0.40479148181011537,0.5675244010647738,0.027684117125110912
2000,GEORGIA,CALHOUN,1107,12,768,1887,0.5866454689984102,0.4069952305246423,0.006359300476947536
2000,GEORGIA,CAMDEN,3636,112,6371,10119,0.35932404387785355,0.6296076687419706,0.011068287380175906
2000,GEORGIA,CANDLER,1053,26,1643,2722,0.38684790595150625,0.603600293901543,0.009551800146950772
2000,GEORGIA,CARROLL,8752,663,16326,25741,0.340002330911775,0.634241093974593,0.025756575113631948
2000,GEORGIA,CATOOSA,5470,218,12033,17721,0.308673325433102,0.6790248857287964,0.012301788838101688
2000,GEORGIA,CHARLTON,1015,31,1770,2816,0.3604403409090909,0.6285511363636364,0.011008522727272728
2000,GEORGIA,CHATHAM,37590,1038,37847,76475,0.49153318077803204,0.4948937561294541,0.013573063092513894
2000,GEORGIA,CHATTAHOOCHEE,600,17,590,1207,0.4971002485501243,0.4888152444076222,0.014084507042253521
2000,GEORGIA,CHATTOOGA,2729,108,3640,6477,0.4213370387525089,0.5619885749575421,0.01667438628994905
2000,GEORGIA,CHEROKEE,12295,2020,38033,52348,0.23487048215786657,0.7265416061740658,0.03858791166806755
2000,GEORGIA,CLARKE,15167,1887,11850,28904,0.5247370606144478,0.4099778577359535,0.06528508164959868
2000,GEORGIA,CLAY,821,8,448,1277,0.6429130775254502,0.350822239624119,0.006264682850430697
2000,GEORGIA,CLAYTON,40042,1394,19966,61402,0.6521285951597667,0.3251685612846487,0.02270284355558451
2000,GEORGIA,CLINCH,816,22,1091,1929,0.4230171073094868,0.5655780196993261,0.011404872991187144
2000,GEORGIA,COBB,86676,7857,140494,235027,0.3687916707442124,0.5977781276193799,0.03343020163640773
2000,GEORGIA,COFFEE,3593,81,5756,9430,0.38101802757158004,0.6103923647932131,0.008589607635206787
2000,GEORGIA,COLQUITT,3297,86,6589,9972,0.3306257521058965,0.6607501002807862,0.008624147613317288
2000,GEORGIA,COLUMBIA,8969,379,26660,36008,0.2490835369917796,0.7403910242168407,0.010525438791379694
2000,GEORGIA,COOK,1639,26,2279,3944,0.4155679513184584,0.5778397565922921,0.006592292089249493
2000,GEORGIA,COWETA,9056,843,21327,31226,0.29001473131364885,0.6829885351950298,0.026996733491321336
2000,GEORGIA,CRAWFORD,1513,67,1987,3567,0.42416596579758903,0.5570507429212224,0.018783291281188674
2000,GEORGIA,CRISP,2268,56,3285,5609,0.40435015154216436,0.5856658940987698,0.009983954359065787
2000,GEORGIA,DADE,1628,88,3333,5049,0.3224400871459695,0.6601307189542484,0.017429193899782137
2000,GEORGIA,DAWSON,1458,230,4210,5898,0.24720244150559512,0.7138012885723974,0.038996269922007464
2000,GEORGIA,DECATUR,3398,63,4187,7648,0.4442991631799163,0.547463389121339,0.00823744769874477
2000,GEORGIA,DEKALB,154509,6664,58807,219980,0.7023774888626239,0.2673288480770979,0.030293663060278208
2000,GEORGIA,DODGE,2326,79,3472,5877,0.39578015994555044,0.5907776076229369,0.013442232431512676
2000,GEORGIA,DOOLY,1901,31,1588,3520,0.5400568181818182,0.4511363636363636,0.008806818181818181
2000,GEORGIA,DOUGHERTY,16650,166,12248,29064,0.5728736581337738,0.4214148086980457,0.005711533168180567
2000,GEORGIA,DOUGLAS,11162,909,18893,30964,0.360483141712957,0.6101601860224777,0.0293566722645653
2000,GEORGIA,EARLY,1622,25,1938,3585,0.45244072524407253,0.5405857740585774,0.00697350069735007
2000,GEORGIA,ECHOLS,272,12,614,898,0.3028953229398664,0.6837416481069042,0.013363028953229399
2000,GEORGIA,EFFINGHAM,3232,92,7326,10650,0.30347417840375585,0.6878873239436619,0.00863849765258216
2000,GEORGIA,ELBERT,2527,64,3262,5853,0.43174440457884844,0.5573210319494276,0.010934563471723903
2000,GEORGIA,EMANUEL,2835,85,3343,6263,0.4526584703816063,0.5337697589014849,0.01357177071690883
2000,GEORGIA,EVANS,1217,22,1841,3080,0.3951298701298701,0.5977272727272728,0.007142857142857143
2000,GEORGIA,FANNIN,2736,191,5463,8390,0.3261025029797378,0.6511323003575685,0.022765196662693683
2000,GEORGIA,FAYETTE,11912,1199,29338,42449,0.2806190958562039,0.691135244646517,0.02824565949727909
2000,GEORGIA,FLOYD,10282,349,16194,26825,0.3832991612301957,0.603690587138863,0.013010251630941286
2000,GEORGIA,FORSYTH,6694,1292,27769,35755,0.18721857082925464,0.776646622849951,0.03613480632079429
2000,GEORGIA,FRANKLIN,2040,63,3659,5762,0.35404373481430057,0.6350225616105519,0.010933703575147518
2000,GEORGIA,FULTON,152039,6303,104870,263212,0.577629439387262,0.3984240840083279,0.023946476604410134
2000,GEORGIA,GILMER,2230,199,4941,7370,0.30257801899592945,0.6704206241519675,0.02700135685210312
2000,GEORGIA,GLASCOCK,249,8,763,1020,0.24411764705882352,0.7480392156862745,0.00784313725490196
2000,GEORGIA,GLYNN,7778,260,14346,22384,0.34748034310221587,0.64090421729807,0.011615439599714082
2000,GEORGIA,GORDON,4032,229,7944,12205,0.33035641130684146,0.6508807865628841,0.018762802130274477
2000,GEORGIA,GRADY,2721,88,3894,6703,0.405937639862748,0.5809339101894674,0.013128449947784573
2000,GEORGIA,GREENE,2137,80,2980,5197,0.4111987685203002,0.5734077352318645,0.01539349624783529
2000,GEORGIA,GWINNETT,61434,7921,121756,191111,0.32145716363788585,0.6370957192416973,0.04144711712041693
2000,GEORGIA,HABERSHAM,2530,197,6964,9691,0.26106696935300794,0.7186048911361057,0.02032813951088639
2000,GEORGIA,HALL,10259,1050,26841,38150,0.2689121887287025,0.703564875491481,0.027522935779816515
2000,GEORGIA,HANCOCK,2414,10,662,3086,0.7822423849643552,0.21451717433570966,0.0032404406999351912
2000,GEORGIA,HARALSON,2869,145,5153,8167,0.35129178400881594,0.6309538386188319,0.017754377372352147
2000,GEORGIA,HARRIS,2912,96,5554,8562,0.34010745153001637,0.64868021490306,0.011212333566923615
2000,GEORGIA,HART,3192,102,4242,7536,0.42356687898089174,0.5628980891719745,0.013535031847133758
2000,GEORGIA,HEARD,1178,73,1947,3198,0.3683552220137586,0.6088180112570356,0.022826766729205753
2000,GEORGIA,HENRY,11971,1081,25815,38867,0.30799907376437596,0.6641881287467517,0.027812797488872307
2000,GEORGIA,HOUSTON,13301,513,23174,36988,0.3596031145236293,0.6265275224397102,0.013869363036660538
2000,GEORGIA,IRWIN,1105,27,1720,2852,0.38744740532959326,0.603085553997195,0.009467040673211781
2000,GEORGIA,JACKSON,3420,337,7878,11635,0.293940696175333,0.6770949720670391,0.028964331757627845
2000,GEORGIA,JASPER,1558,87,2298,3943,0.3951306112097388,0.5828049708343901,0.022064417955871163
2000,GEORGIA,JEFF DAVIS,1379,45,2797,4221,0.32669983416252074,0.6626391850272447,0.010660980810234541
2000,GEORGIA,JEFFERSON,2973,34,2559,5566,0.5341358246496587,0.45975565936040247,0.006108515989938915
2000,GEORGIA,JENKINS,1250,26,1317,2593,0.4820671037408407,0.5079059005013498,0.010026995757809487
2000,GEORGIA,JOHNSON,1065,21,1797,2883,0.36940686784599375,0.6233090530697191,0.007284079084287201
2000,GEORGIA,JONES,3102,116,4850,8068,0.3844819038175508,0.6011403073872087,0.014377788795240456
2000,GEORGIA,LAMAR,2194,124,2912,5230,0.41950286806883363,0.5567877629063097,0.023709369024856597
2000,GEORGIA,LANIER,832,24,1048,1904,0.4369747899159664,0.5504201680672269,0.012605042016806723
2000,GEORGIA,LAURENS,5724,179,8133,14036,0.4078084924479909,0.5794385864918781,0.012752921060131091
2000,GEORGIA,LEE,1936,76,5872,7884,0.24556062912227294,0.7447995941146626,0.009639776763064434
2000,GEORGIA,LIBERTY,5347,170,4455,9972,0.5362013638186923,0.44675090252707583,0.017047733654231848
2000,GEORGIA,LINCOLN,1275,21,1807,3103,0.41089268449887206,0.5823396712858524,0.00676764421527554
2000,GEORGIA,LONG,975,19,1320,2314,0.42134831460674155,0.5704407951598963,0.008210890233362144
2000,GEORGIA,LOWNDES,10616,354,14462,25432,0.4174268637936458,0.5686536646744259,0.01391947153192828
2000,GEORGIA,LUMPKIN,2121,202,4427,6750,0.31422222222222224,0.6558518518518518,0.029925925925925925
2000,GEORGIA,MACON,2757,32,1566,4355,0.633065442020666,0.3595866819747417,0.0073478760045924225
2000,GEORGIA,MADISON,2285,179,5529,7993,0.2858751407481546,0.6917302639809834,0.022394595270862003
2000,GEORGIA,MARION,982,15,1187,2184,0.44963369963369965,0.5434981684981685,0.006868131868131868
2000,GEORGIA,MCDUFFIE,2580,44,3926,6550,0.3938931297709924,0.5993893129770992,0.006717557251908397
2000,GEORGIA,MCINTOSH,2047,24,1766,3837,0.5334897054990878,0.4602554078707323,0.006254886630179828
2000,GEORGIA,MERIWETHER,3441,106,3162,6709,0.5128931286331793,0.4713071992845432,0.015799672082277536
2000,GEORGIA,MILLER,783,18,1349,2150,0.3641860465116279,0.6274418604651163,0.008372093023255815
2000,GEORGIA,MITCHELL,2971,38,2790,5799,0.5123297120193137,0.4811174340403518,0.00655285394033454
2000,GEORGIA,MONROE,2839,141,4561,7541,0.37647526853202495,0.6048269460283782,0.01869778543959687
2000,GEORGIA,MONTGOMERY,1013,31,1465,2509,0.4037465125548027,0.5838979673176564,0.012355520127540853
2000,GEORGIA,MORGAN,2238,140,3524,5902,0.3791934937309387,0.5970857336496103,0.023720772619451033
2000,GEORGIA,MURRAY,2684,149,5539,8372,0.32059245102723366,0.6616101290014333,0.017797419971333016
2000,GEORGIA,MUSCOGEE,28193,491,23479,52163,0.5404788834997987,0.45010831432241244,0.009412802177788854
2000,GEORGIA,NEWTON,6703,545,11127,18375,0.3647891156462585,0.6055510204081632,0.029659863945578232
2000,GEORGIA,OCONEE,3184,373,7611,11168,0.2851002865329513,0.6815007163323782,0.03339899713467049
2000,GEORGIA,OGLETHORPE,1519,160,2706,4385,0.34640820980615733,0.6171037628278221,0.036488027366020526
2000,GEORGIA,PAULDING,6743,636,16881,24260,0.2779472382522671,0.6958367683429514,0.026215993404781535
2000,GEORGIA,PEACH,3540,72,3525,7137,0.49600672551492225,0.4939050021017234,0.01008827238335435
2000,GEORGIA,PICKENS,2489,224,5488,8201,0.3034995732227777,0.6691866845506645,0.027313742226557736
2000,GEORGIA,PIERCE,1300,33,3348,4681,0.27771843623157444,0.7152317880794702,0.007049775688955351
2000,GEORGIA,PIKE,1413,114,3358,4885,0.28925281473899694,0.6874104401228249,0.023336745138178096
2000,GEORGIA,POLK,4112,163,5841,10116,0.40648477659153814,0.5774021352313167,0.016113088177145116
2000,GEORGIA,PULASKI,1390,34,1922,3346,0.415421398684997,0.5744172145845786,0.010161386730424387
2000,GEORGIA,PUTNAM,2612,91,3596,6299,0.4146689950785839,0.5708842673440229,0.014446737577393237
2000,GEORGIA,QUITMAN,542,14,348,904,0.5995575221238938,0.38495575221238937,0.015486725663716814
2000,GEORGIA,RABUN,1776,114,3451,5341,0.3325219996255383,0.6461336828309305,0.021344317543531173
2000,GEORGIA,RANDOLPH,1381,14,1174,2569,0.5375632541845076,0.45698715453483846,0.005449591280653951
2000,GEORGIA,RICHMOND,31413,640,25485,57538,0.5459522402586117,0.44292467586638395,0.011123083875004346
2000,GEORGIA,ROCKDALE,8295,914,15440,24649,0.3365248083086535,0.6263945799018216,0.03708061178952493
2000,GEORGIA,SCHLEY,460,10,706,1176,0.391156462585034,0.6003401360544217,0.008503401360544218
2000,GEORGIA,SCREVEN,2233,25,2461,4719,0.4731934731934732,0.521508794236067,0.005297732570459843
2000,GEORGIA,SEMINOLE,1313,27,1537,2877,0.45637817170663886,0.5342370524852277,0.009384775808133473
2000,GEORGIA,SPALDING,5831,289,9271,15391,0.3788577740237801,0.6023650185173153,0.018777207458904554
2000,GEORGIA,STEPHENS,2869,137,5370,8376,0.34252626552053483,0.6411174785100286,0.016356255969436486
2000,GEORGIA,STEWART,1267,12,675,1954,0.6484135107471852,0.34544524053224157,0.006141248720573183
2000,GEORGIA,SUMTER,4748,102,4847,9697,0.4896359698875941,0.4998453129833969,0.010518717129008972
2000,GEORGIA,TALBOT,1662,25,844,2531,0.6566574476491506,0.33346503358356383,0.009877518767285659
2000,GEORGIA,TALIAFERRO,556,5,271,832,0.6682692307692307,0.32572115384615385,0.006009615384615385
2000,GEORGIA,TATTNALL,1963,50,3597,5610,0.3499108734402852,0.6411764705882353,0.008912655971479501
2000,GEORGIA,TAYLOR,1340,28,1412,2780,0.48201438848920863,0.5079136690647482,0.010071942446043165
2000,GEORGIA,TELFAIR,1777,23,1693,3493,0.5087317492127111,0.48468365302032634,0.006584597766962496
2000,GEORGIA,TERRELL,1584,25,1504,3113,0.508833922261484,0.4831352393189849,0.008030838419530999
2000,GEORGIA,THOMAS,4862,103,7093,12058,0.4032177807264886,0.5882401724995854,0.008542046773926025
2000,GEORGIA,TIFT,3547,103,6678,10328,0.34343532145623545,0.6465917893106119,0.009972889233152595
2000,GEORGIA,TOOMBS,2643,80,4487,7210,0.3665742024965326,0.6223300970873786,0.011095700416088766
2000,GEORGIA,TOWNS,1495,100,2902,4497,0.33244385145652655,0.6453191016233044,0.022237046920169
2000,GEORGIA,TREUTLEN,879,22,1062,1963,0.4477840040753948,0.5410086602139582,0.011207335710646969
2000,GEORGIA,TROUP,6379,227,11198,17804,0.3582902718490227,0.6289597843181307,0.012749943832846552
2000,GEORGIA,TURNER,1169,29,1258,2456,0.4759771986970684,0.512214983713355,0.011807817589576547
2000,GEORGIA,TWIGGS,1977,68,1570,3615,0.5468879668049793,0.4343015214384509,0.018810511756569847
2000,GEORGIA,UNION,2230,159,4567,6956,0.32058654399079933,0.6565554916618747,0.022857964347326048
2000,GEORGIA,UPSON,3158,105,5019,8282,0.38130886259357644,0.6060130403284231,0.012678097078000484
2000,GEORGIA,WALKER,6341,228,12326,18895,0.33559142630325484,0.6523418893887272,0.012066684308017994
2000,GEORGIA,WALTON,5484,633,12966,19083,0.28737619871089454,0.6794529162081434,0.033170885080962116
2000,GEORGIA,WARE,3480,49,6099,9628,0.3614457831325301,0.6334648940589946,0.00508932280847528
2000,GEORGIA,WARREN,1196,16,933,2145,0.5575757575757576,0.43496503496503497,0.007459207459207459
2000,GEORGIA,WASHINGTON,3476,53,3162,6691,0.5195038110895233,0.4725751008817815,0.007921088028695263
2000,GEORGIA,WAYNE,2736,49,5219,8004,0.34182908545727136,0.6520489755122438,0.006121939030484758
2000,GEORGIA,WEBSTER,541,9,359,909,0.5951595159515951,0.3949394939493949,0.009900990099009901
2000,GEORGIA,WHEELER,752,10,813,1575,0.4774603174603175,0.5161904761904762,0.006349206349206349
2000,GEORGIA,WHITE,2014,172,4857,7043,0.28595768848502057,0.6896209001845804,0.024421411330398976
2000,GEORGIA,WHITFIELD,7034,416,15852,23302,0.30186250107286927,0.6802849540811947,0.017852544845935972
2000,GEORGIA,WILCOX,962,22,1381,2365,0.40676532769556023,0.5839323467230444,0.009302325581395349
2000,GEORGIA,WILKES,1940,42,2044,4026,0.48186785891703926,0.5076999503229012,0.010432190760059613
2000,GEORGIA,WILKINSON,1884,56,1800,3740,0.5037433155080214,0.48128342245989303,0.014973262032085561
2000,GEORGIA,WORTH,2214,55,3792,6061,0.36528625639333445,0.6256393334433262,0.009074410163339383
2000,HAWAII,HAWAII,28670,5140,17050,50860,0.563704286276052,0.3352339756193472,0.10106173810460087
2000,HAWAII,HONOLULU,139618,15062,101310,255990,0.5454041173483339,0.39575764678307745,0.05883823586858861
2000,HAWAII,KAUAI,13470,1720,6583,21773,0.6186561337436274,0.30234694346208607,0.0789969227942865
2000,HAWAII,MAUI,23484,2888,12876,39248,0.5983489604565838,0.3280676722380758,0.0735833673053404
2000,IDAHO,ADA,40650,7785,75050,123485,0.3291897801352391,0.6077661254403369,0.06304409442442402
2000,IDAHO,ADAMS,336,97,1476,1909,0.17600838135149294,0.7731796752226296,0.05081194342587742
2000,IDAHO,BANNOCK,10892,1737,18223,30852,0.35304032153507064,0.5906586282899001,0.05630105017502917
2000,IDAHO,BEAR LAKE,517,86,2296,2899,0.17833735770955503,0.7919972404277337,0.02966540186271128
2000,IDAHO,BENEWAH,895,186,2606,3687,0.2427447789530784,0.7068077027393544,0.05044751830756713
2000,IDAHO,BINGHAM,3310,527,10628,14465,0.2288282060145178,0.7347390252333218,0.03643276875216039
2000,IDAHO,BLAINE,3748,662,3528,7938,0.47215923406399596,0.4444444444444444,0.08339632149155958
2000,IDAHO,BOISE,745,291,2019,3055,0.24386252045826515,0.6608837970540098,0.09525368248772505
2000,IDAHO,BONNER,4318,1274,8945,14537,0.29703515168191513,0.615326408474926,0.08763843984315883
2000,IDAHO,BONNEVILLE,7235,1333,24988,33556,0.21560972702348313,0.7446656335677673,0.039724639408749554
2000,IDAHO,BOUNDARY,832,255,2797,3884,0.21421215242018538,0.7201338825952626,0.065653964984552
2000,IDAHO,BUTTE,354,52,1054,1460,0.24246575342465754,0.7219178082191781,0.03561643835616438
2000,IDAHO,CAMAS,113,35,359,507,0.22287968441814596,0.7080867850098619,0.06903353057199212
2000,IDAHO,CANYON,10588,1852,30560,43000,0.24623255813953487,0.7106976744186047,0.04306976744186047
2000,IDAHO,CARIBOU,475,101,2601,3177,0.14951211835064526,0.8186968838526912,0.03179099779666352
2000,IDAHO,CASSIA,1087,209,5983,7279,0.14933369968402252,0.8219535650501443,0.02871273526583322
2000,IDAHO,CLARK,63,8,311,382,0.1649214659685864,0.8141361256544503,0.020942408376963352
2000,IDAHO,CLEARWATER,841,170,2885,3896,0.2158624229979466,0.7405030800821355,0.043634496919917866
2000,IDAHO,CUSTER,416,120,1794,2330,0.17854077253218884,0.7699570815450644,0.05150214592274678
2000,IDAHO,ELMORE,1840,235,4891,6966,0.2641401091013494,0.7021246052253804,0.03373528567327017
2000,IDAHO,FRANKLIN,513,136,3594,4243,0.12090502003299552,0.8470421871317464,0.032052792835258075
2000,IDAHO,FREMONT,699,147,4242,5088,0.13738207547169812,0.8337264150943396,0.028891509433962265
2000,IDAHO,GEM,1346,261,4376,5983,0.22497075045963563,0.7314056493397961,0.043623600200568276
2000,IDAHO,GOODING,1282,242,3502,5026,0.25507361719060884,0.6967767608436132,0.048149621965777954
2000,IDAHO,IDAHO,1187,459,5806,7452,0.1592860976918948,0.7791196994095545,0.06159420289855073
2000,IDAHO,JEFFERSON,1100,256,6480,7836,0.14037774374680959,0.8269525267993875,0.03266972945380296
2000,IDAHO,JEROME,1360,229,4418,6007,0.2264025303812219,0.7354752788413518,0.03812219077742634
2000,IDAHO,KOOTENAI,13488,2162,28162,43812,0.3078608600383457,0.6427919291518306,0.049347210809823794
2000,IDAHO,LATAH,5661,1489,8161,15311,0.36973417804193065,0.5330154790673373,0.09725034289073216
2000,IDAHO,LEMHI,660,122,2859,3641,0.18126888217522658,0.7852238396045043,0.03350727822026916
2000,IDAHO,LEWIS,335,58,1295,1688,0.19845971563981044,0.7671800947867299,0.034360189573459717
2000,IDAHO,LINCOLN,437,88,1049,1574,0.2776365946632783,0.6664548919949174,0.05590851334180432
2000,IDAHO,MADISON,816,213,7941,8970,0.09096989966555184,0.8852842809364548,0.02374581939799331
2000,IDAHO,MINIDOKA,1344,267,4907,6518,0.20619822031297944,0.752838293955201,0.04096348573181958
2000,IDAHO,NEZ PERCE,4995,449,10577,16021,0.3117782909930716,0.6601959927595031,0.028025716247425253
2000,IDAHO,ONEIDA,307,65,1426,1798,0.1707452725250278,0.7931034482758621,0.036151279199110126
2000,IDAHO,OWYHEE,623,115,2450,3188,0.19542032622333752,0.7685069008782937,0.03607277289836888
2000,IDAHO,PAYETTE,1643,254,4961,6858,0.2395742198891805,0.7233887430737824,0.037037037037037035
2000,IDAHO,POWER,755,82,1872,2709,0.27870062753783686,0.6910299003322259,0.030269472129937247
2000,IDAHO,SHOSHONE,2225,281,2879,5385,0.41318477251624885,0.5346332404828227,0.052181987000928506
2000,IDAHO,TETON,720,206,1745,2671,0.2695619618120554,0.6533133657806065,0.07712467240733807
2000,IDAHO,TWIN FALLS,5777,959,15794,22530,0.2564136706613404,0.7010208610741234,0.04256546826453617
2000,IDAHO,VALLEY,1129,301,2548,3978,0.2838109602815485,0.6405228758169934,0.07566616390145801
2000,IDAHO,WASHINGTON,980,191,2899,4070,0.24078624078624078,0.7122850122850123,0.04692874692874693
2000,ILLINOIS,ADAMS,12197,581,17331,30109,0.4050948221462021,0.5756086220067089,0.01929655584708891
2000,ILLINOIS,ALEXANDER,2357,77,1588,4022,0.5860268523122825,0.3948284435604177,0.01914470412729985
2000,ILLINOIS,BOND,3060,168,3804,7032,0.4351535836177474,0.5409556313993175,0.023890784982935155
2000,ILLINOIS,BOONE,6481,425,8617,15523,0.4175095020292469,0.5551117696321587,0.027378728338594345
2000,ILLINOIS,BROWN,1077,54,1529,2660,0.4048872180451128,0.574812030075188,0.02030075187969925
2000,ILLINOIS,BUREAU,7754,543,8526,16823,0.4609166022707008,0.5068061582357487,0.0322772394935505
2000,ILLINOIS,CALHOUN,1310,63,1229,2602,0.5034588777863183,0.47232897770945426,0.02421214450422752
2000,ILLINOIS,CARROLL,3113,229,3835,7177,0.43374669081789047,0.5343458269471925,0.031907482234917094
2000,ILLINOIS,CASS,2789,142,2968,5899,0.4727919986438379,0.5031361247669096,0.024071876589252417
2000,ILLINOIS,CHAMPAIGN,35515,4125,34645,74285,0.4780911354916874,0.4663794844181194,0.055529380090193176
2000,ILLINOIS,CHRISTIAN,6799,435,7537,14771,0.4602938189696026,0.5102565838467267,0.029449597183670705
2000,ILLINOIS,CLARK,2932,182,4398,7512,0.3903088391906283,0.5854632587859425,0.02422790202342918
2000,ILLINOIS,CLAY,2212,134,3789,6135,0.36055419722901383,0.6176039119804401,0.021841890790546048
2000,ILLINOIS,CLINTON,6436,403,8588,15427,0.41719063978738574,0.5566863291631555,0.02612303104945874
2000,ILLINOIS,COLES,8904,694,10495,20093,0.443139401781715,0.5223212063902851,0.0345393918279998
2000,ILLINOIS,COOK,1280547,50818,534542,1865907,0.6862866155708724,0.2864783721803927,0.027235012248734796
2000,ILLINOIS,CRAWFORD,3333,193,4974,8500,0.3921176470588235,0.5851764705882353,0.022705882352941176
2000,ILLINOIS,CUMBERLAND,1870,141,2964,4975,0.3758793969849246,0.5957788944723618,0.02834170854271357
2000,ILLINOIS,DE WITT,2870,213,3968,7051,0.40703446319670966,0.5627570557367749,0.03020848106651539
2000,ILLINOIS,DEKALB,14798,1296,17139,33233,0.4452802936839888,0.5157223241958294,0.038997382120181744
2000,ILLINOIS,DOUGLAS,3215,203,4734,8152,0.3943817468105986,0.5807163886162905,0.02490186457311089
2000,ILLINOIS,DUPAGE,152550,10775,201037,364362,0.4186770299866616,0.5517507314154605,0.029572238597877935
2000,ILLINOIS,EDGAR,3216,183,4833,8232,0.39067055393586003,0.5870991253644315,0.022230320699708456
2000,ILLINOIS,EDWARDS,978,70,2212,3260,0.3,0.6785276073619632,0.02147239263803681
2000,ILLINOIS,EFFINGHAM,4225,405,9855,14485,0.2916810493614084,0.6803589920607525,0.027959958577839145
2000,ILLINOIS,FAYETTE,3886,252,5200,9338,0.4161490683229814,0.5568644249303919,0.026986506746626688
2000,ILLINOIS,FORD,2090,174,3889,6153,0.33967170485941817,0.6320494067934341,0.028278888347147733
2000,ILLINOIS,FRANKLIN,10201,521,8490,19212,0.5309702269414949,0.4419113054341037,0.027118467624401416
2000,ILLINOIS,FULTON,8940,401,6936,16277,0.5492412606745715,0.42612274989248633,0.02463598943294219
2000,ILLINOIS,GALLATIN,1878,89,1591,3558,0.5278246205733558,0.44716132658797075,0.02501405283867341
2000,ILLINOIS,GREENE,2490,148,3129,5767,0.43176694988728975,0.5425697936535461,0.02566325645916421
2000,ILLINOIS,GRUNDY,7516,359,8709,16584,0.45320791123974913,0.5251447178002895,0.021647370959961408
2000,ILLINOIS,HAMILTON,1943,125,2519,4587,0.4235884020056682,0.5491606714628298,0.02725092653150207
2000,ILLINOIS,HANCOCK,4256,301,5134,9691,0.43917036425549477,0.5297698895882778,0.031059746156227426
2000,ILLINOIS,HARDIN,1184,87,1366,2637,0.44899507015547974,0.5180128934395146,0.03299203640500569
2000,ILLINOIS,HENDERSON,2030,128,1708,3866,0.5250905328504915,0.44180031039834455,0.03310915675116399
2000,ILLINOIS,HENRY,11921,653,10896,23470,0.507925010651896,0.46425223689816786,0.027822752449936088
2000,ILLINOIS,IROQUOIS,4397,342,8685,13424,0.3275476758045292,0.6469755661501788,0.025476758045292015
2000,ILLINOIS,JACKSON,11773,1494,9823,23090,0.5098744045041144,0.4254222607189259,0.06470333477695972
2000,ILLINOIS,JASPER,1815,87,3119,5021,0.36148177653853814,0.6211909978092014,0.017327225652260504
2000,ILLINOIS,JEFFERSON,6685,313,8362,15360,0.4352213541666667,0.5444010416666667,0.020377604166666667
2000,ILLINOIS,JERSEY,4355,359,4699,9413,0.4626580261340699,0.4992032295761181,0.03813874428981196
2000,ILLINOIS,JO DAVIESS,4585,433,5304,10322,0.44419686107343537,0.5138539042821159,0.04194923464444875
2000,ILLINOIS,JOHNSON,1928,149,3285,5362,0.3595673256247669,0.6126445356210369,0.027788138754196196
2000,ILLINOIS,KANE,60127,4282,76996,141405,0.425211272585835,0.5445069127682897,0.030281814645875323
2000,ILLINOIS,KANKAKEE,19180,954,20049,40183,0.4773162780280218,0.49894233879999006,0.023741383171988154
2000,ILLINOIS,KENDALL,8444,637,13688,22769,0.3708551100180069,0.6011682550836663,0.027976634898326674
2000,ILLINOIS,KNOX,12572,690,9912,23174,0.5425045309398464,0.42772072149823076,0.029774747561922846
2000,ILLINOIS,LAKE,115058,6118,120988,242164,0.47512429593168265,0.4996118333030508,0.025263870765266514
2000,ILLINOIS,LASALLE,23355,1376,21276,46007,0.5076401417175647,0.4624513660964636,0.0299084921859717
2000,ILLINOIS,LAWRENCE,2822,162,3594,6578,0.4290057768318638,0.5463666768014594,0.0246275463666768
2000,ILLINOIS,LEE,6111,440,8069,14620,0.4179890560875513,0.5519151846785225,0.030095759233926128
2000,ILLINOIS,LIVINGSTON,5829,405,9187,15421,0.37799105116399717,0.5957460605667596,0.02626288826924324
2000,ILLINOIS,LOGAN,4600,324,8141,13065,0.3520857252200536,0.623115193264447,0.024799081515499425
2000,ILLINOIS,MACON,24262,1407,23830,49499,0.49015131618820584,0.4814238671488313,0.028424816662962888
2000,ILLINOIS,MACOUPIN,11015,625,9749,21389,0.5149843377437,0.4557950348309879,0.029220627425312076
2000,ILLINOIS,MADISON,59077,3206,48821,111104,0.531727030529954,0.43941712269585254,0.028855846774193547
2000,ILLINOIS,MARION,8068,355,8240,16663,0.4841865210346276,0.49450879193422553,0.02130468703114685
2000,ILLINOIS,MARSHALL,2570,192,3145,5907,0.4350770272557982,0.5324191637040799,0.03250380904012189
2000,ILLINOIS,MASON,3192,169,3411,6772,0.4713526284701713,0.5036916715888955,0.024955699940933256
2000,ILLINOIS,MASSAC,2912,156,3676,6744,0.431791221826809,0.5450771055753262,0.023131672597864767
2000,ILLINOIS,MCDONOUGH,6080,467,6465,13012,0.467260989855518,0.49684906240393484,0.035889947740547185
2000,ILLINOIS,MCHENRY,40698,3375,62112,106185,0.38327447379573387,0.584941375900551,0.03178415030371522
2000,ILLINOIS,MCLEAN,24936,1954,34008,60898,0.4094715754211961,0.5584419849584551,0.03208643962034878
2000,ILLINOIS,MENARD,2164,176,3862,6202,0.3489197033215092,0.6227023540793293,0.02837794259916156
2000,ILLINOIS,MERCER,4400,230,3688,8318,0.5289733108920414,0.44337581149314736,0.02765087761481125
2000,ILLINOIS,MONROE,5797,367,7632,13796,0.42019425920556686,0.5532038271962888,0.02660191359814439
2000,ILLINOIS,MONTGOMERY,6542,325,6226,13093,0.4996563048957458,0.47552127090811885,0.02482242419613534
2000,ILLINOIS,MORGAN,5899,377,8058,14334,0.4115389981861309,0.5621598995395563,0.026301102274312822
2000,ILLINOIS,MOULTRIE,2529,138,3058,5725,0.44174672489082967,0.5341484716157205,0.024104803493449782
2000,ILLINOIS,OGLE,7673,603,12325,20601,0.3724576476870055,0.5982719285471579,0.02927042376583661
2000,ILLINOIS,PEORIA,38604,1810,36398,76812,0.5025777222309015,0.4738582513148987,0.023564026454199864
2000,ILLINOIS,PERRY,4862,278,4802,9942,0.48903641118487223,0.48300140816737075,0.02796218064775699
2000,ILLINOIS,PIATT,3488,278,4619,8385,0.4159809183064997,0.5508646392367322,0.03315444245676804
2000,ILLINOIS,PIKE,3198,208,4706,8112,0.3942307692307692,0.5801282051282052,0.02564102564102564
2000,ILLINOIS,POPE,927,57,1346,2330,0.39785407725321886,0.5776824034334764,0.024463519313304722
2000,ILLINOIS,PULASKI,1518,68,1430,3016,0.503315649867374,0.47413793103448276,0.022546419098143235
2000,ILLINOIS,PUTNAM,1657,85,1437,3179,0.5212330921673483,0.4520289399182133,0.026737967914438502
2000,ILLINOIS,RANDOLPH,6794,366,7127,14287,0.4755372016518513,0.49884510394064535,0.025617694407503326
2000,ILLINOIS,RICHLAND,2491,219,4718,7428,0.3353527194399569,0.6351642434033388,0.02948303715670436
2000,ILLINOIS,ROCK ISLAND,37957,1944,25194,65095,0.5831016207081957,0.38703433443428836,0.02986404485751594
2000,ILLINOIS,SALINE,5427,290,5933,11650,0.46583690987124465,0.5092703862660944,0.024892703862660945
2000,ILLINOIS,SANGAMON,38414,2697,50374,91485,0.419893971689348,0.5506257856479204,0.029480242662731596
2000,ILLINOIS,SCHUYLER,1587,108,2077,3772,0.42073170731707316,0.5506362672322376,0.02863202545068929
2000,ILLINOIS,SCOTT,954,57,1458,2469,0.3863912515188335,0.5905224787363305,0.023086269744835967
2000,ILLINOIS,SHELBY,4018,294,5851,10163,0.3953557020564794,0.575715831939388,0.02892846600413264
2000,ILLINOIS,ST. CLAIR,55961,2133,42299,100393,0.5574193419859951,0.4213341567639178,0.021246501250087157
2000,ILLINOIS,STARK,1211,84,1694,2989,0.405152224824356,0.5667447306791569,0.02810304449648712
2000,ILLINOIS,STEPHENSON,8062,601,10715,19378,0.41603880689441636,0.5529466405201775,0.03101455258540613
2000,ILLINOIS,TAZEWELL,25379,1432,31537,58348,0.43495921025570716,0.5404983889764859,0.024542400767806952
2000,ILLINOIS,UNION,3982,281,4397,8660,0.45981524249422634,0.5077367205542725,0.032448036951501155
2000,ILLINOIS,VERMILION,15406,911,15783,32100,0.47993769470404984,0.4916822429906542,0.02838006230529595
2000,ILLINOIS,WABASH,1987,115,3406,5508,0.36074800290486564,0.6183732752360204,0.020878721859114015
2000,ILLINOIS,WARREN,3524,208,3899,7631,0.4618005503865811,0.5109422094089896,0.027257240204429302
2000,ILLINOIS,WASHINGTON,2638,147,4353,7138,0.36957130848977304,0.6098346875875595,0.020594003922667414
2000,ILLINOIS,WAYNE,2209,137,5347,7693,0.28714415702586765,0.6950474457298843,0.017808397244248018
2000,ILLINOIS,WHITE,2958,158,4521,7637,0.3873248657849941,0.591986382087207,0.020688752127798873
2000,ILLINOIS,WHITESIDE,12886,699,11252,24837,0.5188227241615332,0.4530337802472118,0.028143495591254983
2000,ILLINOIS,WILL,90902,4940,95828,191670,0.47426305629467314,0.4999634788960192,0.025773464809307665
2000,ILLINOIS,WILLIAMSON,12192,735,14012,26939,0.4525780466980957,0.520138089758343,0.02728386354356138
2000,ILLINOIS,WINNEBAGO,51981,3500,53816,109297,0.47559402362370423,0.4923831395189255,0.032022836857370285
2000,ILLINOIS,WOODFORD,5529,359,10905,16793,0.32924432799380693,0.6493777169058537,0.02137795510033943
2000,INDIANA,ADAMS,3775,260,8555,12590,0.2998411437648928,0.6795075456711676,0.020651310563939634
2000,INDIANA,ALLEN,41636,2258,70426,114320,0.36420573827851643,0.6160426871938418,0.01975157452764171
2000,INDIANA,BARTHOLOMEW,9015,554,16200,25769,0.3498389537816757,0.6286623462299662,0.021498699988358103
2000,INDIANA,BENTON,1328,105,2441,3874,0.3427981414558596,0.6300980898296334,0.02710376871450697
2000,INDIANA,BLACKFORD,2103,91,2699,4893,0.4297976701410178,0.5516043327202126,0.01859799713876967
2000,INDIANA,BOONE,4763,472,13161,18396,0.25891498151772124,0.7154272667971298,0.025657751685148944
2000,INDIANA,BROWN,2608,338,3871,6817,0.3825729793164148,0.5678450931494793,0.04958192753410591
2000,INDIANA,CARROLL,2965,201,5102,8268,0.35861151427189164,0.6170778906627963,0.024310595065312045
2000,INDIANA,CASS,5412,389,9305,15106,0.35826823778631006,0.6159804051370317,0.025751357076658283
2000,INDIANA,CLARK,17360,559,19417,37336,0.4649667880865652,0.5200610670666381,0.014972144846796657
2000,INDIANA,CLAY,3605,160,6393,10158,0.35489269541248275,0.6293561724748966,0.015751132112620594
2000,INDIANA,CLINTON,3643,207,7141,10991,0.33145300700573194,0.6497134018742607,0.01883359112000728
2000,INDIANA,CRAWFORD,1817,65,2327,4209,0.43169398907103823,0.5528629128058922,0.015443098123069612
2000,INDIANA,DAVIESS,2697,192,6872,9761,0.2763036574121504,0.7040262268210224,0.01967011576682717
2000,INDIANA,DEARBORN,6020,178,11452,17650,0.34107648725212464,0.6488385269121814,0.010084985835694052
2000,INDIANA,DECATUR,2889,167,6115,9171,0.3150147203140334,0.6667757060298768,0.01820957365608985
2000,INDIANA,DEKALB,4776,308,8701,13785,0.34646354733405876,0.6311933260790714,0.022343126586869787
2000,INDIANA,DELAWARE,20876,1166,22105,44147,0.472874714023603,0.5007135252678552,0.026411760708541916
2000,INDIANA,DUBOIS,5090,280,10134,15504,0.32830237358101133,0.6536377708978328,0.01805985552115583
2000,INDIANA,ELKHART,16402,1324,36756,54482,0.301053558973606,0.6746448368268418,0.024301604199552147
2000,INDIANA,FAYETTE,3415,172,5060,8647,0.39493465941945183,0.5851740488030531,0.019891291777495084
2000,INDIANA,FLOYD,13209,335,16486,30030,0.4398601398601399,0.548984348984349,0.011155511155511156
2000,INDIANA,FOUNTAIN,2717,156,4408,7281,0.373163027056723,0.6054113445955226,0.021425628347754428
2000,INDIANA,FRANKLIN,2591,161,5587,8339,0.31070871807171124,0.6699844106007915,0.019306871327497303
2000,INDIANA,FULTON,2960,149,5218,8327,0.3554701573195629,0.6266362435450943,0.01789359913534286
2000,INDIANA,GIBSON,5802,236,7734,13772,0.42128957304676157,0.5615742085390648,0.017136218414173687
2000,INDIANA,GRANT,9712,521,16153,26386,0.36807397862502844,0.6121807018873645,0.019745319487607063
2000,INDIANA,GREENE,4898,269,7452,12619,0.38814486092400347,0.5905380775021792,0.02131706157381726
2000,INDIANA,HAMILTON,18002,1552,56372,75926,0.23709928087875037,0.7424597634538893,0.020440955667360323
2000,INDIANA,HANCOCK,6503,504,15943,22950,0.28335511982570805,0.6946840958605665,0.02196078431372549
2000,INDIANA,HARRISON,5870,315,8711,14896,0.3940655209452202,0.5847878625134264,0.021146616541353382
2000,INDIANA,HENDRICKS,10786,784,28651,40221,0.2681683697570921,0.7123393252281147,0.01949230501479327
2000,INDIANA,HENRY,7647,347,10321,18315,0.4175266175266175,0.5635271635271635,0.018946218946218948
2000,INDIANA,HOWARD,12899,865,20331,34095,0.37832526763455054,0.596304443466784,0.025370288898665494
2000,INDIANA,HUNTINGTON,4119,388,10113,14620,0.2817373461012312,0.6917236662106703,0.026538987688098495
2000,INDIANA,JACKSON,5330,218,9054,14602,0.3650184906177236,0.6200520476647035,0.014929461717572935
2000,INDIANA,JASPER,3744,211,7212,11167,0.3352735739231665,0.6458314677173815,0.018894958359451958
2000,INDIANA,JAY,3167,176,4687,8030,0.39439601494396015,0.5836861768368617,0.021917808219178082
2000,INDIANA,JEFFERSON,5117,232,6582,11931,0.42888274243567176,0.5516721146592909,0.019445142905037297
2000,INDIANA,JENNINGS,3549,213,5732,9494,0.37381504107857594,0.6037497366757952,0.022435222245628817
2000,INDIANA,JOHNSON,11952,928,29404,42284,0.2826601078422098,0.6953930564752625,0.02194683568252767
2000,INDIANA,KNOX,6300,269,8485,15054,0.4184934236747708,0.5636375714095921,0.01786900491563704
2000,INDIANA,KOSCIUSKO,5785,459,19040,25284,0.22880082265464324,0.7530454042081949,0.018153773137161842
2000,INDIANA,LAGRANGE,2733,163,5437,8333,0.327973118924757,0.6524660986439458,0.01956078243129725
2000,INDIANA,LAKE,109078,3527,63389,175994,0.6197824925849745,0.3601770514903917,0.020040455924633795
2000,INDIANA,LAPORTE,19736,1017,18994,39747,0.4965406194178177,0.47787254383978667,0.025586836742395654
2000,INDIANA,LAWRENCE,5071,394,10677,16142,0.314149423863214,0.6614422004708215,0.024408375665964564
2000,INDIANA,MADISON,23403,857,27956,52216,0.4481959552627547,0.535391450896277,0.016412593840968284
2000,INDIANA,MARION,134189,7904,137810,279903,0.47941251076265706,0.4923491352361354,0.028238354001207562
2000,INDIANA,MARSHALL,5541,343,10266,16150,0.34309597523219815,0.6356656346749227,0.021238390092879256
2000,INDIANA,MARTIN,1518,83,3008,4609,0.32935560859188545,0.6526361466695596,0.018008244738555
2000,INDIANA,MIAMI,4155,372,8401,12928,0.3213954207920792,0.6498298267326733,0.028774752475247526
2000,INDIANA,MONROE,17523,3550,19147,40220,0.4356787667826952,0.4760566882148185,0.08826454500248633
2000,INDIANA,MONTGOMERY,3899,311,8891,13101,0.2976108693992825,0.6786504846958248,0.023738645904892757
2000,INDIANA,MORGAN,6228,522,15286,22036,0.2826284262116537,0.693683064076965,0.023688509711381377
2000,INDIANA,NEWTON,2101,159,3250,5510,0.3813067150635209,0.5898366606170599,0.02885662431941924
2000,INDIANA,NOBLE,4822,291,9103,14216,0.3391952729319077,0.6403348339898706,0.020469893078221724
2000,INDIANA,OHIO,951,26,1515,2492,0.3816211878009631,0.6079454253611557,0.01043338683788122
2000,INDIANA,ORANGE,2601,170,4687,7458,0.3487530168946098,0.6284526682756771,0.022794314829713058
2000,INDIANA,OWEN,2253,231,4019,6503,0.34645548208519145,0.6180224511763801,0.03552206673842842
2000,INDIANA,PARKE,2481,125,3841,6447,0.3848301535597953,0.5957809834031332,0.019388863037071505
2000,INDIANA,PERRY,3823,103,3461,7387,0.5175307973466902,0.4685257885474482,0.013943414105861649
2000,INDIANA,PIKE,2605,131,3566,6302,0.41336083782926053,0.5658521104411298,0.020787051729609648
2000,INDIANA,PORTER,26790,1431,31157,59378,0.45117720367812997,0.5247229613661626,0.0240998349557075
2000,INDIANA,POSEY,4430,182,6498,11110,0.39873987398739874,0.5848784878487849,0.01638163816381638
2000,INDIANA,PULASKI,1919,102,3497,5518,0.3477709314969192,0.6337441101848496,0.018484958318231243
2000,INDIANA,PUTNAM,4123,396,7352,11871,0.34731699098643753,0.6193244040097717,0.03335860500379075
2000,INDIANA,RANDOLPH,3906,206,6020,10132,0.38551125148045795,0.5941571259376234,0.020331622581918674
2000,INDIANA,RIPLEY,3498,189,6988,10675,0.3276814988290398,0.6546135831381733,0.017704918032786884
2000,INDIANA,RUSH,2370,165,4749,7284,0.32537067545304776,0.6519769357495881,0.022652388797364087
2000,INDIANA,SCOTT,3915,170,3761,7846,0.4989803721641601,0.47935253632424163,0.021667091511598267
2000,INDIANA,SHELBY,5374,346,9590,15310,0.3510124101894187,0.6263879817112998,0.022599608099281514
2000,INDIANA,SPENCER,3752,139,5096,8987,0.4174919327918104,0.5670412818515633,0.015466785356626237
2000,INDIANA,ST. JOSEPH,47703,2190,47581,97474,0.48939204300634015,0.4881404271908406,0.022467529802819214
2000,INDIANA,STARKE,4136,216,4349,8701,0.47534766118836913,0.4998276060222963,0.024824732789334558
2000,INDIANA,STEUBEN,4103,221,6953,11277,0.3638379001507493,0.6165646891903875,0.01959741065886317
2000,INDIANA,SULLIVAN,3833,110,4319,8262,0.46393125151295084,0.5227547809247156,0.013313967562333575
2000,INDIANA,SWITZERLAND,1336,72,1831,3239,0.4124729854893486,0.5652979314603273,0.022229083050324176
2000,INDIANA,TIPPECANOE,18220,1969,26106,46295,0.39356301976455343,0.5639053893509018,0.042531590884544765
2000,INDIANA,TIPTON,2392,140,4784,7316,0.32695462001093495,0.6539092400218699,0.01913613996719519
2000,INDIANA,UNION,927,63,1838,2828,0.3277934936350778,0.6499292786421499,0.022277227722772276
2000,INDIANA,VANDERBURGH,29222,1153,35846,66221,0.44127995650926444,0.541308648313979,0.01741139517675662
2000,INDIANA,VERMILLION,3370,133,3130,6633,0.508065731946329,0.47188300919644205,0.020051258857229005
2000,INDIANA,VIGO,17570,637,18021,36228,0.48498399028375844,0.4974329248095396,0.017583084906701997
2000,INDIANA,WABASH,4277,285,8321,12883,0.33198789101917253,0.6458899324691454,0.02212217651168206
2000,INDIANA,WARREN,1471,79,2218,3768,0.3903927813163482,0.5886411889596603,0.020966029723991506
2000,INDIANA,WARRICK,8749,355,13205,22309,0.39217356223945493,0.5919135774799408,0.015912860280604242
2000,INDIANA,WASHINGTON,3675,258,5868,9801,0.3749617385981022,0.5987144168962351,0.026323844505662688
2000,INDIANA,WAYNE,10273,605,14273,25151,0.40845294421692974,0.5674923462287782,0.024054709554292075
2000,INDIANA,WELLS,3319,207,7755,11281,0.29421150607215674,0.6874390568212038,0.01834943710663948
2000,INDIANA,WHITE,3655,212,6037,9904,0.36904281098546043,0.6095516962843296,0.021405492730210016
2000,INDIANA,WHITLEY,4107,245,8080,12432,0.33035714285714285,0.6499356499356499,0.019707207207207207
2000,IOWA,ADAIR,1753,95,2275,4123,0.4251758428328887,0.5517826825127334,0.02304147465437788
2000,IOWA,ADAMS,897,78,1170,2145,0.41818181818181815,0.5454545454545454,0.03636363636363636
2000,IOWA,ALLAMAKEE,2883,302,3277,6462,0.44614670380687094,0.5071185391519654,0.04673475704116373
2000,IOWA,APPANOOSE,2560,152,2992,5704,0.4488078541374474,0.5245441795231417,0.02664796633941094
2000,IOWA,AUDUBON,1780,95,1909,3784,0.4704016913319239,0.504492600422833,0.02510570824524313
2000,IOWA,BENTON,5915,383,5468,11766,0.5027197008329084,0.4647288798232194,0.03255141934387217
2000,IOWA,BLACK HAWK,30112,1505,23468,55085,0.5466460924026505,0.4260324952346374,0.027321412362712173
2000,IOWA,BOONE,6270,354,5625,12249,0.5118785206955669,0.4592211609110948,0.02890031839333823
2000,IOWA,BREMER,5169,331,5675,11175,0.4625503355704698,0.5078299776286354,0.029619686800894853
2000,IOWA,BUCHANAN,5045,273,4092,9410,0.5361317747077577,0.4348565356004251,0.029011689691817215
2000,IOWA,BUENA VISTA,3297,326,4354,7977,0.41331327566754417,0.5458192302870754,0.04086749404538047
2000,IOWA,BUTLER,2735,152,3837,6724,0.40675193337299226,0.5706424747174301,0.022605591909577633
2000,IOWA,CALHOUN,2132,133,2776,5041,0.4229319579448522,0.5506843880182504,0.02638365403689744
2000,IOWA,CARROLL,4463,226,4879,9568,0.4664506688963211,0.5099289297658863,0.023620401337792644
2000,IOWA,CASS,2481,193,4206,6880,0.3606104651162791,0.6113372093023256,0.028052325581395348
2000,IOWA,CEDAR,4033,280,4031,8344,0.4833413231064238,0.4831016299137105,0.03355704697986577
2000,IOWA,CERRO GORDO,12185,580,9397,22162,0.5498149986463315,0.4240140781517914,0.026170923201877087
2000,IOWA,CHEROKEE,2845,284,3463,6592,0.43158373786407767,0.5253337378640777,0.04308252427184466
2000,IOWA,CHICKASAW,3435,213,2936,6584,0.5217193195625759,0.4459295261239368,0.03235115431348724
2000,IOWA,CLARKE,2081,111,1984,4176,0.49832375478927204,0.47509578544061304,0.02658045977011494
2000,IOWA,CLAY,3294,292,3992,7578,0.4346793349168646,0.5267880707310636,0.038532594352071785
2000,IOWA,CLAYTON,4238,299,4034,8571,0.49445805623614514,0.47065686617664215,0.034885077587212696
2000,IOWA,CLINTON,12276,675,9229,22180,0.5534715960324617,0.4160955816050496,0.03043282236248873
2000,IOWA,CRAWFORD,2838,235,3482,6555,0.43295194508009155,0.5311975591151793,0.03585049580472922
2000,IOWA,DALLAS,8561,463,10306,19330,0.4428867046042421,0.5331608898085877,0.0239524055871702
2000,IOWA,DAVIS,1691,111,1956,3758,0.44997339010111764,0.5204896221394358,0.029536987759446513
2000,IOWA,DECATUR,1674,132,1903,3709,0.4513345915341062,0.5130763008897277,0.03558910757616608
2000,IOWA,DELAWARE,3808,268,4273,8349,0.4561025272487723,0.5117978200982154,0.03209965265301234
2000,IOWA,DES MOINES,11351,629,7385,19365,0.5861605990188484,0.38135812032016525,0.032481280660986316
2000,IOWA,DICKINSON,3660,236,4225,8121,0.4506834133727374,0.5202561260928457,0.029060460534416944
2000,IOWA,DUBUQUE,22341,1520,16462,40323,0.5540510378692062,0.40825335416511666,0.037695607965677155
2000,IOWA,EMMET,2165,134,2331,4630,0.46760259179265656,0.5034557235421167,0.028941684665226782
2000,IOWA,FAYETTE,4640,234,4747,9621,0.4822783494439247,0.49339985448498075,0.02432179607109448
2000,IOWA,FLOYD,3830,217,3191,7238,0.5291516993644653,0.44086764299530257,0.029980657640232108
2000,IOWA,FRANKLIN,2122,159,2657,4938,0.42972863507492914,0.5380720939651681,0.03219927095990279
2000,IOWA,FREMONT,1459,88,2069,3616,0.40348451327433627,0.572179203539823,0.024336283185840708
2000,IOWA,GREENE,2301,136,2282,4719,0.48760330578512395,0.4835770290315745,0.028819665183301545
2000,IOWA,GRUNDY,2139,121,3851,6111,0.35002454590083454,0.6301750940926198,0.019800360006545573
2000,IOWA,GUTHRIE,2493,136,2840,5469,0.455842018650576,0.5192905467178643,0.0248674346315597
2000,IOWA,HAMILTON,3407,199,3968,7574,0.4498283601795617,0.5238975442302615,0.026274095590176922
2000,IOWA,HANCOCK,2281,169,2988,5438,0.41945568223611623,0.549466715704303,0.03107760205958073
2000,IOWA,HARDIN,3734,215,4486,8435,0.44267931238885594,0.5318316538233551,0.025489033787788974
2000,IOWA,HARRISON,2551,190,3802,6543,0.3898823169799786,0.5810790157420144,0.02903866727800703
2000,IOWA,HENRY,3907,288,4476,8671,0.45058240110713876,0.5162034367431669,0.03321416214969438
2000,IOWA,HOWARD,2426,143,1922,4491,0.5401914940993098,0.42796704520151413,0.03184146069917613
2000,IOWA,HUMBOLDT,1949,145,2846,4940,0.3945344129554656,0.5761133603238866,0.029352226720647773
2000,IOWA,IDA,1411,112,1968,3491,0.4041821827556574,0.5637353193927241,0.03208249785161845
2000,IOWA,IOWA,3230,289,3894,7413,0.4357210306218805,0.5252934034803723,0.0389855658977472
2000,IOWA,JACKSON,4945,318,3769,9032,0.5474977856510186,0.41729406554472986,0.03520814880425155
2000,IOWA,JASPER,8699,407,8729,17835,0.48774880852256797,0.4894308943089431,0.022820297168488927
2000,IOWA,JEFFERSON,2863,1437,3248,7548,0.3793057763645999,0.4303126656067833,0.19038155802861687
2000,IOWA,JOHNSON,31174,3696,17899,52769,0.5907635164585268,0.33919536091265706,0.07004112262881616
2000,IOWA,JONES,4690,252,4201,9143,0.5129607349885158,0.4594771956688177,0.02756206934266652
2000,IOWA,KEOKUK,2181,195,2571,4947,0.4408732565191025,0.5197089144936325,0.03941782898726501
2000,IOWA,KOSSUTH,3960,306,4612,8878,0.44604640684838925,0.5194863708042352,0.03446722234737554
2000,IOWA,LEE,9632,601,6339,16572,0.5812213371952691,0.38251267197682837,0.03626599082790249
2000,IOWA,LINN,48897,2750,40417,92064,0.5311196558915537,0.4390098192561696,0.02987052485227668
2000,IOWA,LOUISA,2294,136,2207,4637,0.4947164114729351,0.4759542807849903,0.029329307742074616
2000,IOWA,LUCAS,1934,107,2262,4303,0.44945386939344645,0.525679758308157,0.02486637229839647
2000,IOWA,LYON,1313,111,3918,5342,0.24578809434668664,0.7334331710969674,0.020778734556345938
2000,IOWA,MADISON,3093,214,3662,6969,0.4438226431338786,0.5254699382981777,0.03070741856794375
2000,IOWA,MAHASKA,3370,202,5971,9543,0.353138426071466,0.6256942261343393,0.0211673477941947
2000,IOWA,MARION,5741,309,8358,14408,0.39845918933925595,0.580094392004442,0.021446418656302053
2000,IOWA,MARSHALL,8322,517,8785,17624,0.47219700408533816,0.49846799818429416,0.02933499773036768
2000,IOWA,MILLS,2039,192,3684,5915,0.3447168216398986,0.6228233305156382,0.03245984784446323
2000,IOWA,MITCHELL,2650,124,2388,5162,0.5133669120495932,0.4626113909337466,0.02402169701666021
2000,IOWA,MONONA,2086,170,2304,4560,0.45745614035087717,0.5052631578947369,0.03728070175438596
2000,IOWA,MONROE,1699,90,1858,3647,0.4658623526185906,0.509459829997258,0.024677817384151358
2000,IOWA,MONTGOMERY,1838,139,3417,5394,0.3407489803485354,0.6334816462736373,0.025769373377827216
2000,IOWA,MUSCATINE,8058,535,7483,16076,0.5012440905697935,0.4654764866882309,0.033279422741975616
2000,IOWA,O'BRIEN,2170,200,4674,7044,0.3080636002271437,0.6635434412265758,0.028392958546280524
2000,IOWA,OSCEOLA,913,86,2064,3063,0.2980737838720209,0.67384916748286,0.028077048645119163
2000,IOWA,PAGE,2293,178,4588,7059,0.324833545828021,0.649950417906219,0.025216036265760022
2000,IOWA,PALO ALTO,2326,156,2341,4823,0.48227244453659546,0.4853825419863156,0.03234501347708895
2000,IOWA,PLYMOUTH,3499,430,6189,10118,0.3458193318837715,0.6116821506226527,0.042498517493575805
2000,IOWA,POCAHONTAS,1736,163,2242,4141,0.4192224100458826,0.5414151171214683,0.03936247283264912
2000,IOWA,POLK,89715,4525,79927,174167,0.5151090619922258,0.4589101264877962,0.025980811519977953
2000,IOWA,POTTAWATTAMIE,14726,958,18783,34467,0.42724925290857924,0.544956044912525,0.027794702178895757
2000,IOWA,POWESHIEK,4222,362,4396,8980,0.47015590200445434,0.48953229398663695,0.040311804008908686
2000,IOWA,RINGGOLD,1246,77,1369,2692,0.46285289747399705,0.5085438335809807,0.028603268945022287
2000,IOWA,SAC,2099,158,2776,5033,0.4170474865885158,0.5515597059407907,0.031392807470693423
2000,IOWA,SCOTT,35857,1910,32801,70568,0.508119827683936,0.46481408003627706,0.02706609227978687
2000,IOWA,SHELBY,2179,175,3655,6009,0.36262273256781496,0.6082542852388084,0.0291229821933766
2000,IOWA,SIOUX,2148,303,12241,14692,0.14620201470187857,0.8331745167438062,0.020623468554315273
2000,IOWA,STORY,17478,1658,16228,35364,0.49423142178486595,0.4588847415450741,0.04688383667005995
2000,IOWA,TAMA,4045,236,4034,8315,0.4864702345159351,0.48514732411304873,0.028382441371016236
2000,IOWA,TAYLOR,1247,79,1770,3096,0.4027777777777778,0.5717054263565892,0.025516795865633074
2000,IOWA,UNION,2540,197,3003,5740,0.4425087108013937,0.5231707317073171,0.0343205574912892
2000,IOWA,VAN BUREN,1440,105,2016,3561,0.4043807919123842,0.5661331086773378,0.02948609941027801
2000,IOWA,WAPELLO,8355,471,6313,15139,0.5518858577184754,0.4170024440187595,0.031111698262765042
2000,IOWA,WARREN,9521,511,9621,19653,0.4844552994453773,0.4895435811326515,0.0260011194219712
2000,IOWA,WASHINGTON,3932,335,4827,9094,0.43237299318231803,0.5307895315592699,0.03683747525841214
2000,IOWA,WAYNE,1300,55,1666,3021,0.43032108573320094,0.5514730221780867,0.018205892088712348
2000,IOWA,WEBSTER,8479,397,8172,17048,0.4973603941811356,0.47935241670577194,0.023287189113092445
2000,IOWA,WINNEBAGO,2691,174,2662,5527,0.4868825764429166,0.48163560702008323,0.03148181653700018
2000,IOWA,WINNESHIEK,4339,431,4647,9417,0.46076245088669426,0.49346925772539024,0.04576829138791547
2000,IOWA,WOODBURY,17691,1341,18864,37896,0.46683027232425583,0.49778340721975933,0.0353863204559848
2000,IOWA,WORTH,2208,137,1659,4004,0.5514485514485514,0.4143356643356643,0.034215784215784216
2000,IOWA,WRIGHT,2796,156,3384,6336,0.4412878787878788,0.5340909090909091,0.02462121212121212
2000,KANSAS,ALLEN,2132,255,3379,5766,0.36975372875476936,0.5860215053763441,0.04422476586888657
2000,KANSAS,ANDERSON,1327,167,1984,3478,0.38154111558366877,0.5704427832087406,0.04801610120759057
2000,KANSAS,ATCHISON,3171,351,3378,6900,0.45956521739130435,0.4895652173913044,0.050869565217391305
2000,KANSAS,BARBER,637,106,1755,2498,0.25500400320256206,0.7025620496397118,0.04243394715772618
2000,KANSAS,BARTON,3238,415,7302,10955,0.2955727978092195,0.6665449566408033,0.03788224554997718
2000,KANSAS,BOURBON,2211,245,3852,6308,0.35050729232720357,0.6106531388712746,0.038839568801521875
2000,KANSAS,BROWN,1512,194,2985,4691,0.3223193348966105,0.6363248774248561,0.04135578767853336
2000,KANSAS,BUTLER,6755,870,13377,21002,0.3216360346633654,0.6369393391105609,0.04142462622607371
2000,KANSAS,CHASE,391,78,848,1317,0.2968868640850418,0.6438876233864844,0.05922551252847381
2000,KANSAS,CHAUTAUQUA,443,90,1347,1880,0.23563829787234042,0.7164893617021276,0.047872340425531915
2000,KANSAS,CHEROKEE,3783,333,5014,9130,0.41434830230010955,0.5491785323110624,0.03647316538882804
2000,KANSAS,CHEYENNE,350,65,1312,1727,0.2026635784597568,0.7596988998262884,0.03763752171395483
2000,KANSAS,CLARK,292,43,926,1261,0.2315622521808089,0.7343378271213322,0.03409992069785884
2000,KANSAS,CLAY,951,139,2998,4088,0.2326320939334638,0.7333659491193738,0.034001956947162425
2000,KANSAS,CLOUD,1314,271,2918,4503,0.2918054630246502,0.6480124361536753,0.06018210082167444
2000,KANSAS,COFFEY,1196,144,2700,4040,0.296039603960396,0.6683168316831684,0.03564356435643564
2000,KANSAS,COMANCHE,211,35,760,1006,0.20974155069582506,0.7554671968190855,0.03479125248508946
2000,KANSAS,COWLEY,5535,595,8080,14210,0.38951442646023926,0.5686136523574947,0.04187192118226601
2000,KANSAS,CRAWFORD,7076,798,7160,15034,0.4706664892909405,0.4762538246640947,0.05307968604496475
2000,KANSAS,DECATUR,424,80,1255,1759,0.24104604889141557,0.7134735645252984,0.04548038658328596
2000,KANSAS,DICKINSON,2413,436,5243,8092,0.29819574888779043,0.6479238754325259,0.05388037567968364
2000,KANSAS,DONIPHAN,1134,165,2350,3649,0.31077007399287476,0.644012058098109,0.04521786790901617
2000,KANSAS,DOUGLAS,18249,4527,17062,39838,0.4580802249108891,0.42828455243737135,0.11363522265173955
2000,KANSAS,EDWARDS,447,54,1062,1563,0.28598848368522073,0.6794625719769674,0.0345489443378119
2000,KANSAS,ELK,402,68,1080,1550,0.2593548387096774,0.6967741935483871,0.04387096774193548
2000,KANSAS,ELLIS,3926,718,6516,11160,0.3517921146953405,0.5838709677419355,0.06433691756272401
2000,KANSAS,ELLSWORTH,825,169,1845,2839,0.2905952800281789,0.6498767171539275,0.059528002817893624
2000,KANSAS,FINNEY,2431,277,6442,9150,0.2656830601092896,0.7040437158469945,0.03027322404371585
2000,KANSAS,FORD,2566,301,6050,8917,0.28776494336660313,0.6784793091847033,0.03375574744869351
2000,KANSAS,FRANKLIN,3321,412,5925,9658,0.3438600124249327,0.6134810519776351,0.04265893559743218
2000,KANSAS,GEARY,2660,229,3977,6866,0.3874162540052432,0.5792309933003205,0.033352752694436355
2000,KANSAS,GOVE,296,77,1122,1495,0.1979933110367893,0.7505016722408027,0.05150501672240803
2000,KANSAS,GRAHAM,346,70,1058,1474,0.23473541383989144,0.7177747625508819,0.04748982360922659
2000,KANSAS,GRANT,683,47,2126,2856,0.23914565826330533,0.7443977591036415,0.016456582633053222
2000,KANSAS,GRAY,482,47,1631,2160,0.22314814814814815,0.7550925925925925,0.02175925925925926
2000,KANSAS,GREELEY,143,32,628,803,0.1780821917808219,0.7820672478206725,0.039850560398505604
2000,KANSAS,GREENWOOD,1027,142,2392,3561,0.2884021342319573,0.6717214265655714,0.03987643920247121
2000,KANSAS,HAMILTON,264,27,901,1192,0.2214765100671141,0.7558724832214765,0.022651006711409395
2000,KANSAS,HARPER,869,110,2076,3055,0.2844517184942717,0.6795417348608838,0.03600654664484452
2000,KANSAS,HARVEY,4591,822,8271,13684,0.3355013154048524,0.6044285296696872,0.06007015492546039
2000,KANSAS,HASKELL,263,30,1323,1616,0.16274752475247525,0.8186881188118812,0.018564356435643563
2000,KANSAS,HODGEMAN,217,36,835,1088,0.19944852941176472,0.7674632352941176,0.03308823529411765
2000,KANSAS,JACKSON,1990,259,3001,5250,0.379047619047619,0.5716190476190476,0.04933333333333333
2000,KANSAS,JEFFERSON,3000,454,4423,7877,0.3808556557064872,0.5615081883965977,0.05763615589691507
2000,KANSAS,JEWELL,380,97,1400,1877,0.20245071923281832,0.7458710708577517,0.051678209909429944
2000,KANSAS,JOHNSON,79118,8453,129965,217536,0.36370072080023536,0.5974413430420712,0.03885793615769344
2000,KANSAS,KEARNY,320,31,1084,1435,0.2229965156794425,0.7554006968641115,0.021602787456445994
2000,KANSAS,KINGMAN,991,145,2672,3808,0.2602415966386555,0.7016806722689075,0.03807773109243697
2000,KANSAS,KIOWA,294,52,1262,1608,0.1828358208955224,0.7848258706467661,0.03233830845771144
2000,KANSAS,LABETTE,3745,318,4475,8538,0.4386273131881003,0.5241274303115484,0.03724525650035137
2000,KANSAS,LANE,252,35,846,1133,0.22241835834068843,0.7466902030008826,0.03089143865842895
2000,KANSAS,LEAVENWORTH,9733,955,12583,23271,0.41824588543680974,0.5407159125091315,0.0410382020540587
2000,KANSAS,LINCOLN,469,126,1295,1890,0.24814814814814815,0.6851851851851852,0.06666666666666667
2000,KANSAS,LINN,1587,159,2513,4259,0.3726226813806058,0.5900446114111294,0.03733270720826485
2000,KANSAS,LOGAN,231,78,1088,1397,0.16535433070866143,0.7788117394416607,0.05583392984967788
2000,KANSAS,LYON,5190,613,6652,12455,0.4167001204335608,0.5340826977117623,0.049217181854676835
2000,KANSAS,MARION,1475,272,4156,5903,0.24987294595968151,0.7040487887514822,0.046078265288836184
2000,KANSAS,MARSHALL,1831,218,3066,5115,0.3579667644183773,0.5994134897360703,0.042619745845552295
2000,KANSAS,MCPHERSON,3272,688,8501,12461,0.26257924725142445,0.6822084904903298,0.05521226225824573
2000,KANSAS,MEADE,400,49,1604,2053,0.1948368241597662,0.7812956648806625,0.023867510959571358
2000,KANSAS,MIAMI,4554,442,6611,11607,0.39234944430085295,0.5695700870164556,0.03808046868269148
2000,KANSAS,MITCHELL,751,165,2350,3266,0.2299448867115738,0.7195345988977342,0.05052051439069198
2000,KANSAS,MONTGOMERY,4770,479,8496,13745,0.34703528555838487,0.6181156784285194,0.03484903601309567
2000,KANSAS,MORRIS,882,160,1599,2641,0.3339644074214313,0.6054524801211663,0.0605831124574025
2000,KANSAS,MORTON,321,33,1203,1557,0.20616570327552985,0.7726396917148363,0.02119460500963391
2000,KANSAS,NEMAHA,1494,218,3578,5290,0.2824196597353497,0.6763705103969754,0.04120982986767486
2000,KANSAS,NEOSHO,2588,284,4014,6886,0.3758350275922161,0.5829218704618065,0.04124310194597734
2000,KANSAS,NESS,383,73,1420,1876,0.20415778251599148,0.7569296375266524,0.03891257995735608
2000,KANSAS,NORTON,598,109,1744,2451,0.24398204814361485,0.711546307629539,0.044471644226846185
2000,KANSAS,OSAGE,2530,313,3770,6613,0.3825797671253591,0.5700892182065628,0.04733101466807803
2000,KANSAS,OSBORNE,484,114,1432,2030,0.23842364532019705,0.7054187192118226,0.0561576354679803
2000,KANSAS,OTTAWA,631,183,1977,2791,0.22608384091723396,0.7083482622715872,0.06556789681117879
2000,KANSAS,PAWNEE,968,122,1850,2940,0.3292517006802721,0.6292517006802721,0.04149659863945578
2000,KANSAS,PHILLIPS,611,124,2057,2792,0.21883954154727794,0.7367478510028653,0.044412607449856735
2000,KANSAS,POTTAWATOMIE,2037,709,4985,7731,0.26348467209934034,0.6448066226878799,0.09170870521277971
2000,KANSAS,PRATT,1314,217,2885,4416,0.297554347826087,0.6533061594202898,0.04913949275362319
2000,KANSAS,RAWLINS,306,85,1349,1740,0.17586206896551723,0.7752873563218391,0.04885057471264368
2000,KANSAS,RENO,9025,1226,15179,25430,0.3548957923712151,0.5968934329532048,0.04821077467558002
2000,KANSAS,REPUBLIC,604,142,2239,2985,0.20234505862646565,0.7500837520938023,0.047571189279731994
2000,KANSAS,RICE,1422,195,2903,4520,0.3146017699115044,0.6422566371681416,0.04314159292035398
2000,KANSAS,RILEY,6188,1393,10672,18253,0.3390127650249274,0.584671012984167,0.07631622199090561
2000,KANSAS,ROOKS,597,162,2016,2775,0.21513513513513513,0.7264864864864865,0.05837837837837838
2000,KANSAS,RUSH,505,114,1235,1854,0.27238403451995685,0.6661272923408845,0.061488673139158574
2000,KANSAS,RUSSELL,886,162,2434,3482,0.25445146467547386,0.6990235496840896,0.04652498564043653
2000,KANSAS,SALINE,7487,1628,12412,21527,0.3477957913318159,0.5765782505690528,0.07562595809913132
2000,KANSAS,SCOTT,418,74,1811,2303,0.18150238818931827,0.7863656100738168,0.03213200173686496
2000,KANSAS,SEDGWICK,62561,7132,93724,163417,0.38283042767888287,0.5735266220772625,0.04364295024385468
2000,KANSAS,SEWARD,1126,101,3869,5096,0.22095761381475668,0.7592229199372057,0.019819466248037678
2000,KANSAS,SHAWNEE,34818,3661,35894,74373,0.46815376547940785,0.4826213814152986,0.049224853105293585
2000,KANSAS,SHERIDAN,281,76,1132,1489,0.18871725990597715,0.7602417730020148,0.05104096709200806
2000,KANSAS,SHERMAN,681,107,1894,2682,0.2539149888143177,0.7061894108873975,0.039895600298284865
2000,KANSAS,SMITH,534,116,1534,2184,0.2445054945054945,0.7023809523809523,0.05311355311355311
2000,KANSAS,STAFFORD,567,87,1546,2200,0.25772727272727275,0.7027272727272728,0.03954545454545454
2000,KANSAS,STANTON,215,29,785,1029,0.20894071914480078,0.7628765792031098,0.028182701652089408
2000,KANSAS,STEVENS,345,52,1714,2111,0.1634296541923259,0.8119374703931785,0.0246328754144955
2000,KANSAS,SUMNER,3549,507,6176,10232,0.3468530101641908,0.6035965598123534,0.04955043002345583
2000,KANSAS,THOMAS,807,151,2822,3780,0.21349206349206348,0.7465608465608465,0.039947089947089946
2000,KANSAS,TREGO,516,101,1220,1837,0.2808927599346761,0.6641262928688079,0.054980947196516056
2000,KANSAS,WABAUNSEE,1025,213,2182,3420,0.2997076023391813,0.6380116959064327,0.062280701754385964
2000,KANSAS,WALLACE,103,21,737,861,0.11962833914053426,0.8559814169570267,0.024390243902439025
2000,KANSAS,WASHINGTON,687,134,2446,3267,0.21028466483011937,0.7486991123354759,0.041016222834404654
2000,KANSAS,WICHITA,207,24,859,1090,0.18990825688073396,0.7880733944954128,0.022018348623853212
2000,KANSAS,WILSON,1186,161,2748,4095,0.28962148962148965,0.671062271062271,0.039316239316239315
2000,KANSAS,WOODSON,521,100,974,1595,0.3266457680250784,0.6106583072100313,0.06269592476489028
2000,KANSAS,WYANDOTTE,32411,1837,14024,48272,0.6714244282399735,0.2905203844879019,0.038055187272124626
2000,KENTUCKY,ADAIR,1779,89,5460,7328,0.2427674672489083,0.7450873362445415,0.012145196506550219
2000,KENTUCKY,ALLEN,1950,64,4415,6429,0.30331311245916937,0.6867319956447347,0.009954891896095816
2000,KENTUCKY,ANDERSON,2902,156,4909,7967,0.36425254173465543,0.6161666875862934,0.019580770679051087
2000,KENTUCKY,BALLARD,1880,66,1824,3770,0.4986737400530504,0.48381962864721484,0.01750663129973475
2000,KENTUCKY,BARREN,4930,173,8741,13844,0.35611095059231435,0.6313926610806125,0.0124963883270731
2000,KENTUCKY,BATH,2087,83,2303,4473,0.46657724122512856,0.514866979655712,0.018555779119159403
2000,KENTUCKY,BELL,4787,239,5585,10611,0.45113561398548674,0.5263405899538215,0.022523796060691735
2000,KENTUCKY,BOONE,9248,720,22016,31984,0.2891445722861431,0.688344172086043,0.022511255627813906
2000,KENTUCKY,BOURBON,3048,173,3881,7102,0.42917488031540413,0.5464657842861166,0.0243593353984793
2000,KENTUCKY,BOYD,9541,394,9247,19182,0.4973933896361172,0.4820665206964863,0.020540089667396517
2000,KENTUCKY,BOYLE,3963,237,6126,10326,0.38378849506101104,0.5932597327135386,0.02295177222545032
2000,KENTUCKY,BRACKEN,888,66,2065,3019,0.29413713150049686,0.6840013249420338,0.02186154355746936
2000,KENTUCKY,BREATHITT,2902,87,2084,5073,0.5720480977725212,0.41080228661541496,0.01714961561206387
2000,KENTUCKY,BRECKINRIDGE,2595,95,4763,7453,0.3481819401583255,0.6390715148262445,0.012746545015430029
2000,KENTUCKY,BULLITT,8195,452,14054,22701,0.3609973128937051,0.6190916699704859,0.019911017135808996
2000,KENTUCKY,BUTLER,1299,57,3654,5010,0.2592814371257485,0.7293413173652694,0.011377245508982036
2000,KENTUCKY,CALDWELL,2223,98,3161,5482,0.4055089383436702,0.5766143743159431,0.01787668734038672
2000,KENTUCKY,CALLOWAY,5635,333,7705,13673,0.4121260879104805,0.5635193446939223,0.024354567395597163
2000,KENTUCKY,CAMPBELL,12040,1000,20789,33829,0.35590765319696116,0.6145319104909989,0.029560436312039966
2000,KENTUCKY,CARLISLE,1149,39,1405,2593,0.4431160817585808,0.541843424604705,0.01504049363671423
2000,KENTUCKY,CARROLL,1601,80,1818,3499,0.45755930265790223,0.5195770220062875,0.02286367533581023
2000,KENTUCKY,CARTER,4182,160,4617,8959,0.4667931688804554,0.5153476950552517,0.017859136064292888
2000,KENTUCKY,CASEY,1122,63,4284,5469,0.20515633571036754,0.7833241908941305,0.01151947339550192
2000,KENTUCKY,CHRISTIAN,6778,208,10787,17773,0.3813649918415574,0.6069318629381646,0.01170314522027795
2000,KENTUCKY,CLARK,4918,258,7297,12473,0.3942916700072156,0.5850236510863465,0.020684678906437905
2000,KENTUCKY,CLAY,1723,70,4926,6719,0.25643696978717073,0.7331448132162525,0.010418216996576872
2000,KENTUCKY,CLINTON,1032,49,3224,4305,0.2397212543554007,0.7488966318234611,0.011382113821138212
2000,KENTUCKY,CRITTENDEN,1610,75,2469,4154,0.38757823784304285,0.5943668753009148,0.018054886856042368
2000,KENTUCKY,CUMBERLAND,736,50,2220,3006,0.24484364604125083,0.7385229540918163,0.0166333998669328
2000,KENTUCKY,DAVIESS,14126,753,21361,36240,0.38979028697571744,0.5894315673289183,0.02077814569536424
2000,KENTUCKY,EDMONSON,1710,35,3250,4995,0.34234234234234234,0.6506506506506506,0.007007007007007007
2000,KENTUCKY,ELLIOTT,1525,29,827,2381,0.6404871902561948,0.3473330533389332,0.012179756404871903
2000,KENTUCKY,ESTILL,1591,86,3033,4710,0.33779193205944796,0.6439490445859872,0.018259023354564755
2000,KENTUCKY,FAYETTE,47277,3705,54495,105477,0.4482209391620922,0.5166529195938451,0.035126141244062686
2000,KENTUCKY,FLEMING,1813,84,3282,5179,0.35006758061401816,0.6337130720216257,0.016219347364356054
2000,KENTUCKY,FLOYD,10088,238,5068,15394,0.6553202546446667,0.3292191763024555,0.015460569052877744
2000,KENTUCKY,FRANKLIN,10853,592,10209,21654,0.5012007019488316,0.471460238293156,0.027339059758012377
2000,KENTUCKY,FULTON,1452,43,1293,2788,0.5208034433285509,0.46377331420373025,0.015423242467718794
2000,KENTUCKY,GALLATIN,1049,65,1345,2459,0.4265961773078487,0.5469703131354209,0.026433509556730378
2000,KENTUCKY,GARRARD,1713,67,4043,5823,0.29417825862957236,0.6943156448566031,0.011506096513824489
2000,KENTUCKY,GRANT,2568,130,4405,7103,0.3615373785724342,0.6201604955652541,0.0183021258623117
2000,KENTUCKY,GRAVES,6097,285,7849,14231,0.42843089030988685,0.5515424074204202,0.020026702269692925
2000,KENTUCKY,GRAYSON,2604,111,5843,8558,0.3042767001635896,0.6827529796681467,0.012970320168263614
2000,KENTUCKY,GREEN,1085,56,3615,4756,0.22813288477712362,0.7600925147182507,0.011774600504625737
2000,KENTUCKY,GREENUP,7164,266,7233,14663,0.48857668962695217,0.4932824115119689,0.018140898861078905
2000,KENTUCKY,HANCOCK,1508,70,2032,3610,0.41772853185595565,0.5628808864265928,0.019390581717451522
2000,KENTUCKY,HARDIN,11095,631,18964,30690,0.36151840990550665,0.617921146953405,0.020560443141088302
2000,KENTUCKY,HARLAN,5365,190,4980,10535,0.5092548647365923,0.47271001423825343,0.018035121025154248
2000,KENTUCKY,HARRISON,2658,160,3793,6611,0.40205717743155345,0.5737407351384057,0.02420208743004084
2000,KENTUCKY,HART,2201,93,3725,6019,0.36567536135570694,0.6188735670377139,0.015451071606579166
2000,KENTUCKY,HENDERSON,8054,287,7698,16039,0.502151006920631,0.47995510942078684,0.017893883658582205
2000,KENTUCKY,HENRY,2117,112,3244,5473,0.3868079663804129,0.5927279371459894,0.020464096473597662
2000,KENTUCKY,HICKMAN,940,33,1151,2124,0.4425612052730697,0.5419020715630886,0.015536723163841809
2000,KENTUCKY,HOPKINS,6734,265,9490,16489,0.4083934744375038,0.5755352052883741,0.01607132027412214
2000,KENTUCKY,JACKSON,701,75,4079,4855,0.1443872296601442,0.8401647785787848,0.015447991761071062
2000,KENTUCKY,JEFFERSON,149901,7409,145052,302362,0.4957666638003453,0.47972959565024703,0.024503740549407665
2000,KENTUCKY,JESSAMINE,4633,354,10074,15061,0.3076156961689131,0.6688798884536219,0.023504415377464977
2000,KENTUCKY,JOHNSON,3251,146,4783,8180,0.39743276283618584,0.5847188264058679,0.01784841075794621
2000,KENTUCKY,KENTON,19100,1786,35363,56249,0.3395615922060837,0.6286867322085726,0.03175167558534374
2000,KENTUCKY,KNOTT,4349,80,2029,6458,0.6734283059770827,0.3141839578816971,0.012387736141220192
2000,KENTUCKY,KNOX,3690,162,6058,9910,0.37235116044399597,0.6113017154389505,0.016347124117053483
2000,KENTUCKY,LARUE,1727,68,3384,5179,0.33346205831241554,0.653407993821201,0.013129947866383471
2000,KENTUCKY,LAUREL,4856,235,13029,18120,0.26799116997792494,0.7190397350993377,0.012969094922737307
2000,KENTUCKY,LAWRENCE,2258,80,2969,5307,0.4254757866968155,0.5594497833050688,0.015074429998115696
2000,KENTUCKY,LEE,836,35,1893,2764,0.3024602026049204,0.684876989869754,0.012662807525325614
2000,KENTUCKY,LESLIE,1210,65,3159,4434,0.2728912945421741,0.7124492557510149,0.014659449706811005
2000,KENTUCKY,LETCHER,4698,195,4092,8985,0.5228714524207012,0.45542570951585976,0.021702838063439065
2000,KENTUCKY,LEWIS,1293,58,3217,4568,0.2830560420315236,0.704246935201401,0.012697022767075307
2000,KENTUCKY,LINCOLN,2678,124,4795,7597,0.3525075687771489,0.6311701987626694,0.016322232460181652
2000,KENTUCKY,LIVINGSTON,2022,90,2118,4230,0.47801418439716314,0.500709219858156,0.02127659574468085
2000,KENTUCKY,LOGAN,3885,103,5344,9332,0.41630947278182595,0.5726532361765967,0.011037291041577368
2000,KENTUCKY,LYON,1680,52,1688,3420,0.49122807017543857,0.4935672514619883,0.0152046783625731
2000,KENTUCKY,MADISON,9309,675,13682,23666,0.39334910842558946,0.5781289613791938,0.028521930195216767
2000,KENTUCKY,MAGOFFIN,2603,65,2785,5453,0.47735191637630664,0.5107280396112232,0.0119200440124702
2000,KENTUCKY,MARION,2778,139,3259,6176,0.4498056994818653,0.5276878238341969,0.022506476683937824
2000,KENTUCKY,MARSHALL,6203,264,7294,13761,0.4507666593997529,0.5300486883220696,0.019184652278177457
2000,KENTUCKY,MARTIN,1714,75,2667,4456,0.3846499102333932,0.5985188509874326,0.016831238779174147
2000,KENTUCKY,MASON,2178,123,3572,5873,0.37084965094500255,0.6082070492082411,0.020943299846756344
2000,KENTUCKY,MCCRACKEN,11412,532,14745,26689,0.42759189179062534,0.5524748023530294,0.019933305856345312
2000,KENTUCKY,MCCREARY,1418,60,3321,4799,0.2954782246301313,0.6920191706605543,0.012502604709314441
2000,KENTUCKY,MCLEAN,1747,56,2219,4022,0.43436101442068625,0.5517155643958229,0.0139234211834908
2000,KENTUCKY,MEADE,3596,156,5319,9071,0.3964281777091831,0.586374159409106,0.017197662881710946
2000,KENTUCKY,MENIFEE,1038,41,1170,2249,0.46153846153846156,0.5202312138728323,0.01823032458870609
2000,KENTUCKY,MERCER,3092,178,5362,8632,0.35820203892493047,0.621177015755329,0.0206209453197405
2000,KENTUCKY,METCALFE,1318,55,2476,3849,0.3424266043128085,0.6432839698623019,0.014289425824889582
2000,KENTUCKY,MONROE,1158,34,4377,5569,0.2079367929610343,0.785957981684324,0.006105225354641767
2000,KENTUCKY,MONTGOMERY,3833,152,4534,8519,0.44993543843174083,0.5322220917948116,0.017842469773447587
2000,KENTUCKY,MORGAN,1875,70,2295,4240,0.44221698113207547,0.5412735849056604,0.01650943396226415
2000,KENTUCKY,MUHLENBERG,6295,143,5518,11956,0.5265138842422215,0.46152559384409503,0.011960521913683506
2000,KENTUCKY,NELSON,5481,293,7714,13488,0.40636120996441283,0.5719157769869514,0.021723013048635824
2000,KENTUCKY,NICHOLAS,994,66,1613,2673,0.37186681631126073,0.6034418256640479,0.024691358024691357
2000,KENTUCKY,OHIO,3303,166,5413,8882,0.3718757036703445,0.609434811979284,0.018689484350371537
2000,KENTUCKY,OLDHAM,6236,452,13580,20268,0.3076771265048352,0.6700217090980857,0.02230116439707914
2000,KENTUCKY,OWEN,1394,94,2582,4070,0.34250614250614253,0.6343980343980344,0.023095823095823097
2000,KENTUCKY,OWSLEY,339,21,1466,1826,0.18565169769989048,0.8028477546549836,0.011500547645125958
2000,KENTUCKY,PENDLETON,1670,89,3044,4803,0.3476993545700604,0.633770560066625,0.018530085363314595
2000,KENTUCKY,PERRY,5514,186,5300,11000,0.5012727272727273,0.4818181818181818,0.01690909090909091
2000,KENTUCKY,PIKE,13611,319,11005,24935,0.5458592340084218,0.4413475035091237,0.012793262482454382
2000,KENTUCKY,POWELL,2008,96,2258,4362,0.4603392939018799,0.5176524530032095,0.02200825309491059
2000,KENTUCKY,PULASKI,5415,281,15845,21541,0.25138108722900515,0.7355740216331647,0.013044891137830184
2000,KENTUCKY,ROBERTSON,341,27,630,998,0.34168336673346694,0.6312625250501002,0.027054108216432865
2000,KENTUCKY,ROCKCASTLE,1174,81,3992,5247,0.223746902992186,0.7608157042119307,0.015437392795883362
2000,KENTUCKY,ROWAN,3505,175,3546,7226,0.48505397176861337,0.49072792693052864,0.024218101300858014
2000,KENTUCKY,RUSSELL,1710,96,5268,7074,0.24173027989821882,0.7446988973706531,0.013570822731128074
2000,KENTUCKY,SCOTT,5472,362,7952,13786,0.39692441607427825,0.5768170607863049,0.0262585231394168
2000,KENTUCKY,SHELBY,4435,235,8068,12738,0.34817082744543887,0.6333804364892448,0.018448736065316378
2000,KENTUCKY,SIMPSON,2583,72,3169,5824,0.44350961538461536,0.5441277472527473,0.012362637362637362
2000,KENTUCKY,SPENCER,1554,68,3150,4772,0.3256496227996647,0.6601005867560771,0.014249790444258172
2000,KENTUCKY,TAYLOR,2790,110,6151,9051,0.3082532316871064,0.679593415092255,0.012153353220638603
2000,KENTUCKY,TODD,1496,45,2646,4187,0.3572963935992357,0.6319560544542632,0.010747551946501075
2000,KENTUCKY,TRIGG,2110,104,3130,5344,0.3948353293413174,0.5857035928143712,0.019461077844311378
2000,KENTUCKY,TRIMBLE,1181,63,1837,3081,0.38331710483609216,0.596234988640052,0.02044790652385589
2000,KENTUCKY,UNION,2547,72,2749,5368,0.474478390461997,0.5121087928464978,0.013412816691505217
2000,KENTUCKY,WARREN,12180,560,20235,32975,0.36937073540561033,0.6136467020470053,0.01698256254738438
2000,KENTUCKY,WASHINGTON,1458,86,3044,4588,0.3177855274629468,0.6634699215344376,0.018744551002615517
2000,KENTUCKY,WAYNE,2312,93,4069,6474,0.3571207908557306,0.6285140562248996,0.014365152919369786
2000,KENTUCKY,WEBSTER,2388,85,2599,5072,0.47082018927444796,0.5124211356466877,0.016758675078864353
2000,KENTUCKY,WHITLEY,4101,171,7502,11774,0.3483098352301682,0.637166638355699,0.014523526414132836
2000,KENTUCKY,WOLFE,1136,22,1267,2425,0.46845360824742266,0.5224742268041237,0.009072164948453608
2000,KENTUCKY,WOODFORD,3995,252,5890,10137,0.39410081878267733,0.581039755351682,0.024859425865640723
2000,LOUISIANA,ACADIA,8892,532,13814,23238,0.3826491092176607,0.5944573543334194,0.022893536448919873
2000,LOUISIANA,ALLEN,3914,343,4035,8292,0.4720212252773758,0.4866136034732272,0.04136517124939701
2000,LOUISIANA,ASCENSION,13385,641,16818,30844,0.4339579821034885,0.5452600181558812,0.020781999740630268
2000,LOUISIANA,ASSUMPTION,5222,443,4388,10053,0.5194469312642992,0.43648662090918133,0.044066447826519445
2000,LOUISIANA,AVOYELLES,6701,623,7329,14653,0.4573124957346618,0.5001706135262404,0.0425168907390978
2000,LOUISIANA,BEAUREGARD,3958,385,7862,12205,0.32429332240884884,0.6441622285948382,0.031544448996312986
2000,LOUISIANA,BIENVILLE,3413,324,3269,7006,0.48715386811304595,0.4666000570939195,0.04624607479303454
2000,LOUISIANA,BOSSIER,11933,758,23224,35915,0.3322567172490603,0.6466378950299317,0.021105387721007934
2000,LOUISIANA,CADDO,47530,1302,46807,95639,0.4969729921893788,0.4894133146519725,0.013613693158648668
2000,LOUISIANA,CALCASIEU,33919,1631,38086,73636,0.46063066978108536,0.5172198381226574,0.022149492096257266
2000,LOUISIANA,CALDWELL,1359,152,2817,4328,0.3140018484288355,0.6508780036968577,0.03512014787430684
2000,LOUISIANA,CAMERON,1435,155,2593,4183,0.34305522352378676,0.6198900310781735,0.037054745398039685
2000,LOUISIANA,CATAHOULA,1718,135,2912,4765,0.3605456453305351,0.6111227701993704,0.02833158447009444
2000,LOUISIANA,CLAIBORNE,2721,176,3384,6281,0.4332112720904315,0.5387677121477472,0.028021015761821366
2000,LOUISIANA,CONCORDIA,3569,303,4627,8499,0.41993175667725613,0.5444169902341452,0.03565125308859866
2000,LOUISIANA,DE SOTO,5036,300,5260,10596,0.47527368818422044,0.4964137410343526,0.028312570781426953
2000,LOUISIANA,EAST BATON ROUGE,76516,3345,89128,168989,0.45278686778429367,0.5274189444283356,0.019794187787370774
2000,LOUISIANA,EAST CARROLL,1876,89,1280,3245,0.578120184899846,0.39445300462249616,0.027426810477657937
2000,LOUISIANA,EAST FELICIANA,3870,178,4051,8099,0.4778367699716014,0.5001852080503766,0.02197802197802198
2000,LOUISIANA,EVANGELINE,5763,559,7290,13612,0.4233764325595063,0.5355568615927123,0.04106670584778137
2000,LOUISIANA,FRANKLIN,2792,201,5363,8356,0.33413116323599806,0.6418142651986597,0.02405457156534227
2000,LOUISIANA,GRANT,2099,172,4784,7055,0.29751948972360026,0.6781006378454997,0.02437987243090007
2000,LOUISIANA,IBERIA,11762,1022,17236,30020,0.39180546302465025,0.5741505662891405,0.03404397068620919
2000,LOUISIANA,IBERVILLE,8355,575,5573,14503,0.5760877059918638,0.38426532441563815,0.0396469695924981
2000,LOUISIANA,JACKSON,2582,177,4347,7106,0.36335491134252745,0.6117365606529693,0.024908528004503237
2000,LOUISIANA,JEFFERSON,70411,3737,105003,179151,0.39302599483117595,0.5861145067568699,0.020859498411954162
2000,LOUISIANA,JEFFERSON DAVIS,5162,439,6945,12546,0.411445879164674,0.5535628885700622,0.03499123226526383
2000,LOUISIANA,LA SALLE,1397,147,4564,6108,0.22871643745907008,0.7472167648984938,0.02406679764243615
2000,LOUISIANA,LAFAYETTE,27190,2612,48491,78293,0.34728519791041346,0.6193529434304471,0.03336185865913939
2000,LOUISIANA,LAFOURCHE,14627,1247,18575,34449,0.42459868210978546,0.5392028796191471,0.036198438271067376
2000,LOUISIANA,LINCOLN,6851,454,9246,16551,0.4139326928886472,0.558636940366141,0.02743036674521177
2000,LOUISIANA,LIVINGSTON,11008,968,24889,36865,0.2986030109860301,0.6751390207513902,0.026257968262579683
2000,LOUISIANA,MADISON,2489,127,2127,4743,0.5247733502002951,0.4484503478810879,0.02677630191861691
2000,LOUISIANA,MOREHOUSE,5289,391,6641,12321,0.42926710494278064,0.5389984579173769,0.031734437139842545
2000,LOUISIANA,NATCHITOCHES,6924,601,7332,14857,0.4660429427206031,0.49350474523793497,0.040452312041461935
2000,LOUISIANA,ORLEANS,137630,4187,39404,181221,0.7594594445456101,0.2174361690974004,0.023104386356989533
2000,LOUISIANA,OUACHITA,21457,1647,35107,58211,0.36860730789713286,0.603099070622391,0.0282936214804762
2000,LOUISIANA,PLAQUEMINES,4425,204,6302,10931,0.4048120025615223,0.5765254779983533,0.01866251944012442
2000,LOUISIANA,POINTE COUPEE,5813,309,4710,10832,0.5366506646971935,0.4348227474150665,0.02852658788774003
2000,LOUISIANA,RAPIDES,18898,1295,28831,49024,0.38548466057441255,0.5880997062663186,0.02641563315926893
2000,LOUISIANA,RED RIVER,2177,145,2200,4522,0.48142414860681115,0.4865103936311367,0.03206545776205219
2000,LOUISIANA,RICHLAND,3282,308,4895,8485,0.3868002357100766,0.576900412492634,0.03629935179728933
2000,LOUISIANA,SABINE,2846,262,5754,8862,0.32114646806589936,0.6492890995260664,0.029564432408034302
2000,LOUISIANA,ST. BERNARD,11682,684,16255,28621,0.4081618392089724,0.567939624751057,0.02389853603997065
2000,LOUISIANA,ST. CHARLES,8918,611,11981,21510,0.41459786145978617,0.5569967456996746,0.028405392840539286
2000,LOUISIANA,ST. HELENA,3059,230,1965,5254,0.5822230681385611,0.374000761324705,0.04377617053673392
2000,LOUISIANA,ST. JAMES,6523,369,3813,10705,0.6093414292386735,0.3561886968706212,0.03446987389070528
2000,LOUISIANA,ST. JOHN THE BAPTIST,9745,545,7423,17713,0.550160898774911,0.4190707390052504,0.030768362219838537
2000,LOUISIANA,ST. LANDRY,18067,635,15449,34151,0.5290328248074727,0.45237328335919885,0.018593891833328453
2000,LOUISIANA,ST. MARTIN,9853,964,9961,20778,0.4742034844547117,0.4794012898257773,0.04639522571951102
2000,LOUISIANA,ST. MARY,9851,634,11325,21810,0.45167354424575884,0.5192572214580468,0.029069234296194405
2000,LOUISIANA,ST. TAMMANY,22722,1822,59193,83737,0.2713495826217801,0.7068918160430873,0.02175860133513262
2000,LOUISIANA,TANGIPAHOA,15843,891,20421,37155,0.42640290674202663,0.549616471538151,0.023980621719822365
2000,LOUISIANA,TENSAS,1580,100,1330,3010,0.5249169435215947,0.4418604651162791,0.03322259136212625
2000,LOUISIANA,TERREBONNE,14414,947,21314,36675,0.39301976823449214,0.5811588275391957,0.0258214042263122
2000,LOUISIANA,UNION,3205,366,5772,9343,0.34303756823290166,0.6177887188269292,0.03917371294016911
2000,LOUISIANA,VERMILION,8704,1036,12495,22235,0.3914549134247807,0.5619518776703396,0.046593208904879696
2000,LOUISIANA,VERNON,4655,378,8794,13827,0.3366601576625443,0.6360020250235048,0.027337817313950966
2000,LOUISIANA,WASHINGTON,7399,505,8983,16887,0.43814768757032035,0.5319476520400308,0.029904660389648844
2000,LOUISIANA,WEBSTER,7197,473,9420,17090,0.4211234640140433,0.5511995318899942,0.027677004095962552
2000,LOUISIANA,WEST BATON ROUGE,5058,187,4924,10169,0.49739404071196774,0.4842167371422952,0.018389222145737044
2000,LOUISIANA,WEST CARROLL,1319,136,3220,4675,0.2821390374331551,0.6887700534759358,0.02909090909090909
2000,LOUISIANA,WEST FELICIANA,2187,161,2512,4860,0.45,0.516872427983539,0.0331275720164609
2000,LOUISIANA,WINN,2167,166,4028,6361,0.3406697060210659,0.6332337682754284,0.02609652570350574
2000,MAINE,ANDROSCOGGIN,26251,3046,19948,49245,0.5330693471418418,0.4050766575286831,0.061853995329475074
2000,MAINE,AROOSTOOK,17196,1392,16555,35143,0.48931508408502405,0.47107532083202913,0.03960959508294682
2000,MAINE,CUMBERLAND,74203,9874,58543,142620,0.5202846725564437,0.4104824007853036,0.0692329266582527
2000,MAINE,FRANKLIN,7593,1396,6459,15448,0.49151993785603315,0.41811237700673226,0.09036768513723459
2000,MAINE,HANCOCK,12983,2859,12732,28574,0.45436410723034926,0.44557989780919716,0.10005599496045356
2000,MAINE,KENNEBEC,31198,3742,23967,58907,0.529614477057056,0.40686166329977763,0.06352385964316634
2000,MAINE,KNOX,9453,2080,8968,20501,0.46109945856299694,0.43744207599629287,0.10145846544071022
2000,MAINE,LINCOLN,8634,1580,9457,19671,0.43892023791368,0.48075847694575774,0.08032128514056225
2000,MAINE,MAINE UOCAVA,0,0,0,0,,,
2000,MAINE,OXFORD,13649,2009,11835,27493,0.4964536427454261,0.43047321136289235,0.07307314589168151
2000,MAINE,PENOBSCOT,32868,4718,35620,73206,0.4489795918367347,0.48657213889571893,0.06444826926754638
2000,MAINE,PISCATAQUIS,3745,666,4845,9256,0.40460242005185826,0.5234442523768367,0.0719533275713051
2000,MAINE,SAGADAHOC,8844,1510,8052,18406,0.48049549060089103,0.43746604368140823,0.08203846571770075
2000,MAINE,SOMERSET,11538,1729,10684,23951,0.4817335393094234,0.4460774080414179,0.0721890526491587
2000,MAINE,WALDO,8477,1972,8689,19138,0.4429407461594733,0.45401818371825686,0.10304107012226983
2000,MAINE,WASHINGTON,6701,1049,7958,15708,0.42659791189202956,0.506620830150242,0.06678125795772855
2000,MAINE,YORK,46618,5628,42304,94550,0.4930512956107879,0.44742464304600743,0.059524061343204655
2000,MARYLAND,ALLEGANY,10894,821,14656,26371,0.41310530506996324,0.555762011300292,0.031132683629744796
2000,MARYLAND,ANNE ARUNDEL,89624,6824,104209,200657,0.446652745730276,0.5193389714786925,0.03400828279103146
2000,MARYLAND,BALTIMORE,160635,10416,133033,304084,0.5282586390602597,0.4374876678812433,0.034253693058496994
2000,MARYLAND,BALTIMORE CITY,158765,6489,27150,192404,0.8251647574894493,0.14110933244631088,0.03372591006423983
2000,MARYLAND,CALVERT,12986,816,16004,29806,0.4356840904515869,0.5369388713681809,0.02737703818023217
2000,MARYLAND,CAROLINE,3396,256,5300,8952,0.37935656836461124,0.5920464700625558,0.028596961572832886
2000,MARYLAND,CARROLL,20146,2139,41742,64027,0.3146485076608306,0.6519437112468177,0.033407781092351665
2000,MARYLAND,CECIL,12327,1055,15494,28876,0.4268943066906774,0.5365701620723092,0.03653553123701344
2000,MARYLAND,CHARLES,21873,951,21768,44592,0.49051399354144243,0.4881593110871905,0.021326695371367062
2000,MARYLAND,DORCHESTER,5232,313,5847,11392,0.4592696629213483,0.5132549157303371,0.027475421348314606
2000,MARYLAND,FREDERICK,30725,2586,45350,78661,0.3906001703512541,0.5765245801604353,0.032875249488310596
2000,MARYLAND,GARRETT,2872,269,7514,10655,0.2695448146410136,0.7052088221492258,0.025246363209760675
2000,MARYLAND,HARFORD,35665,2897,52862,91424,0.3901054427721386,0.5782070353517675,0.031687521876093805
2000,MARYLAND,HOWARD,58556,4414,49809,112779,0.5192101366389132,0.4416513712659272,0.03913849209515956
2000,MARYLAND,KENT,3627,303,4155,8085,0.44860853432282005,0.5139146567717996,0.037476808905380334
2000,MARYLAND,MONTGOMERY,232453,14655,124580,371688,0.6253981834226555,0.3351735864488496,0.03942823012849487
2000,MARYLAND,PRINCE GEORGE'S,216119,5803,49987,271909,0.7948210614580613,0.18383723966474078,0.021341698877197886
2000,MARYLAND,QUEEN ANNE'S,6257,534,9970,16761,0.3733070819163534,0.5948332438398664,0.0318596742437802
2000,MARYLAND,SOMERSET,3785,210,3609,7604,0.49776433456075747,0.47461862177801156,0.027617043661230932
2000,MARYLAND,ST. MARY'S,11912,733,16856,29501,0.4037829226127928,0.5713704620182367,0.024846615368970544
2000,MARYLAND,TALBOT,5854,506,8874,15234,0.3842720231062098,0.5825128003150847,0.03321517657870553
2000,MARYLAND,WASHINGTON,18221,1301,27948,47470,0.38384242679587105,0.5887507899726143,0.02740678323151464
2000,MARYLAND,WICOMICO,14469,988,16338,31795,0.45507155213083816,0.513854379619437,0.0310740682497248
2000,MARYLAND,WORCESTER,9389,622,10742,20753,0.4524165180937696,0.5176119115308631,0.029971570375367417
2000,MASSACHUSETTS,BARNSTABLE,62363,9037,49686,121086,0.5150306393802752,0.41033645508151234,0.07463290553821252
2000,MASSACHUSETTS,BERKSHIRE,37934,5672,15805,59411,0.638501287640336,0.2660281766002929,0.09547053575937116
2000,MASSACHUSETTS,BRISTOL,136325,12164,62848,211337,0.645059786028949,0.29738285297889155,0.05755736099215944
2000,MASSACHUSETTS,DUKES,5474,1067,2315,8856,0.6181120144534779,0.26140469738030714,0.120483288166215
2000,MASSACHUSETTS,ESSEX,178400,21923,110010,310333,0.5748663532399068,0.35449017668117794,0.07064347007891524
2000,MASSACHUSETTS,FRANKLIN,17945,5245,10176,33366,0.5378229335251453,0.3049811185038662,0.15719594797098843
2000,MASSACHUSETTS,HAMPDEN,100103,12432,59558,172093,0.5816796731999558,0.34608031703788067,0.07224000976216348
2000,MASSACHUSETTS,HAMPSHIRE,38543,10881,19202,68626,0.5616384460700026,0.27980648733716085,0.15855506659283652
2000,MASSACHUSETTS,MIDDLESEX,404043,54091,198914,657048,0.6149368082697154,0.30273891709585904,0.08232427463442549
2000,MASSACHUSETTS,NANTUCKET,2874,428,1624,4926,0.5834348355663824,0.32967925294356476,0.08688591149005279
2000,MASSACHUSETTS,NORFOLK,188450,21694,107033,317177,0.5941477471569502,0.3374551118145389,0.0683971410285109
2000,MASSACHUSETTS,PLYMOUTH,115376,13450,82751,211577,0.5453144717998648,0.39111529135964684,0.06357023684048833
2000,MASSACHUSETTS,SUFFOLK,154888,17671,44441,217000,0.7137695852534562,0.20479723502304148,0.08143317972350231
2000,MASSACHUSETTS,WORCESTER,173769,22240,114139,310148,0.560277673884726,0.36801462527567486,0.07170770083959915
2000,MICHIGAN,ALCONA,2696,149,3152,5997,0.4495581123895281,0.5255961313990328,0.024845756211439054
2000,MICHIGAN,ALGER,2071,153,2142,4366,0.4743472285845167,0.4906092533211177,0.03504351809436555
2000,MICHIGAN,ALLEGAN,15495,1199,28197,44891,0.34516941034951326,0.6281214497337997,0.026709139916687087
2000,MICHIGAN,ALPENA,7053,310,6769,14132,0.49908010189640534,0.4789838664024908,0.021936031701103878
2000,MICHIGAN,ANTRIM,4329,398,6780,11507,0.3762057877813505,0.5892065699139654,0.034587642304684106
2000,MICHIGAN,ARENAC,3685,161,3421,7267,0.5070868308793175,0.4707582220999037,0.022154947020778862
2000,MICHIGAN,BARAGA,1400,157,1836,3393,0.412614205717654,0.5411140583554377,0.04627173592690834
2000,MICHIGAN,BARRY,9769,759,15716,26244,0.37223746380124983,0.5988416399939034,0.02892089620484682
2000,MICHIGAN,BAY,28251,1235,22150,51636,0.5471182895654195,0.4289642884809048,0.02391742195367573
2000,MICHIGAN,BENZIE,3546,354,4172,8072,0.4392963330029732,0.5168483647175421,0.043855302279484636
2000,MICHIGAN,BERRIEN,28152,1400,35689,65241,0.4315077941785074,0.5470333072760993,0.021458898545393235
2000,MICHIGAN,BRANCH,6691,349,8743,15783,0.4239371475638345,0.5539504530190712,0.022112399417094343
2000,MICHIGAN,CALHOUN,27312,1477,26291,55080,0.4958605664488017,0.4773238925199709,0.026815541031227307
2000,MICHIGAN,CASS,8808,472,10545,19825,0.4442875157629256,0.5319041614123581,0.023808322824716267
2000,MICHIGAN,CHARLEVOIX,4958,511,7018,12487,0.39705293505245454,0.5620245054857052,0.04092255946184031
2000,MICHIGAN,CHEBOYGAN,5484,318,6815,12617,0.43465166045811204,0.5401442498216692,0.02520408972021875
2000,MICHIGAN,CHIPPEWA,6370,458,7526,14354,0.44377873763410897,0.524313780130974,0.031907482234917094
2000,MICHIGAN,CLARE,6287,383,5937,12607,0.4986912032997541,0.4709288490521139,0.03037994764813199
2000,MICHIGAN,CLINTON,13394,751,18054,32199,0.4159756514177459,0.560700642877108,0.023323705705146122
2000,MICHIGAN,CRAWFORD,2790,229,3345,6364,0.43840351979886866,0.52561282212445,0.03598365807668133
2000,MICHIGAN,DELTA,7970,475,8871,17316,0.46026796026796024,0.5123007623007623,0.02743127743127743
2000,MICHIGAN,DICKINSON,5533,367,6932,12832,0.43118765586034913,0.5402119700748129,0.028600374064837904
2000,MICHIGAN,EATON,23211,1258,24803,49272,0.47107890891378473,0.5033893489202793,0.02553174216593603
2000,MICHIGAN,EMMET,5451,658,8602,14711,0.3705390524097614,0.5847325130854463,0.04472843450479233
2000,MICHIGAN,GENESEE,119833,4391,66641,190865,0.6278416681947974,0.34915254237288135,0.023005789432321275
2000,MICHIGAN,GLADWIN,5573,313,5743,11629,0.4792329521025024,0.49385157795167256,0.026915469945825093
2000,MICHIGAN,GOGEBIC,4066,344,3929,8339,0.4875884398608946,0.4711596114642043,0.04125194867490107
2000,MICHIGAN,GRAND TRAVERSE,14371,1500,22358,38229,0.37591880509560804,0.5848439666221978,0.03923722828219415
2000,MICHIGAN,GRATIOT,6538,329,8312,15179,0.4307266618354305,0.5475986560379472,0.021674682126622307
2000,MICHIGAN,HILLSDALE,6495,495,10483,17473,0.37171636238768385,0.5999542150746867,0.028329422537629486
2000,MICHIGAN,HOUGHTON,5688,633,7895,14216,0.4001125492402926,0.5553601575689364,0.044527293190770964
2000,MICHIGAN,HURON,6899,285,8911,16095,0.4286424355389873,0.553650201926064,0.017707362534948742
2000,MICHIGAN,INGHAM,69231,4050,47314,120595,0.5740785273021269,0.3923379907956383,0.03358348190223475
2000,MICHIGAN,IONIA,9481,574,13915,23970,0.3955360867751356,0.580517313308302,0.02394659991656237
2000,MICHIGAN,IOSCO,6505,372,6345,13222,0.491983058538799,0.47988201482377857,0.028134926637422477
2000,MICHIGAN,IRON,3014,207,2967,6188,0.4870717517776341,0.4794764059469942,0.033451842275371686
2000,MICHIGAN,ISABELLA,10228,788,10053,21069,0.48545256063410697,0.4771465185818026,0.03740092078409037
2000,MICHIGAN,JACKSON,28160,1720,32066,61946,0.4545894811610112,0.5176443999612566,0.02776611887773222
2000,MICHIGAN,KALAMAZOO,48807,3595,48254,100656,0.48488912732474965,0.4793951676998887,0.035715704975361626
2000,MICHIGAN,KALKASKA,2774,233,3842,6849,0.40502263104102787,0.5609578040589868,0.0340195648999854
2000,MICHIGAN,KENT,95442,6274,148602,250318,0.38128300801380643,0.593652873544851,0.02506411844134261
2000,MICHIGAN,KEWEENAW,540,63,740,1343,0.40208488458674607,0.5510052122114668,0.04690990320178704
2000,MICHIGAN,LAKE,2584,148,1961,4693,0.5506072874493927,0.4178563818453015,0.03153633070530577
2000,MICHIGAN,LAPEER,15749,1134,20351,37234,0.4229736262555729,0.5465703389375303,0.03045603480689692
2000,MICHIGAN,LEELANAU,4635,534,6840,12009,0.3859605296027979,0.5695728203847115,0.04446665001249063
2000,MICHIGAN,LENAWEE,18365,1047,20681,40093,0.45806001047564415,0.5158257052353279,0.02611428428902801
2000,MICHIGAN,LIVINGSTON,28780,2058,44637,75475,0.3813183173236171,0.5914143756210666,0.02726730705531633
2000,MICHIGAN,LUCE,956,100,1480,2536,0.37697160883280756,0.583596214511041,0.03943217665615142
2000,MICHIGAN,MACKINAC,2533,165,3272,5970,0.42428810720268006,0.5480737018425461,0.02763819095477387
2000,MICHIGAN,MACOMB,172625,8669,164265,345559,0.49955289834731553,0.47536021345124857,0.025086888201435936
2000,MICHIGAN,MANISTEE,5639,388,5401,11428,0.4934371718585929,0.4726111305565278,0.033951697584879245
2000,MICHIGAN,MARQUETTE,15503,1099,12577,29179,0.5313067617121903,0.4310291648103088,0.03766407347750094
2000,MICHIGAN,MASON,5579,371,7066,13016,0.42862630608481866,0.5428703134603565,0.028503380454824832
2000,MICHIGAN,MECOSTA,6300,382,8072,14754,0.4270028466856446,0.5471058695946862,0.025891283719669242
2000,MICHIGAN,MENOMINEE,4597,308,5529,10434,0.4405788767490895,0.5299022426682001,0.02951888058271037
2000,MICHIGAN,MIDLAND,15959,1042,21887,38888,0.4103836659123637,0.5628214359185353,0.02679489816910101
2000,MICHIGAN,MISSAUKEE,2062,160,4274,6496,0.31742610837438423,0.6579433497536946,0.024630541871921183
2000,MICHIGAN,MONROE,31555,1300,28940,61795,0.5106400194190468,0.4683226798284651,0.021037300752488067
2000,MICHIGAN,MONTCALM,9627,581,12696,22904,0.4203195948305973,0.5543136570031435,0.025366748166259168
2000,MICHIGAN,MONTMORENCY,2139,120,2750,5009,0.4270313435815532,0.5490117787981633,0.02395687762028349
2000,MICHIGAN,MUSKEGON,37865,1377,30028,69270,0.5466291323805399,0.4334921322361773,0.019878735383282806
2000,MICHIGAN,NEWAYGO,7677,481,11399,19557,0.39254486884491485,0.5828603569054559,0.02459477424962929
2000,MICHIGAN,OAKLAND,281201,14745,274319,570265,0.4931058367601028,0.4810377631452044,0.025856400094692818
2000,MICHIGAN,OCEANA,4597,262,5913,10772,0.4267545488303008,0.5489231340512439,0.024322317118455256
2000,MICHIGAN,OGEMAW,4896,253,4706,9855,0.4968036529680365,0.47752409944190766,0.02567224759005581
2000,MICHIGAN,ONTONAGON,1514,165,2472,4151,0.3647313900264996,0.5955191520115635,0.03974945796193688
2000,MICHIGAN,OSCEOLA,4006,244,5680,9930,0.40342396777442097,0.5720040281973817,0.024572004028197383
2000,MICHIGAN,OSCODA,1677,108,2207,3992,0.42009018036072143,0.5528557114228457,0.027054108216432865
2000,MICHIGAN,OTSEGO,4034,363,6108,10505,0.38400761542122797,0.5814374107567825,0.03455497382198953
2000,MICHIGAN,OTTAWA,29600,2296,78703,110599,0.2676335229070787,0.7116067957214803,0.02075968137144097
2000,MICHIGAN,PRESQUE ISLE,3242,178,3660,7080,0.457909604519774,0.5169491525423728,0.02514124293785311
2000,MICHIGAN,ROSCOMMON,6433,305,6190,12928,0.49760210396039606,0.4788056930693069,0.02359220297029703
2000,MICHIGAN,SAGINAW,50825,1779,41152,93756,0.542098639020436,0.43892657536584323,0.01897478561372072
2000,MICHIGAN,SANILAC,7153,447,10966,18566,0.38527415706129486,0.5906495744910051,0.024076268447700097
2000,MICHIGAN,SCHOOLCRAFT,2036,74,2088,4198,0.4849928537398761,0.4973797046212482,0.017627441638875654
2000,MICHIGAN,SHIAWASSEE,15520,882,15816,32218,0.48171829412129863,0.49090570488546775,0.027376000993233597
2000,MICHIGAN,ST. CLAIR,33002,1943,33571,68516,0.48166851538326816,0.48997314495884176,0.028358339657890128
2000,MICHIGAN,ST. JOSEPH,8574,544,12906,22024,0.38930257900472215,0.5859970940791863,0.024700326916091538
2000,MICHIGAN,TUSCOLA,10845,594,13213,24652,0.4399237384390719,0.5359808534804479,0.024095408080480284
2000,MICHIGAN,VAN BUREN,13796,894,14792,29482,0.4679465436537548,0.5017298690726545,0.030323587273590667
2000,MICHIGAN,WASHTENAW,86647,5834,52459,144940,0.5978128880916241,0.3619359735062785,0.04025113840209742
2000,MICHIGAN,WAYNE,530414,15192,223021,768627,0.690079843669296,0.29015504269300973,0.019765113637694225
2000,MICHIGAN,WEXFORD,5326,441,7215,12982,0.41026036049915265,0.5557695270374364,0.033970112463410876
2000,MINNESOTA,AITKIN,3830,675,3755,8260,0.463680387409201,0.45460048426150124,0.08171912832929783
2000,MINNESOTA,ANOKA,68008,8355,69256,145619,0.467026967634718,0.475597277827756,0.05737575453752601
2000,MINNESOTA,BECKER,5253,928,8152,14333,0.3664968952766343,0.5687574129630921,0.06474569176027349
2000,MINNESOTA,BELTRAMI,7301,1570,8346,17217,0.42405761747110415,0.48475344136609166,0.09118894116280421
2000,MINNESOTA,BENTON,6009,1236,7663,14908,0.403072176012879,0.5140193184867186,0.08290850550040246
2000,MINNESOTA,BIG STONE,1430,180,1370,2980,0.4798657718120805,0.4597315436241611,0.06040268456375839
2000,MINNESOTA,BLUE EARTH,12329,2131,12942,27402,0.44993066199547477,0.4723012918765054,0.07776804612801985
2000,MINNESOTA,BROWN,4650,814,7370,12834,0.36231884057971014,0.5742558828112825,0.06342527660900732
2000,MINNESOTA,CARLTON,8620,883,5578,15081,0.5715801339433725,0.3698693720575559,0.05855049399907168
2000,MINNESOTA,CARVER,12462,1769,20790,35021,0.3558436366751378,0.5936438137117729,0.05051254961308929
2000,MINNESOTA,CASS,5534,925,7134,13593,0.4071213124402266,0.5248289560803354,0.06804973147943795
2000,MINNESOTA,CHIPPEWA,2952,423,2977,6352,0.464735516372796,0.4686712846347607,0.06659319899244333
2000,MINNESOTA,CHISAGO,9593,1457,10937,21987,0.43630327011415837,0.4974302997225633,0.0662664301632783
2000,MINNESOTA,CLAY,10128,1518,11712,23358,0.4335987670177241,0.5014127921911122,0.06498844079116363
2000,MINNESOTA,CLEARWATER,1466,221,2137,3824,0.3833682008368201,0.5588389121338913,0.057792887029288705
2000,MINNESOTA,COOK,1171,354,1295,2820,0.4152482269503546,0.4592198581560284,0.125531914893617
2000,MINNESOTA,COTTONWOOD,2503,309,3369,6181,0.40495065523378093,0.5450574340721566,0.04999191069406245
2000,MINNESOTA,CROW WING,11255,1838,15035,28128,0.40013509670079633,0.5345207622298066,0.06534414106939704
2000,MINNESOTA,DAKOTA,85446,9553,87250,182249,0.4688420786945333,0.47874062409121587,0.052417297214250834
2000,MINNESOTA,DODGE,3370,467,4213,8050,0.4186335403726708,0.5233540372670807,0.05801242236024845
2000,MINNESOTA,DOUGLAS,6352,1042,9811,17205,0.369195001453066,0.5702412089508864,0.06056378959604766
2000,MINNESOTA,FARIBAULT,3624,464,4336,8424,0.4301994301994302,0.5147198480531814,0.055080721747388414
2000,MINNESOTA,FILLMORE,5020,557,4646,10223,0.49104959405262644,0.4544654211092634,0.054484984838110144
2000,MINNESOTA,FREEBORN,8514,782,6843,16139,0.5275419790569428,0.42400396554929054,0.048454055393766654
2000,MINNESOTA,GOODHUE,9981,1424,10852,22257,0.44844318641326325,0.48757694208563596,0.06397987150110078
2000,MINNESOTA,GRANT,1507,313,1804,3624,0.41583885209713023,0.4977924944812362,0.08636865342163355
2000,MINNESOTA,HENNEPIN,307599,40590,225657,573846,0.5360305726623519,0.3932361644064784,0.07073326293116969
2000,MINNESOTA,HOUSTON,4502,588,5077,10167,0.44280515392937936,0.4993606766991246,0.05783416937149602
2000,MINNESOTA,HUBBARD,3632,674,5307,9613,0.37782169978154584,0.5520649120982003,0.07011338812025382
2000,MINNESOTA,ISANTI,6247,1014,7668,14929,0.41844731730189566,0.513631187621408,0.06792149507669636
2000,MINNESOTA,ITASCA,10583,1586,9545,21714,0.4873814129133278,0.4395781523441098,0.0730404347425624
2000,MINNESOTA,JACKSON,2364,301,2773,5438,0.43471864656123577,0.5099301213681501,0.055351232070614195
2000,MINNESOTA,KANABEC,2831,500,3480,6811,0.41565115254734986,0.5109381882249303,0.07341065922771986
2000,MINNESOTA,KANDIYOHI,8220,1039,10026,19285,0.4262380088151413,0.5198859217008037,0.05387606948405497
2000,MINNESOTA,KITTSON,1107,177,1353,2637,0.4197952218430034,0.5130830489192264,0.0671217292377702
2000,MINNESOTA,KOOCHICHING,2903,453,3523,6879,0.42200901293792703,0.5121383922081698,0.06585259485390318
2000,MINNESOTA,LAC QUI PARLE,2244,268,1941,4453,0.503929934875365,0.43588591960476086,0.06018414551987424
2000,MINNESOTA,LAKE,3579,519,2465,6563,0.5453298796282188,0.3755904312052415,0.0790796891665397
2000,MINNESOTA,LAKE OF THE WOODS,848,123,1216,2187,0.38774577046181985,0.5560128029263832,0.056241426611796985
2000,MINNESOTA,LE SUEUR,5361,832,6138,12331,0.43475792717541156,0.4977698483496878,0.06747222447490066
2000,MINNESOTA,LINCOLN,1590,181,1513,3284,0.48416565164433617,0.46071863580998784,0.055115712545676
2000,MINNESOTA,LYON,4737,665,6087,11489,0.4123074244929933,0.5298111236835233,0.05788145182348333
2000,MINNESOTA,MAHNOMEN,921,181,1122,2224,0.4141187050359712,0.5044964028776978,0.08138489208633093
2000,MINNESOTA,MARSHALL,1910,377,2912,5199,0.367378341988844,0.5601077130217349,0.07251394498942104
2000,MINNESOTA,MARTIN,4166,519,5686,10371,0.4016970398225822,0.5482595699546813,0.050043390222736475
2000,MINNESOTA,MCLEOD,5609,1003,8782,15394,0.3643627387293751,0.5704820059763545,0.06515525529427049
2000,MINNESOTA,MEEKER,4402,750,5520,10672,0.4124812593703148,0.5172413793103449,0.07027736131934033
2000,MINNESOTA,MILLE LACS,4376,654,5223,10253,0.42680191163561887,0.5094118794499171,0.06378620891446406
2000,MINNESOTA,MORRISON,5274,1206,8197,14677,0.35933773932002455,0.5584928800163521,0.08216938066362335
2000,MINNESOTA,MOWER,10693,914,6873,18480,0.5786255411255411,0.3719155844155844,0.04945887445887446
2000,MINNESOTA,MURRAY,2093,253,2407,4753,0.44035346097201766,0.5064169997896065,0.05322953923837576
2000,MINNESOTA,NICOLLET,7041,1065,7221,15327,0.459385398316696,0.4711293795263261,0.06948522215697789
2000,MINNESOTA,NOBLES,3760,346,4766,8872,0.4238052299368801,0.5371956717763751,0.03899909828674482
2000,MINNESOTA,NORMAN,1575,258,1808,3641,0.4325734688272453,0.4965668772315298,0.07085965394122494
2000,MINNESOTA,OLMSTED,25822,2929,30641,59392,0.4347723599137931,0.5159112338362069,0.04931640625
2000,MINNESOTA,OTTER TAIL,9844,1704,16963,28511,0.34527024657149874,0.5949633474799201,0.05976640594858125
2000,MINNESOTA,PENNINGTON,2458,482,3380,6320,0.3889240506329114,0.5348101265822784,0.07626582278481013
2000,MINNESOTA,PINE,6148,1066,5854,13068,0.470462197734925,0.4479644934190389,0.08157330884603611
2000,MINNESOTA,PIPESTONE,1970,231,2693,4894,0.40253371475275845,0.5502656313853699,0.04720065386187168
2000,MINNESOTA,POLK,5764,767,7609,14140,0.40763790664780764,0.5381188118811882,0.05424328147100424
2000,MINNESOTA,POPE,2771,408,2808,5987,0.46283614498079173,0.46901620177050274,0.06814765324870553
2000,MINNESOTA,RAMSEY,138470,18139,87669,244278,0.5668541579675616,0.3588902807457078,0.07425556128673069
2000,MINNESOTA,RED LAKE,830,170,1090,2090,0.39712918660287083,0.5215311004784688,0.08133971291866028
2000,MINNESOTA,REDWOOD,2681,478,4589,7748,0.34602478058853897,0.5922818791946308,0.06169334021683015
2000,MINNESOTA,RENVILLE,3533,553,4036,8122,0.43499138143314453,0.4969219404087663,0.06808667815808914
2000,MINNESOTA,RICE,13140,2005,10876,26021,0.5049767495484416,0.4179701010722109,0.07705314937934744
2000,MINNESOTA,ROCK,2081,157,2772,5010,0.4153692614770459,0.5532934131736527,0.0313373253493014
2000,MINNESOTA,ROSEAU,2128,343,4695,7166,0.29695785654479484,0.6551772257884454,0.047864917666759696
2000,MINNESOTA,SAINT LOUIS,64237,7807,35420,107464,0.597753666344078,0.32959874934861905,0.0726475843073029
2000,MINNESOTA,SCOTT,17503,2336,23954,43793,0.3996757472655447,0.546982394446601,0.053341858287854226
2000,MINNESOTA,SHERBURNE,12109,1913,16813,30835,0.3927030971298849,0.5452570131344252,0.06203988973568996
2000,MINNESOTA,SIBLEY,2687,561,4087,7335,0.3663258350374915,0.5571915473755965,0.07648261758691206
2000,MINNESOTA,STEARNS,24800,5274,32402,62476,0.3969524297330175,0.5186311543632754,0.08441641590370702
2000,MINNESOTA,STEELE,6900,943,8223,16066,0.4294784015934271,0.5118262168554711,0.058695381551101704
2000,MINNESOTA,STEVENS,2434,487,2831,5752,0.42315716272600834,0.4921766342141864,0.08466620305980528
2000,MINNESOTA,SWIFT,2698,363,2376,5437,0.49622953834835387,0.4370057016737171,0.06676475997792901
2000,MINNESOTA,TODD,4132,929,6031,11092,0.3725207356653444,0.5437252073566534,0.08375405697800216
2000,MINNESOTA,TRAVERSE,884,148,1074,2106,0.41975308641975306,0.50997150997151,0.07027540360873694
2000,MINNESOTA,WABASHA,4522,764,5245,10531,0.42939891748172065,0.49805336625201785,0.07254771626626151
2000,MINNESOTA,WADENA,2251,398,3733,6382,0.3527107489815105,0.5849263553744908,0.062362895643998745
2000,MINNESOTA,WASECA,3694,562,4608,8864,0.41674187725631767,0.51985559566787,0.06340252707581227
2000,MINNESOTA,WASHINGTON,49637,5870,51502,107009,0.46385818015307123,0.48128662075152556,0.05485519909540319
2000,MINNESOTA,WATONWAN,2258,314,2562,5134,0.4398130112972341,0.49902610050642776,0.06116088819633814
2000,MINNESOTA,WILKIN,1046,227,2032,3305,0.31649016641452343,0.6148260211800303,0.0686838124054463
2000,MINNESOTA,WINONA,11069,2076,10773,23918,0.46278953089723224,0.4504139142068735,0.0867965548958943
2000,MINNESOTA,WRIGHT,16762,2743,23861,43366,0.3865240049808606,0.5502236775353964,0.06325231748374302
2000,MINNESOTA,YELLOW MEDICINE,2528,389,2598,5515,0.45838621940163193,0.47107887579329105,0.07053490480507706
2000,MISSISSIPPI,ADAMS,8065,123,6691,14879,0.5420391155319578,0.44969419987902415,0.008266684589018079
2000,MISSISSIPPI,ALCORN,5059,325,7254,12638,0.4003006804874189,0.5739832251938598,0.025716094318721315
2000,MISSISSIPPI,AMITE,2673,58,3677,6408,0.41713483146067415,0.5738139825218477,0.009051186017478152
2000,MISSISSIPPI,ATTALA,2922,45,4206,7173,0.40736093684650776,0.5863655374320368,0.006273525721455458
2000,MISSISSIPPI,BENTON,1886,34,1561,3481,0.541798333812123,0.4484343579431198,0.009767308244757253
2000,MISSISSIPPI,BOLIVAR,8436,255,4847,13538,0.6231348795981682,0.35802925099719307,0.018835869404638793
2000,MISSISSIPPI,CALHOUN,2251,59,3448,5758,0.39093435220562694,0.59881903438694,0.010246613407433136
2000,MISSISSIPPI,CARROLL,1726,33,3165,4924,0.3505280259951259,0.642770105605199,0.006701868399675061
2000,MISSISSIPPI,CHICKASAW,3519,107,3549,7175,0.4904529616724739,0.4946341463414634,0.014912891986062719
2000,MISSISSIPPI,CHOCTAW,1278,43,2398,3719,0.34364076364614143,0.6447969884377521,0.01156224791610648
2000,MISSISSIPPI,CLAIBORNE,3670,62,883,4615,0.7952329360780065,0.19133261105092092,0.013434452871072589
2000,MISSISSIPPI,CLARKE,2368,48,4503,6919,0.3422459893048128,0.6508165919930626,0.006937418702124584
2000,MISSISSIPPI,CLAY,4515,80,3570,8165,0.5529699938763013,0.43723208818126147,0.009797917942437232
2000,MISSISSIPPI,COAHOMA,5662,196,3695,9553,0.5926933947451063,0.3867894902124987,0.02051711504239506
2000,MISSISSIPPI,COPIAH,4845,99,5643,10587,0.45763672428449986,0.5330121847548881,0.009351090960612072
2000,MISSISSIPPI,COVINGTON,2623,78,4180,6881,0.38119459380903936,0.607469844499346,0.011335561691614591
2000,MISSISSIPPI,DESOTO,9586,471,24879,34936,0.2743874513395924,0.7121307533776048,0.01348179528280284
2000,MISSISSIPPI,FORREST,8500,470,13281,22251,0.38200530313244346,0.5968720506943508,0.021122646173205698
2000,MISSISSIPPI,FRANKLIN,1486,40,2427,3953,0.37591702504427016,0.6139640779155072,0.010118897040222615
2000,MISSISSIPPI,GEORGE,1977,164,5143,7284,0.2714168039538715,0.706068094453597,0.022515101592531575
2000,MISSISSIPPI,GREENE,1317,37,3082,4436,0.29688908926961227,0.6947700631199278,0.008340847610459874
2000,MISSISSIPPI,GRENADA,4163,93,5129,9385,0.4435801811401172,0.5465103889184869,0.009909429941395844
2000,MISSISSIPPI,HANCOCK,4801,421,9326,14548,0.3300109980753368,0.6410503161946659,0.02893868572999725
2000,MISSISSIPPI,HARRISON,19142,1218,32256,52616,0.36380568648319905,0.6130454614565911,0.02314885206020982
2000,MISSISSIPPI,HINDS,46789,3228,37753,87770,0.5330864760168622,0.43013558163381566,0.03677794234932209
2000,MISSISSIPPI,HOLMES,5447,38,1937,7422,0.7338992185394773,0.26098086769064943,0.005119913769873349
2000,MISSISSIPPI,HUMPHREYS,2288,28,1628,3944,0.5801217038539553,0.4127789046653144,0.007099391480730223
2000,MISSISSIPPI,ISSAQUENA,555,20,366,941,0.589798087141339,0.3889479277364506,0.021253985122210415
2000,MISSISSIPPI,ITAWAMBA,2994,146,5424,8564,0.3496029892573564,0.6333489023820644,0.01704810836057917
2000,MISSISSIPPI,JACKSON,14193,846,30068,45107,0.3146518278759394,0.6665927683064713,0.01875540381758929
2000,MISSISSIPPI,JASPER,3104,49,3294,6447,0.48146424693655965,0.5109353187529083,0.00760043431053203
2000,MISSISSIPPI,JEFFERSON,2786,22,600,3408,0.8174882629107981,0.176056338028169,0.006455399061032864
2000,MISSISSIPPI,JEFFERSON DAVIS,2835,45,2437,5317,0.5331954109460222,0.45834116983261236,0.008463419221365431
2000,MISSISSIPPI,JONES,7713,286,16341,24340,0.316885784716516,0.6713640098603122,0.011750205423171733
2000,MISSISSIPPI,KEMPER,2311,35,1915,4261,0.5423609481342407,0.449425017601502,0.008214034264257217
2000,MISSISSIPPI,LAFAYETTE,5139,458,7081,12678,0.4053478466635116,0.5585265814797287,0.03612557185675974
2000,MISSISSIPPI,LAMAR,3478,329,12795,16602,0.2094928321888929,0.7706902782797254,0.019816889531381762
2000,MISSISSIPPI,LAUDERDALE,8412,243,17315,25970,0.32391220639199075,0.6667308432807085,0.009356950327300731
2000,MISSISSIPPI,LAWRENCE,2841,72,3674,6587,0.43130408380142704,0.557765295278579,0.010930620919993927
2000,MISSISSIPPI,LEAKE,2793,45,4114,6952,0.4017548906789413,0.5917721518987342,0.006472957422324511
2000,MISSISSIPPI,LEE,9142,401,15551,25094,0.36431019367179407,0.6197098908105523,0.015979915517653622
2000,MISSISSIPPI,LEFLORE,6401,249,4626,11276,0.5676658389499822,0.4102518623625399,0.02208229868747783
2000,MISSISSIPPI,LINCOLN,4358,102,8540,13000,0.3352307692307692,0.6569230769230769,0.007846153846153846
2000,MISSISSIPPI,LOWNDES,7537,289,11404,19230,0.39193967758710346,0.5930317212688507,0.015028601144045762
2000,MISSISSIPPI,MADISON,10416,334,19109,29859,0.34883954586556815,0.639974547037744,0.011185907096687766
2000,MISSISSIPPI,MARION,4114,88,6796,10998,0.3740680123658847,0.6179305328241499,0.008001454809965449
2000,MISSISSIPPI,MARSHALL,7735,134,4723,12592,0.6142789072426937,0.375079415501906,0.010641677255400253
2000,MISSISSIPPI,MONROE,5783,180,7397,13360,0.43285928143712576,0.5536676646706586,0.01347305389221557
2000,MISSISSIPPI,MONTGOMERY,2187,32,2630,4849,0.4510208290369148,0.5423798721385853,0.006599298824499897
2000,MISSISSIPPI,NESHOBA,2563,94,6409,9066,0.2827046106331348,0.7069269799249945,0.010368409441870726
2000,MISSISSIPPI,NEWTON,2147,51,5540,7738,0.27746187645386405,0.7159472731972086,0.006590850348927371
2000,MISSISSIPPI,NOXUBEE,3383,41,1530,4954,0.6828825191764231,0.3088413403310456,0.008276140492531288
2000,MISSISSIPPI,OKTIBBEHA,6443,402,7959,14804,0.4352202107538503,0.5376249662253445,0.02715482302080519
2000,MISSISSIPPI,PANOLA,5880,85,5424,11389,0.5162876459741856,0.47624901220475896,0.007463341821055404
2000,MISSISSIPPI,PEARL RIVER,4611,291,11575,16477,0.2798446319111489,0.7024943861139771,0.017660981974874066
2000,MISSISSIPPI,PERRY,1285,48,3026,4359,0.2947923835742143,0.6941959164946089,0.011011699931176875
2000,MISSISSIPPI,PIKE,6544,158,7464,14166,0.4619511506423832,0.5268953833121559,0.011153466045460962
2000,MISSISSIPPI,PONTOTOC,2771,138,6601,9510,0.29137749737118823,0.694111461619348,0.014511041009463722
2000,MISSISSIPPI,PRENTISS,3287,94,5101,8482,0.387526526762556,0.6013911813251591,0.011082291912284839
2000,MISSISSIPPI,QUITMAN,2103,30,1280,3413,0.61617345443891,0.37503662467037796,0.008789920890711983
2000,MISSISSIPPI,RANKIN,8050,402,32983,41435,0.1942801979003258,0.7960178592976952,0.009701942801979004
2000,MISSISSIPPI,SCOTT,3548,57,5601,9206,0.3854008255485553,0.6084075602867695,0.006191614164675212
2000,MISSISSIPPI,SHARKEY,1706,123,1074,2903,0.5876679297278677,0.3699621081639683,0.04236996210816397
2000,MISSISSIPPI,SIMPSON,3227,93,6254,9574,0.3370587006475872,0.6532274911217881,0.009713808230624609
2000,MISSISSIPPI,SMITH,1620,70,4838,6528,0.24816176470588236,0.7411151960784313,0.010723039215686275
2000,MISSISSIPPI,STONE,1677,144,3702,5523,0.30363932645301467,0.6702878870179251,0.026072786529060293
2000,MISSISSIPPI,SUNFLOWER,4981,65,3369,8415,0.591919191919192,0.40035650623885916,0.007724301841948901
2000,MISSISSIPPI,TALLAHATCHIE,3041,54,2428,5523,0.5506065544088358,0.4396161506427666,0.00977729494839761
2000,MISSISSIPPI,TATE,3441,104,5148,8693,0.3958357298976188,0.5922006211894628,0.01196364891291844
2000,MISSISSIPPI,TIPPAH,2908,114,5381,8403,0.34606688087587767,0.6403665357610377,0.013566583363084613
2000,MISSISSIPPI,TISHOMINGO,2747,123,4122,6992,0.39287757437070936,0.5895308924485125,0.01759153318077803
2000,MISSISSIPPI,TUNICA,1539,35,792,2366,0.650464919695689,0.33474218089602703,0.014792899408284023
2000,MISSISSIPPI,UNION,3094,130,6087,9311,0.3322951347868113,0.6537428847599613,0.013961980453227366
2000,MISSISSIPPI,WALTHALL,2356,63,3476,5895,0.3996607294317218,0.5896522476675149,0.010687022900763359
2000,MISSISSIPPI,WARREN,7485,246,10892,18623,0.4019223540782903,0.5848681737636257,0.013209472158084089
2000,MISSISSIPPI,WASHINGTON,10405,556,7367,18328,0.5677106067219555,0.40195329550414666,0.030336097773897862
2000,MISSISSIPPI,WAYNE,2981,89,4635,7705,0.3868916288124594,0.6015574302401038,0.011550940947436729
2000,MISSISSIPPI,WEBSTER,1426,50,3069,4545,0.3137513751375138,0.6752475247524753,0.011001100110011002
2000,MISSISSIPPI,WILKINSON,2551,124,1423,4098,0.6224987798926306,0.3472425573450464,0.030258662762323085
2000,MISSISSIPPI,WINSTON,3672,51,4645,8368,0.43881453154875716,0.5550908221797323,0.006094646271510516
2000,MISSISSIPPI,YALOBUSHA,2674,84,2470,5228,0.5114766641162969,0.4724560061208875,0.016067329762815608
2000,MISSISSIPPI,YAZOO,4997,265,5254,10516,0.47518067706352224,0.49961962723469,0.02519969570178775
2000,MISSOURI,ADAIR,4101,401,6050,10552,0.3886467020470053,0.5733510235026535,0.03800227445034117
2000,MISSOURI,ANDREW,2795,222,4257,7274,0.384245257080011,0.5852350838603244,0.03051965905966456
2000,MISSOURI,ATCHISON,1013,60,1798,2871,0.35283873214907696,0.6262626262626263,0.02089864158829676
2000,MISSOURI,AUDRAIN,4551,178,5256,9985,0.4557836755132699,0.5263895843765648,0.01782674011016525
2000,MISSOURI,BARRY,4135,348,7885,12368,0.33433053040103494,0.63753234152652,0.02813712807244502
2000,MISSOURI,BARTON,1424,106,3836,5366,0.2653745806932538,0.7148714125978383,0.01975400670890794
2000,MISSOURI,BATES,3386,161,4245,7792,0.4345482546201232,0.5447895277207392,0.020662217659137578
2000,MISSOURI,BENTON,3150,166,4218,7534,0.41810459251393683,0.5598619591186621,0.022033448367401114
2000,MISSOURI,BOLLINGER,1692,115,3487,5294,0.3196071023800529,0.6586701926709483,0.021722704948998868
2000,MISSOURI,BOONE,28811,2372,28426,59609,0.4833330537334966,0.47687429750541027,0.039792648761093126
2000,MISSOURI,BUCHANAN,17085,1243,16423,34751,0.49164052833012,0.47259071681390463,0.03576875485597537
2000,MISSOURI,BUTLER,4996,290,9111,14397,0.34701673959852747,0.632840175036466,0.0201430853650066
2000,MISSOURI,CALDWELL,1488,142,2220,3850,0.3864935064935065,0.5766233766233766,0.036883116883116886
2000,MISSOURI,CALLAWAY,6708,362,8238,15308,0.43820224719101125,0.538149986934936,0.023647765874052783
2000,MISSOURI,CAMDEN,6323,418,10358,17099,0.3697877068834435,0.6057664190888356,0.02444587402772092
2000,MISSOURI,CAPE GIRARDEAU,9334,693,19832,29859,0.3126025653906695,0.6641883519206939,0.02320908268863659
2000,MISSOURI,CARROLL,1620,81,2880,4581,0.35363457760314343,0.6286836935166994,0.01768172888015717
2000,MISSOURI,CARTER,997,81,1730,2808,0.35505698005698005,0.6160968660968661,0.028846153846153848
2000,MISSOURI,CASS,14921,835,20113,35869,0.41598594886949736,0.560734896428671,0.023279154701831666
2000,MISSOURI,CEDAR,1979,154,3530,5663,0.34946141621048915,0.6233445170404379,0.027194066749072928
2000,MISSOURI,CHARITON,1792,62,2300,4154,0.431391429947039,0.5536831969186327,0.014925373134328358
2000,MISSOURI,CHRISTIAN,7896,508,14824,23228,0.3399345617358361,0.6381952815567419,0.021870156707422077
2000,MISSOURI,CLARK,1812,91,1899,3802,0.4765912677538138,0.4994739610731194,0.023934771173066808
2000,MISSOURI,CLAY,39084,2006,39083,80173,0.4874957903533609,0.4874833173262819,0.025020892320357226
2000,MISSOURI,CLINTON,3994,214,4323,8531,0.4681748915719142,0.5067401242527253,0.02508498417536045
2000,MISSOURI,COLE,12056,552,20167,32775,0.3678413424866514,0.6153165522501907,0.016842105263157894
2000,MISSOURI,COOPER,2567,151,4072,6790,0.3780559646539028,0.5997054491899853,0.02223858615611193
2000,MISSOURI,CRAWFORD,3350,198,4754,8302,0.40351722476511687,0.572633100457721,0.02384967477716213
2000,MISSOURI,DADE,1193,91,2468,3752,0.3179637526652452,0.6577825159914712,0.024253731343283583
2000,MISSOURI,DALLAS,2311,185,3723,6219,0.3716031516320952,0.5986493005306319,0.029747547837272872
2000,MISSOURI,DAVIESS,1367,116,2011,3494,0.39124212936462505,0.5755580995993131,0.03319977103606182
2000,MISSOURI,DEKALB,1562,124,2363,4049,0.3857742652506792,0.5836008891084218,0.030624845640898988
2000,MISSOURI,DENT,1839,153,3996,5988,0.30711422845691383,0.6673346693386774,0.02555110220440882
2000,MISSOURI,DOUGLAS,1546,136,3599,5281,0.29274758568452947,0.6814997159628858,0.025752698352584737
2000,MISSOURI,DUNKLIN,4947,152,5426,10525,0.47002375296912113,0.5155344418052257,0.014441805225653206
2000,MISSOURI,FRANKLIN,16172,1159,21863,39194,0.41261417563912844,0.5578149716793387,0.029570852681532887
2000,MISSOURI,GASCONADE,2257,182,4190,6629,0.3404736762709308,0.6320712022929552,0.027455121436114043
2000,MISSOURI,GENTRY,1271,63,1771,3105,0.40933977455716586,0.5703703703703704,0.020289855072463767
2000,MISSOURI,GREENE,41091,2657,59178,102926,0.39922857198375533,0.5749567650545052,0.025814662961739503
2000,MISSOURI,GRUNDY,1563,169,2976,4708,0.3319881053525913,0.6321155480033984,0.035896346644010195
2000,MISSOURI,HARRISON,1328,111,2552,3991,0.3327486845402155,0.6394387371586069,0.02781257830117765
2000,MISSOURI,HENRY,4459,199,5120,9778,0.45602372673348335,0.5236244630803846,0.020351810186132132
2000,MISSOURI,HICKORY,1961,105,2172,4238,0.46271826333176025,0.5125058990089665,0.024775837659273242
2000,MISSOURI,HOLT,871,53,1738,2662,0.32719759579263713,0.6528925619834711,0.019909842223891812
2000,MISSOURI,HOWARD,1944,154,2414,4512,0.4308510638297872,0.5350177304964538,0.034131205673758866
2000,MISSOURI,HOWELL,4641,416,9018,14075,0.3297335701598579,0.6407104795737123,0.02955595026642984
2000,MISSOURI,IRON,2044,133,2237,4414,0.46307204349796105,0.5067965564114182,0.030131400090620753
2000,MISSOURI,JACKSON,160419,7225,104418,272062,0.5896413317552617,0.38380222155244026,0.026556446692298077
2000,MISSOURI,JASPER,11737,845,24899,37481,0.3131453269656626,0.6643099170246258,0.02254475600971159
2000,MISSOURI,JEFFERSON,38616,1822,36766,77204,0.5001813377545204,0.47621884876431275,0.023599813481166777
2000,MISSOURI,JOHNSON,6926,522,9339,16787,0.41258116399594924,0.5563233454458807,0.031095490558170014
2000,MISSOURI,KANSAS CITY,0,0,0,0,,,
2000,MISSOURI,KNOX,787,42,1226,2055,0.3829683698296837,0.5965936739659368,0.020437956204379562
2000,MISSOURI,LACLEDE,4183,307,8556,13046,0.3206346772957228,0.6558332055802545,0.02353211712402269
2000,MISSOURI,LAFAYETTE,6343,328,7849,14520,0.43684573002754823,0.540564738292011,0.022589531680440773
2000,MISSOURI,LAWRENCE,4235,363,8305,12903,0.32821824381926684,0.6436487638533674,0.028132992327365727
2000,MISSOURI,LEWIS,2023,73,2388,4484,0.4511596788581623,0.5325602140945584,0.016280107047279214
2000,MISSOURI,LINCOLN,6961,403,8549,15913,0.4374410859046063,0.5372337082888204,0.025325205806573242
2000,MISSOURI,LINN,2646,118,3246,6010,0.44026622296173046,0.540099833610649,0.01963394342762063
2000,MISSOURI,LIVINGSTON,2425,142,3709,6276,0.3863926067558955,0.5909815168897387,0.02262587635436584
2000,MISSOURI,MACON,2817,126,4232,7175,0.39261324041811846,0.5898257839721255,0.0175609756097561
2000,MISSOURI,MADISON,1828,85,2460,4373,0.4180196661330894,0.5625428767436542,0.019437457123256344
2000,MISSOURI,MARIES,1554,84,2216,3854,0.40321743642968344,0.5749870264660093,0.021795537104307212
2000,MISSOURI,MARION,4993,169,6550,11712,0.42631489071038253,0.5592554644808743,0.01442964480874317
2000,MISSOURI,MCDONALD,1866,203,4460,6529,0.28580180732118243,0.683106141828764,0.031092050850053607
2000,MISSOURI,MERCER,555,37,1250,1842,0.30130293159609123,0.6786102062975027,0.02008686210640608
2000,MISSOURI,MILLER,3217,194,5945,9356,0.34384352287302267,0.6354211201368106,0.020735356990166737
2000,MISSOURI,MISSISSIPPI,2756,64,2395,5215,0.5284755512943432,0.4592521572387344,0.012272291466922339
2000,MISSOURI,MONITEAU,2176,125,3764,6065,0.3587798845836768,0.6206100577081616,0.020610057708161583
2000,MISSOURI,MONROE,1860,59,2175,4094,0.45432340009770394,0.5312652662432829,0.01441133365901319
2000,MISSOURI,MONTGOMERY,2092,105,3106,5303,0.3944936828210447,0.5857062040354516,0.01980011314350368
2000,MISSOURI,MORGAN,3235,186,4460,7881,0.4104809034386499,0.565918030706763,0.023601065854586982
2000,MISSOURI,NEW MADRID,3738,112,3416,7266,0.5144508670520231,0.4701348747591522,0.015414258188824663
2000,MISSOURI,NEWTON,6447,483,14232,21162,0.30464984406010776,0.6725262262546073,0.022823929685284943
2000,MISSOURI,NODAWAY,3553,335,5161,9049,0.39264007072604706,0.5703392640070726,0.03702066526688032
2000,MISSOURI,OREGON,1568,144,2521,4233,0.3704228679423577,0.5955587054098748,0.03401842664776754
2000,MISSOURI,OSAGE,1938,86,4154,6178,0.3136937520233085,0.6723858853998058,0.013920362576885724
2000,MISSOURI,OZARK,1432,197,2663,4292,0.3336439888164026,0.6204566635601119,0.045899347623485555
2000,MISSOURI,PEMISCOT,3245,65,2750,6060,0.5354785478547854,0.4537953795379538,0.010726072607260726
2000,MISSOURI,PERRY,2085,151,4667,6903,0.3020425901781834,0.6760828625235404,0.021874547298276113
2000,MISSOURI,PETTIS,5855,367,9533,15755,0.37162805458584575,0.6050777530942558,0.023294192319898446
2000,MISSOURI,PHELPS,6262,440,9444,16146,0.3878359965316487,0.5849126718691936,0.027251331599157685
2000,MISSOURI,PIKE,3557,146,3648,7351,0.48387974425248265,0.4962590123792681,0.019861243368249216
2000,MISSOURI,PLATTE,15325,944,17785,34054,0.4500205555881835,0.522258765490104,0.027720678921712573
2000,MISSOURI,POLK,3606,258,6430,10294,0.35030114629881487,0.6246357101224014,0.025063143578783757
2000,MISSOURI,PULASKI,3800,200,6531,10531,0.36083942645522743,0.6201690247839712,0.018991548760801443
2000,MISSOURI,PUTNAM,708,33,1593,2334,0.3033419023136247,0.6825192802056556,0.014138817480719794
2000,MISSOURI,RALLS,2033,63,2446,4542,0.4476001761338617,0.5385292822545135,0.013870541611624834
2000,MISSOURI,RANDOLPH,4116,226,4844,9186,0.4480731548007838,0.5273241889832354,0.02460265621598084
2000,MISSOURI,RAY,4970,260,4517,9747,0.5099004821996512,0.46342464348004514,0.026674874320303684
2000,MISSOURI,REYNOLDS,1298,71,1762,3131,0.4145640370488662,0.5627595017566273,0.022676461194506548
2000,MISSOURI,RIPLEY,1820,124,3121,5065,0.35932872655478776,0.6161895360315893,0.024481737413622903
2000,MISSOURI,SALINE,4585,198,4572,9355,0.4901122394441475,0.4887226082308926,0.021165152324959916
2000,MISSOURI,SCHUYLER,808,39,1159,2006,0.40279162512462613,0.577766699900299,0.019441674975074777
2000,MISSOURI,SCOTLAND,790,54,1335,2179,0.3625516291877008,0.6126663607159247,0.024782010096374485
2000,MISSOURI,SCOTT,6452,253,8999,15704,0.4108507386653082,0.5730387162506367,0.016110545084055017
2000,MISSOURI,SHANNON,1430,106,2245,3781,0.3782068235916424,0.5937582650092568,0.028034911399100765
2000,MISSOURI,SHELBY,1262,59,1936,3257,0.38747313478661344,0.5944120356155972,0.018114829597789376
2000,MISSOURI,ST. CHARLES,53806,2766,72114,128686,0.41811852105124103,0.5603872993177191,0.021494179631039896
2000,MISSOURI,ST. CLAIR,1866,142,2731,4739,0.3937539565309137,0.5762819160160372,0.029964127453049168
2000,MISSOURI,ST. FRANCOIS,9075,439,9327,18841,0.48166233214797516,0.49503741839605114,0.023300249455973674
2000,MISSOURI,ST. LOUIS CITY,96557,3396,24799,124752,0.7739915993330768,0.19878639220212901,0.02722200846479415
2000,MISSOURI,ST. LOUIS COUNTY,250631,11564,224689,486884,0.5147653239786069,0.46148363881335186,0.02375103720804134
2000,MISSOURI,STE. GENEVIEVE,3600,206,3505,7311,0.4924086992203529,0.4794145807687047,0.028176720010942416
2000,MISSOURI,STODDARD,4476,251,7727,12454,0.35940260157379156,0.6204432310904128,0.02015416733579573
2000,MISSOURI,STONE,4055,303,7793,12151,0.33371738951526625,0.641346391243519,0.024936219241214714
2000,MISSOURI,SULLIVAN,1127,60,1877,3064,0.36781984334203655,0.612597911227154,0.0195822454308094
2000,MISSOURI,TANEY,5092,373,9647,15112,0.3369507676019058,0.6383668607728957,0.024682371625198516
2000,MISSOURI,TEXAS,3486,310,6136,9932,0.3509867096254531,0.6178010471204188,0.03121224325412807
2000,MISSOURI,VERNON,3156,267,4985,8408,0.3753568030447193,0.5928877259752616,0.03175547098001903
2000,MISSOURI,WARREN,4524,237,5979,10740,0.4212290502793296,0.5567039106145252,0.022067039106145252
2000,MISSOURI,WASHINGTON,4047,198,4020,8265,0.4896551724137931,0.4863883847549909,0.023956442831215972
2000,MISSOURI,WAYNE,2387,115,3346,5848,0.40817373461012313,0.5721614227086184,0.01966484268125855
2000,MISSOURI,WEBSTER,4174,356,7350,11880,0.35134680134680135,0.6186868686868687,0.029966329966329967
2000,MISSOURI,WORTH,469,38,651,1158,0.40500863557858374,0.5621761658031088,0.03281519861830743
2000,MISSOURI,WRIGHT,2250,200,5391,7841,0.2869531947455682,0.6875398546103814,0.025506950644050504
2000,MONTANA,BEAVERHEAD,799,284,3113,4196,0.19041944709246902,0.7418970448045757,0.06768350810295519
2000,MONTANA,BIG HORN,2345,165,1651,4161,0.5635664503725066,0.39677962028358565,0.03965392934390771
2000,MONTANA,BLAINE,1246,103,1410,2759,0.45161290322580644,0.5110547299746285,0.03733236679956506
2000,MONTANA,BROADWATER,462,124,1488,2074,0.2227579556412729,0.7174541947926711,0.05978784956605593
2000,MONTANA,CARBON,1434,347,3008,4789,0.2994362079766131,0.6281060764251409,0.07245771559824599
2000,MONTANA,CARTER,53,19,573,645,0.08217054263565891,0.8883720930232558,0.02945736434108527
2000,MONTANA,CASCADE,13137,2016,18164,33317,0.39430320857220036,0.5451871416994327,0.0605096497283669
2000,MONTANA,CHOUTEAU,686,160,2039,2885,0.23778162911611786,0.7067590987868284,0.05545927209705372
2000,MONTANA,CUSTER,1501,248,3156,4905,0.30601427115188584,0.6434250764525994,0.05056065239551478
2000,MONTANA,DANIELS,303,57,750,1110,0.27297297297297296,0.6756756756756757,0.051351351351351354
2000,MONTANA,DAWSON,1364,184,2723,4271,0.31936314680402716,0.6375556075860455,0.04308124560992742
2000,MONTANA,DEER LODGE,2672,369,1493,4534,0.5893250992501102,0.3292898103220115,0.08138509042787825
2000,MONTANA,FALLON,256,52,1061,1369,0.18699780861943024,0.775018261504748,0.03798392987582177
2000,MONTANA,FERGUS,1352,289,4353,5994,0.2255588922255589,0.7262262262262262,0.048214881548214884
2000,MONTANA,FLATHEAD,8329,2991,22519,33839,0.24613611513342593,0.6654747480717516,0.08838913679482255
2000,MONTANA,GALLATIN,10009,3198,18833,32040,0.31239076154806494,0.5877965043695381,0.099812734082397
2000,MONTANA,GARFIELD,61,32,651,744,0.08198924731182795,0.875,0.043010752688172046
2000,MONTANA,GLACIER,2211,204,1709,4124,0.5361299709020368,0.4144034917555771,0.049466537342386034
2000,MONTANA,GOLDEN VALLEY,88,38,405,531,0.1657250470809793,0.7627118644067796,0.07156308851224105
2000,MONTANA,GRANITE,295,114,1181,1590,0.18553459119496854,0.7427672955974842,0.07169811320754717
2000,MONTANA,HILL,2760,406,3392,6558,0.42086001829826164,0.5172308630680086,0.0619091186337298
2000,MONTANA,JEFFERSON,1513,342,3308,5163,0.29304667828781716,0.6407127638969591,0.06624055781522371
2000,MONTANA,JUDITH BASIN,278,59,1057,1394,0.1994261119081779,0.7582496413199427,0.04232424677187949
2000,MONTANA,LAKE,3884,1123,6441,11448,0.3392732354996506,0.5626310272536688,0.09809573724668064
2000,MONTANA,LEWIS AND CLARK,9982,2196,15091,27269,0.36605669441490335,0.5534122996809564,0.08053100590414024
2000,MONTANA,LIBERTY,243,49,752,1044,0.23275862068965517,0.7203065134099617,0.04693486590038314
2000,MONTANA,LINCOLN,1629,639,5578,7846,0.2076217180729034,0.7109355085393831,0.08144277338771348
2000,MONTANA,MADISON,758,242,2656,3656,0.20733041575492342,0.7264770240700219,0.0661925601750547
2000,MONTANA,MCCONE,267,48,827,1142,0.23380035026269702,0.7241681260945709,0.04203152364273205
2000,MONTANA,MEAGHER,176,61,698,935,0.18823529411764706,0.746524064171123,0.06524064171122995
2000,MONTANA,MINERAL,382,179,1078,1639,0.23306894447834045,0.6577181208053692,0.10921293471629043
2000,MONTANA,MISSOULA,17241,7861,21474,46576,0.37016918584678804,0.46105290278254896,0.168777911370663
2000,MONTANA,MUSSELSHELL,512,113,1582,2207,0.23198912550974174,0.716810149524241,0.05120072496601722
2000,MONTANA,PARK,2154,729,4523,7406,0.29084526059951393,0.6107210369970294,0.09843370240345665
2000,MONTANA,PETROLEUM,36,16,254,306,0.11764705882352941,0.8300653594771242,0.05228758169934641
2000,MONTANA,PHILLIPS,423,78,1727,2228,0.18985637342908437,0.7751346499102334,0.03500897666068223
2000,MONTANA,PONDERA,792,156,1948,2896,0.27348066298342544,0.6726519337016574,0.05386740331491713
2000,MONTANA,POWDER RIVER,115,33,860,1008,0.11408730158730158,0.8531746031746031,0.03273809523809524
2000,MONTANA,POWELL,638,223,1971,2832,0.2252824858757062,0.6959745762711864,0.07874293785310735
2000,MONTANA,PRAIRIE,164,41,541,746,0.21983914209115282,0.725201072386059,0.054959785522788206
2000,MONTANA,RAVALLI,4451,1546,11241,17238,0.25820860888734193,0.6521058127392969,0.08968557837336118
2000,MONTANA,RICHLAND,1018,157,2858,4033,0.25241755516984876,0.7086536077361766,0.03892883709397471
2000,MONTANA,ROOSEVELT,2059,149,1605,3813,0.5399947547862576,0.4209284028324154,0.03907684238132704
2000,MONTANA,ROSEBUD,1394,203,1826,3423,0.4072451066316097,0.5334501898919077,0.05930470347648262
2000,MONTANA,SANDERS,1165,412,3144,4721,0.2467697521711502,0.6659606015674645,0.0872696462613853
2000,MONTANA,SHERIDAN,702,87,1176,1965,0.35725190839694654,0.5984732824427481,0.044274809160305344
2000,MONTANA,SILVER BOW,8967,1437,6299,16703,0.5368496677243609,0.37711788301502724,0.08603244926061186
2000,MONTANA,STILLWATER,925,228,2765,3918,0.23608984175599795,0.7057172026544155,0.05819295558958652
2000,MONTANA,SWEET GRASS,305,91,1450,1846,0.16522210184182015,0.7854821235102926,0.04929577464788732
2000,MONTANA,TETON,847,173,2294,3314,0.2555823777911889,0.692214846107423,0.05220277610138805
2000,MONTANA,TOOLE,630,109,1639,2378,0.2649285113540791,0.6892346509671994,0.04583683767872161
2000,MONTANA,TREASURE,106,29,344,479,0.22129436325678498,0.7181628392484343,0.060542797494780795
2000,MONTANA,VALLEY,1273,190,2500,3963,0.32122129699722435,0.6308352258390109,0.047943477163764826
2000,MONTANA,WHEATLAND,243,48,708,999,0.24324324324324326,0.7087087087087087,0.04804804804804805
2000,MONTANA,WIBAUX,121,28,369,518,0.2335907335907336,0.7123552123552124,0.05405405405405406
2000,MONTANA,YELLOWSTONE,20370,3207,33922,57499,0.3542670307309692,0.5899580862275866,0.0557748830414442
2000,NEBRASKA,ADAMS,3686,590,8162,12438,0.2963498954815887,0.6562148255346518,0.047435278983759446
2000,NEBRASKA,ANTELOPE,678,128,2562,3368,0.2013064133016627,0.7606888361045131,0.03800475059382423
2000,NEBRASKA,ARTHUR,26,11,235,272,0.09558823529411764,0.8639705882352942,0.04044117647058824
2000,NEBRASKA,BANNER,65,7,390,462,0.1406926406926407,0.8441558441558441,0.015151515151515152
2000,NEBRASKA,BLAINE,43,7,299,349,0.12320916905444126,0.8567335243553008,0.02005730659025788
2000,NEBRASKA,BOONE,575,91,2196,2862,0.20090845562543674,0.7672955974842768,0.03179594689028651
2000,NEBRASKA,BOX BUTTE,1614,267,3208,5089,0.3171546472784437,0.6303792493613677,0.05246610336018864
2000,NEBRASKA,BOYD,265,46,931,1242,0.21336553945249598,0.749597423510467,0.037037037037037035
2000,NEBRASKA,BROWN,250,59,1375,1684,0.14845605700712589,0.8165083135391924,0.03503562945368171
2000,NEBRASKA,BUFFALO,3927,603,11931,16461,0.2385638782577,0.7248040823765264,0.036632039365773646
2000,NEBRASKA,BURT,1223,113,2056,3392,0.3605542452830189,0.6061320754716981,0.03331367924528302
2000,NEBRASKA,BUTLER,1028,162,2638,3828,0.26854754440961337,0.6891327063740856,0.04231974921630094
2000,NEBRASKA,CASS,3656,480,6144,10280,0.3556420233463035,0.5976653696498054,0.04669260700389105
2000,NEBRASKA,CEDAR,1062,218,2989,4269,0.24877020379479972,0.7001639728273601,0.05106582337784024
2000,NEBRASKA,CHASE,306,64,1505,1875,0.1632,0.8026666666666666,0.034133333333333335
2000,NEBRASKA,CHERRY,446,79,2322,2847,0.156656129258869,0.815595363540569,0.027748507200561996
2000,NEBRASKA,CHEYENNE,844,135,3207,4186,0.2016244624940277,0.7661251791686574,0.032250358337314856
2000,NEBRASKA,CLAY,774,115,2326,3215,0.24074650077760498,0.7234836702954899,0.03576982892690513
2000,NEBRASKA,COLFAX,863,114,2338,3315,0.2603318250377074,0.7052790346907994,0.034389140271493215
2000,NEBRASKA,CUMING,857,126,3232,4215,0.2033214709371293,0.766785290628707,0.0298932384341637
2000,NEBRASKA,CUSTER,976,193,4245,5414,0.18027336534909494,0.7840783154783894,0.0356483191725157
2000,NEBRASKA,DAKOTA,2695,247,3119,6061,0.44464609800362975,0.5146015508991916,0.04075235109717868
2000,NEBRASKA,DAWES,823,249,2549,3621,0.2272852803093068,0.7039491853079259,0.0687655343827672
2000,NEBRASKA,DAWSON,1740,256,5511,7507,0.23178366857599575,0.7341148261622485,0.0341015052617557
2000,NEBRASKA,DEUEL,213,37,783,1033,0.20619554695062922,0.7579864472410455,0.03581800580832527
2000,NEBRASKA,DIXON,820,138,1834,2792,0.29369627507163326,0.6568767908309455,0.0494269340974212
2000,NEBRASKA,DODGE,5021,580,8871,14472,0.34694582642343835,0.6129767827529021,0.04007739082365948
2000,NEBRASKA,DOUGLAS,73347,8784,101025,183156,0.40046190133001375,0.5515789818515364,0.047959116818449846
2000,NEBRASKA,DUNDY,179,31,801,1011,0.17705242334322452,0.7922848664688428,0.03066271018793274
2000,NEBRASKA,FILLMORE,848,126,2024,2998,0.2828552368245497,0.6751167444963309,0.042028018679119414
2000,NEBRASKA,FRANKLIN,420,52,1196,1668,0.2517985611510791,0.7170263788968825,0.03117505995203837
2000,NEBRASKA,FRONTIER,244,47,1102,1393,0.17516152189519024,0.7910983488872936,0.03374012921751615
2000,NEBRASKA,FURNAS,534,48,1849,2431,0.21966269025092555,0.7605923488276429,0.01974496092143151
2000,NEBRASKA,GAGE,3516,452,5538,9506,0.36987166000420785,0.5825794235219861,0.04754891647380602
2000,NEBRASKA,GARDEN,203,53,963,1219,0.16652994257588188,0.7899917965545529,0.043478260869565216
2000,NEBRASKA,GARFIELD,202,43,718,963,0.20976116303219106,0.7455867082035307,0.0446521287642783
2000,NEBRASKA,GOSPER,228,29,757,1014,0.22485207100591717,0.7465483234714004,0.028599605522682446
2000,NEBRASKA,GRANT,49,12,324,385,0.12727272727272726,0.8415584415584415,0.03116883116883117
2000,NEBRASKA,GREELEY,416,55,839,1310,0.31755725190839695,0.6404580152671756,0.04198473282442748
2000,NEBRASKA,HALL,5952,791,11803,18546,0.32093173730184404,0.636417556346382,0.04265070635177397
2000,NEBRASKA,HAMILTON,1066,174,3251,4491,0.23736361612113116,0.7238922289022489,0.038744154976619906
2000,NEBRASKA,HARLAN,438,56,1358,1852,0.23650107991360692,0.7332613390928726,0.03023758099352052
2000,NEBRASKA,HAYES,66,19,486,571,0.11558669001751314,0.851138353765324,0.03327495621716287
2000,NEBRASKA,HITCHCOCK,312,42,1126,1480,0.21081081081081082,0.7608108108108108,0.02837837837837838
2000,NEBRASKA,HOLT,846,159,3954,4959,0.1705989110707804,0.7973381730187538,0.03206291591046582
2000,NEBRASKA,HOOKER,74,18,317,409,0.18092909535452323,0.7750611246943765,0.044009779951100246
2000,NEBRASKA,HOWARD,955,112,1760,2827,0.33781393703572693,0.622568093385214,0.039617969579059074
2000,NEBRASKA,JEFFERSON,1361,135,2351,3847,0.35378216792305694,0.6111255523784768,0.03509227969846634
2000,NEBRASKA,JOHNSON,794,108,1210,2112,0.3759469696969697,0.5729166666666666,0.05113636363636364
2000,NEBRASKA,KEARNEY,680,109,2333,3122,0.21780909673286356,0.7472773862908392,0.03491351697629724
2000,NEBRASKA,KEITH,778,118,2953,3849,0.20213042348661991,0.7672122629254352,0.03065731358794492
2000,NEBRASKA,KEYA PAHA,78,13,422,513,0.15204678362573099,0.8226120857699805,0.025341130604288498
2000,NEBRASKA,KIMBALL,379,62,1379,1820,0.20824175824175825,0.7576923076923077,0.03406593406593406
2000,NEBRASKA,KNOX,1037,157,2784,3978,0.2606837606837607,0.6998491704374057,0.03946706887883358
2000,NEBRASKA,LANCASTER,44650,6968,55514,107132,0.4167755665907479,0.5181831758951574,0.06504125751409476
2000,NEBRASKA,LINCOLN,5205,689,9220,15114,0.3443826915442636,0.6100304353579463,0.04558687309779013
2000,NEBRASKA,LOGAN,60,16,336,412,0.14563106796116504,0.8155339805825242,0.038834951456310676
2000,NEBRASKA,LOUP,84,10,284,378,0.2222222222222222,0.7513227513227513,0.026455026455026454
2000,NEBRASKA,MADISON,2772,445,9636,12853,0.21566949350346223,0.7497082393215592,0.034622267174978606
2000,NEBRASKA,MCPHERSON,48,9,244,301,0.15946843853820597,0.8106312292358804,0.029900332225913623
2000,NEBRASKA,MERRICK,848,112,2380,3340,0.25389221556886227,0.7125748502994012,0.033532934131736525
2000,NEBRASKA,MORRILL,460,81,1597,2138,0.21515434985968196,0.7469597754911131,0.03788587464920486
2000,NEBRASKA,NANCE,497,63,1105,1665,0.2984984984984985,0.6636636636636637,0.03783783783783784
2000,NEBRASKA,NEMAHA,1063,129,2177,3369,0.3155238943306619,0.6461858118135946,0.03829029385574354
2000,NEBRASKA,NUCKOLLS,644,98,1701,2443,0.2636103151862464,0.6962750716332379,0.04011461318051576
2000,NEBRASKA,OTOE,2208,276,4178,6662,0.3314320024016812,0.6271389972981086,0.04142900030021015
2000,NEBRASKA,PAWNEE,522,60,937,1519,0.3436471362738644,0.6168531928900592,0.03949967083607637
2000,NEBRASKA,PERKINS,243,39,1170,1452,0.16735537190082644,0.8057851239669421,0.026859504132231406
2000,NEBRASKA,PHELPS,934,118,3575,4627,0.20185865571644696,0.7726388588718393,0.025502485411713852
2000,NEBRASKA,PIERCE,570,104,2534,3208,0.17768079800498754,0.7899002493765586,0.032418952618453865
2000,NEBRASKA,PLATTE,2612,386,9861,12859,0.203126215102263,0.7668558985924255,0.030017886305311454
2000,NEBRASKA,POLK,610,78,1925,2613,0.2334481438959051,0.7367011098354382,0.029850746268656716
2000,NEBRASKA,RED WILLOW,1188,157,3680,5025,0.2364179104477612,0.7323383084577114,0.031243781094527363
2000,NEBRASKA,RICHARDSON,1382,145,2623,4150,0.3330120481927711,0.6320481927710844,0.03493975903614458
2000,NEBRASKA,ROCK,141,28,725,894,0.15771812080536912,0.8109619686800895,0.03131991051454139
2000,NEBRASKA,SALINE,2321,243,2581,5145,0.4511175898931001,0.5016520894071914,0.04723032069970846
2000,NEBRASKA,SARPY,14637,1662,28979,45278,0.3232695790450108,0.640023852643668,0.03670656831132117
2000,NEBRASKA,SAUNDERS,2852,379,5688,8919,0.3197667899988788,0.6377396569122099,0.04249355308891131
2000,NEBRASKA,SCOTTS BLUFF,3937,505,9397,13839,0.2844858732567382,0.6790230507984681,0.0364910759447937
2000,NEBRASKA,SEWARD,2250,309,4457,7016,0.32069555302166475,0.6352622576966933,0.04404218928164196
2000,NEBRASKA,SHERIDAN,392,79,2105,2576,0.15217391304347827,0.8171583850931677,0.030667701863354036
2000,NEBRASKA,SHERMAN,564,69,1072,1705,0.330791788856305,0.6287390029325514,0.04046920821114369
2000,NEBRASKA,SIOUX,98,25,629,752,0.13031914893617022,0.836436170212766,0.03324468085106383
2000,NEBRASKA,STANTON,500,91,1895,2486,0.2011263073209976,0.7622687047465808,0.03660498793242156
2000,NEBRASKA,THAYER,821,89,2096,3006,0.2731204258150366,0.697272122421823,0.029607451763140388
2000,NEBRASKA,THOMAS,55,11,329,395,0.13924050632911392,0.8329113924050633,0.027848101265822784
2000,NEBRASKA,THURSTON,924,118,1040,2082,0.4438040345821326,0.49951969260326606,0.056676272814601344
2000,NEBRASKA,VALLEY,583,70,1610,2263,0.25762262483429077,0.7114449845338047,0.03093239063190455
2000,NEBRASKA,WASHINGTON,2550,318,5758,8626,0.29561789937398564,0.6675168096452585,0.036865290980755853
2000,NEBRASKA,WAYNE,1001,165,2774,3940,0.25406091370558376,0.7040609137055838,0.04187817258883249
2000,NEBRASKA,WEBSTER,584,59,1302,1945,0.30025706940874036,0.6694087403598972,0.030334190231362468
2000,NEBRASKA,WHEELER,85,17,351,453,0.18763796909492272,0.7748344370860927,0.037527593818984545
2000,NEBRASKA,YORK,1407,237,4816,6460,0.2178018575851393,0.7455108359133127,0.03668730650154799
2000,NEVADA,CARSON CITY,7354,1014,11084,19452,0.37805881143327164,0.5698128727123175,0.052128315854410856
2000,NEVADA,CHURCHILL,2191,395,6237,8823,0.24832823302731497,0.7069024141448487,0.04476935282783634
2000,NEVADA,CLARK,196100,15166,170932,382198,0.513084840841658,0.4472341561180331,0.03968100304030895
2000,NEVADA,DOUGLAS,5837,944,11193,17974,0.324746856570602,0.6227328363191277,0.05252030711027039
2000,NEVADA,ELKO,2542,613,11025,14180,0.17926657263751763,0.7775035260930888,0.04322990126939351
2000,NEVADA,ESMERALDA,116,42,333,491,0.23625254582484725,0.6782077393075356,0.0855397148676171
2000,NEVADA,EUREKA,150,55,632,837,0.17921146953405018,0.7550776583034647,0.06571087216248507
2000,NEVADA,HUMBOLDT,1128,264,3638,5030,0.2242544731610338,0.7232604373757455,0.052485089463220676
2000,NEVADA,LANDER,395,105,1619,2119,0.18640868334119867,0.7640396413402548,0.049551675318546484
2000,NEVADA,LINCOLN,461,123,1372,1956,0.23568507157464214,0.7014314928425358,0.06288343558282208
2000,NEVADA,LYON,3955,767,7270,11992,0.3298032021347565,0.6062374916611074,0.06395930620413609
2000,NEVADA,MINERAL,916,150,1227,2293,0.3994766681203663,0.5351068469254252,0.06541648495420846
2000,NEVADA,NYE,4525,752,6904,12181,0.3714801740415401,0.5667843362613907,0.061735489697069205
2000,NEVADA,PERSHING,476,105,1221,1802,0.2641509433962264,0.6775804661487237,0.058268590455049944
2000,NEVADA,STOREY,666,118,1014,1798,0.3704115684093437,0.5639599555061179,0.06562847608453838
2000,NEVADA,WASHOE,52097,6564,63640,122301,0.4259736224560715,0.520355516308125,0.05367086123580347
2000,NEVADA,WHITE PINE,1069,240,2234,3543,0.30172170476996896,0.6305390911656789,0.06773920406435224
2000,NEW HAMPSHIRE,BELKNAP,10719,1277,14799,26795,0.4000373203955962,0.5523045344280649,0.047658145176338866
2000,NEW HAMPSHIRE,CARROLL,9852,1430,12597,23879,0.41258009129360523,0.5275346538799782,0.05988525482641652
2000,NEW HAMPSHIRE,CHESHIRE,17382,2220,13793,33395,0.5204970804012576,0.41302590208114986,0.06647701751759245
2000,NEW HAMPSHIRE,COOS,6570,701,7329,14600,0.45,0.501986301369863,0.048013698630136985
2000,NEW HAMPSHIRE,GRAFTON,18326,2315,18092,38733,0.4731366018640436,0.4670952417834921,0.059768156352464304
2000,NEW HAMPSHIRE,HILLSBOROUGH,77625,7487,80649,165761,0.4682947134730123,0.4865378466587436,0.045167439868244036
2000,NEW HAMPSHIRE,MERRIMACK,30622,3034,30028,63684,0.48084291187739464,0.47151560831606054,0.04764147980654482
2000,NEW HAMPSHIRE,ROCKINGHAM,61628,6685,65860,134173,0.4593174483688969,0.49085881660244607,0.04982373502865703
2000,NEW HAMPSHIRE,STRAFFORD,25400,2885,21108,49393,0.5142429089142186,0.427348004778005,0.05840908630777641
2000,NEW HAMPSHIRE,SULLIVAN,8224,1140,9304,18668,0.44053996143132634,0.4983929719305764,0.06106706663809728
2000,NEW JERSEY,ATLANTIC,52880,2629,35593,91102,0.5804482887313122,0.3906939474435248,0.028857763825163005
2000,NEW JERSEY,BERGEN,202682,11308,152731,366721,0.5526871927159884,0.41647737653420447,0.030835430749807075
2000,NEW JERSEY,BURLINGTON,99506,5781,72254,177541,0.560467722948502,0.40697078421322397,0.032561492838273975
2000,NEW JERSEY,CAMDEN,127166,7231,62464,196861,0.6459684752185553,0.3173000238747136,0.03673150090673115
2000,NEW JERSEY,CAPE MAY,22189,1611,23794,47594,0.4662142286842879,0.49993696684456024,0.03384880447115183
2000,NEW JERSEY,CUMBERLAND,28188,1614,18882,48684,0.5789992605373429,0.3878481636677348,0.033152575794922354
2000,NEW JERSEY,ESSEX,185505,7226,66842,259573,0.7146544517341943,0.2575075219687718,0.027838026297033976
2000,NEW JERSEY,GLOUCESTER,61095,3888,42315,107298,0.5693955152938545,0.39436895375496284,0.03623553095118269
2000,NEW JERSEY,HUDSON,118206,5351,43804,167361,0.7062935809417965,0.26173361774845993,0.03197280130974361
2000,NEW JERSEY,HUNTERDON,21387,2858,32210,56455,0.378832698609512,0.5705429102825259,0.050624391107962095
2000,NEW JERSEY,MERCER,83256,5633,46670,135559,0.6141680006491639,0.34427813719487455,0.04155386215596161
2000,NEW JERSEY,MIDDLESEX,154998,10306,93545,258849,0.598796982024269,0.36138829974232084,0.039814718233410214
2000,NEW JERSEY,MONMOUTH,131476,11374,119291,262141,0.5015468774438184,0.4550642593108289,0.04338886324535269
2000,NEW JERSEY,MORRIS,88039,7403,111066,206508,0.4263224669262208,0.5378290429426463,0.035848490131132935
2000,NEW JERSEY,OCEAN,102104,8605,105684,216393,0.47184520756216697,0.48838918079605165,0.03976561164178139
2000,NEW JERSEY,PASSAIC,90324,5206,61043,156573,0.5768810714491004,0.38986926226105395,0.03324966628984563
2000,NEW JERSEY,SALEM,13718,997,12257,26972,0.5086015126798161,0.45443422808838796,0.036964259231795936
2000,NEW JERSEY,SOMERSET,56232,4420,59725,120377,0.4671324256294807,0.49614959668375186,0.036717977686767406
2000,NEW JERSEY,SUSSEX,21353,2860,33277,57490,0.3714211167159506,0.5788311010610541,0.0497477822229953
2000,NEW JERSEY,UNION,112003,5816,68554,186373,0.6009615126654612,0.3678322503796151,0.03120623695492373
2000,NEW JERSEY,WARREN,16543,2086,22172,40801,0.40545574863361195,0.5434180534790813,0.051126197887306685
2000,NEW MEXICO,BERNALILLO,99461,9609,95249,204319,0.48679271139737373,0.4661778884978881,0.04702940010473818
2000,NEW MEXICO,CATRON,353,85,1273,1711,0.20631209818819404,0.7440093512565751,0.049678550555230856
2000,NEW MEXICO,CHAVES,6340,431,11378,18149,0.3493305416276379,0.6269215934762246,0.02374786489613753
2000,NEW MEXICO,CIBOLA,4127,209,2752,7088,0.5822516930022573,0.38826185101580135,0.029486455981941308
2000,NEW MEXICO,COLFAX,2653,208,2600,5461,0.485808459989013,0.4761032777879509,0.03808826222303607
2000,NEW MEXICO,CURRY,3471,197,8301,11969,0.28999916450831315,0.6935416492605898,0.016459186231097
2000,NEW MEXICO,DE BACA,349,21,612,982,0.35539714867617106,0.6232179226069247,0.021384928716904276
2000,NEW MEXICO,DONA ANA,23912,1478,21263,46653,0.5125501039590166,0.45576918954836776,0.031680706492615694
2000,NEW MEXICO,EDDY,7108,344,10335,17787,0.399617698318997,0.5810423342890876,0.019339967391915444
2000,NEW MEXICO,GRANT,5673,607,4961,11241,0.504670402989058,0.44133084245173915,0.053998754559202916
2000,NEW MEXICO,GUADALUPE,1076,27,548,1651,0.6517262265293762,0.3319200484554815,0.01635372501514234
2000,NEW MEXICO,HARDING,214,13,366,593,0.3608768971332209,0.6172006745362564,0.021922428330522766
2000,NEW MEXICO,HIDALGO,839,41,954,1834,0.4574700109051254,0.520174482006543,0.022355507088331516
2000,NEW MEXICO,LEA,3855,244,10157,14256,0.27041245791245794,0.7124719416386083,0.01711560044893378
2000,NEW MEXICO,LINCOLN,2027,287,4458,6772,0.29932073242764323,0.6582988777318369,0.04238038984051979
2000,NEW MEXICO,LOS ALAMOS,4149,446,5623,10218,0.4060481503229595,0.5503033861812487,0.04364846349579174
2000,NEW MEXICO,LUNA,2975,242,3395,6612,0.4499395039322444,0.51346037507562,0.03660012099213551
2000,NEW MEXICO,MCKINLEY,10281,528,5070,15879,0.6474589079916871,0.3192896278103155,0.033251464197997356
2000,NEW MEXICO,MORA,1456,67,668,2191,0.6645367412140575,0.30488361478776815,0.03057964399817435
2000,NEW MEXICO,OTERO,5465,481,10258,16204,0.33726240434460625,0.6330535670204888,0.029684028634904963
2000,NEW MEXICO,QUAY,1471,81,2292,3844,0.3826742976066597,0.5962539021852237,0.021071800208116546
2000,NEW MEXICO,RIO ARRIBA,8169,433,3495,12097,0.6752913945606349,0.28891460692733734,0.035793998512027775
2000,NEW MEXICO,ROOSEVELT,1762,127,3762,5651,0.31180322066890814,0.6657228809060344,0.022473898425057513
2000,NEW MEXICO,SAN JUAN,11980,1243,21434,34657,0.34567331275067087,0.6184609169864674,0.03586577026286176
2000,NEW MEXICO,SAN MIGUEL,6540,406,2215,9161,0.7138958628970636,0.24178583124113087,0.044318305861805476
2000,NEW MEXICO,SANDOVAL,14899,1433,15423,31755,0.46918595496772164,0.48568729333963157,0.04512675169264683
2000,NEW MEXICO,SANTA FE,32017,3480,13974,49471,0.6471872410098846,0.28246851690889613,0.0703442420812193
2000,NEW MEXICO,SIERRA,1689,176,2721,4586,0.36829481029219363,0.5933275185346707,0.03837767117313563
2000,NEW MEXICO,SOCORRO,3294,359,3173,6826,0.4825666569000879,0.46484031643715207,0.052593026662760035
2000,NEW MEXICO,TAOS,7039,1112,2744,10895,0.6460761817347407,0.2518586507572281,0.10206516750803121
2000,NEW MEXICO,TORRANCE,1868,201,2891,4960,0.37661290322580643,0.5828629032258065,0.0405241935483871
2000,NEW MEXICO,UNION,452,34,1269,1755,0.25754985754985754,0.7230769230769231,0.019373219373219373
2000,NEW MEXICO,VALENCIA,9819,755,10803,21377,0.45932544323338165,0.5053562239790429,0.03531833278757543
2000,NEW YORK,ALBANY,85617,8728,47624,141969,0.6030682754685882,0.3354535144996443,0.0614782100317675
2000,NEW YORK,ALLEGANY,6336,917,11436,18689,0.33902295467922305,0.611910749638825,0.04906629568195195
2000,NEW YORK,BRONX,265801,6002,36245,308048,0.8628557887082533,0.11766023476860749,0.01948397652313925
2000,NEW YORK,BROOME,45381,4736,36946,87063,0.5212432376554909,0.4243593719490484,0.05439739039546076
2000,NEW YORK,CATTARAUGUS,13697,1654,18382,33733,0.40604156167551064,0.5449263332641627,0.04903210506032668
2000,NEW YORK,CAYUGA,17031,1959,14988,33978,0.5012360939431397,0.4411089528518453,0.05765495320501501
2000,NEW YORK,CHAUTAUQUA,27016,2640,29064,58720,0.4600817438692098,0.4949591280653951,0.04495912806539509
2000,NEW YORK,CHEMUNG,17424,1507,18779,37710,0.4620525059665871,0.4979846194643331,0.03996287456907982
2000,NEW YORK,CHENANGO,9112,1105,10033,20250,0.4499753086419753,0.4954567901234568,0.0545679012345679
2000,NEW YORK,CLINTON,15542,1739,13274,30555,0.508656521027655,0.4344297169039437,0.05691376206840124
2000,NEW YORK,COLUMBIA,13489,2049,13153,28691,0.4701474329929246,0.45843644348401935,0.07141612352305601
2000,NEW YORK,CORTLAND,9691,1175,9857,20723,0.46764464604545675,0.4756550692467307,0.056700284707812576
2000,NEW YORK,DELAWARE,8450,1063,10662,20175,0.4188351920693928,0.5284758364312268,0.05268897149938042
2000,NEW YORK,DUTCHESS,52390,6703,52669,111762,0.4687639806016356,0.47126035682969164,0.05997566256867271
2000,NEW YORK,ERIE,240176,24302,160176,424654,0.5655804490243822,0.37719178437033446,0.05722776660528336
2000,NEW YORK,ESSEX,7927,1183,8822,17932,0.4420588891367388,0.49196966317198304,0.06597144769127816
2000,NEW YORK,FRANKLIN,8870,934,7643,17447,0.508396859058864,0.4380695821631226,0.05353355877801341
2000,NEW YORK,FULTON,9314,923,11434,21671,0.4297909648839463,0.5276175534123945,0.04259148170365927
2000,NEW YORK,GENESEE,10191,1419,14459,26069,0.3909240860792512,0.5546434462388278,0.05443246768192105
2000,NEW YORK,GREENE,8480,1282,11332,21094,0.4020100502512563,0.5372143737555704,0.06077557599317342
2000,NEW YORK,HAMILTON,1114,180,2388,3682,0.3025529603476372,0.6485605649103748,0.04888647474198805
2000,NEW YORK,HERKIMER,12224,1334,14147,27705,0.4412199963905432,0.5106298502075438,0.04815015340191301
2000,NEW YORK,JEFFERSON,16799,1427,18192,36418,0.46128288209127355,0.49953319786918554,0.03918392003954089
2000,NEW YORK,KINGS,497468,23032,96605,617105,0.8061318576255256,0.156545482535387,0.03732265983908735
2000,NEW YORK,LEWIS,4333,487,6103,10923,0.3966858921541701,0.5587292868259636,0.044584821019866334
2000,NEW YORK,LIVINGSTON,10476,1503,15244,27223,0.3848216581567057,0.5599676743929766,0.055210667450317746
2000,NEW YORK,MADISON,12017,1470,14879,28366,0.42364097863639566,0.5245364168370584,0.051822604526545864
2000,NEW YORK,MONROE,161743,14753,141266,317762,0.5090067408941283,0.44456542947237243,0.046427829633499285
2000,NEW YORK,MONTGOMERY,10249,795,9765,20809,0.4925272718535249,0.4692681051468115,0.03820462299966361
2000,NEW YORK,NASSAU,341610,21143,226954,589707,0.5792876801530251,0.38485892146438827,0.03585339838258661
2000,NEW YORK,NEW YORK,449300,34011,79921,563232,0.7977174592352707,0.1418971223225953,0.06038541844213397
2000,NEW YORK,NIAGARA,47781,4524,40952,93257,0.512358321627331,0.4391305746485519,0.048511103724117224
2000,NEW YORK,ONEIDA,43933,4460,47603,95996,0.4576544856035668,0.49588524521855076,0.04646026917788241
2000,NEW YORK,ONONDAGA,109896,10055,83678,203629,0.5396873726237422,0.41093360965284903,0.04937901772340875
2000,NEW YORK,ONTARIO,19761,2302,23885,45948,0.43007312614259596,0.5198267606859929,0.05010011317141116
2000,NEW YORK,ORANGE,58170,5527,62852,126549,0.45966384562501483,0.49666137227477103,0.043674782100214145
2000,NEW YORK,ORLEANS,5991,650,9202,15843,0.37814807801552736,0.5808243388247175,0.0410275831597551
2000,NEW YORK,OSWEGO,22857,2367,23249,48473,0.4715408577971242,0.4796278340519464,0.048831308150929384
2000,NEW YORK,OTSEGO,11460,1679,12219,25358,0.4519283855193627,0.48185976812051423,0.06621184636012303
2000,NEW YORK,PUTNAM,18525,2169,21853,42547,0.43540085082379487,0.5136202317437187,0.05097891743248643
2000,NEW YORK,QUEENS,416967,16911,122052,555930,0.7500350763585344,0.2195456262479089,0.030419297393556744
2000,NEW YORK,RENSSELAER,34808,4066,29562,68436,0.5086211935238764,0.4319656321234438,0.05941317435267988
2000,NEW YORK,RICHMOND,73828,4390,63903,142121,0.5194728435628795,0.44963798453430526,0.030889171902815208
2000,NEW YORK,ROCKLAND,69530,4609,48441,122580,0.5672214064284549,0.3951786588350465,0.037599934736498614
2000,NEW YORK,SARATOGA,43359,5075,46623,95057,0.4561368442092639,0.49047413657068917,0.05338901922004692
2000,NEW YORK,SCHENECTADY,35534,3451,27961,66946,0.530786006632211,0.41766498371822064,0.05154900964956831
2000,NEW YORK,SCHOHARIE,5390,699,7459,13548,0.3978447003247712,0.5505609684086212,0.05159433126660762
2000,NEW YORK,SCHUYLER,3301,471,4381,8153,0.4048816386606157,0.5373482153808414,0.057770145958542865
2000,NEW YORK,SENECA,6841,758,6734,14333,0.47729016953882647,0.4698248796483639,0.0528849508128096
2000,NEW YORK,ST. LAWRENCE,21386,1944,16449,39779,0.5376203524472711,0.4135096407652279,0.04887000678750094
2000,NEW YORK,STEUBEN,14600,1763,24200,40563,0.3599339299361487,0.5966028153736164,0.043463254690234945
2000,NEW YORK,SUFFOLK,306306,26568,240992,573866,0.5337587520431599,0.4199447257722186,0.0462965221846215
2000,NEW YORK,SULLIVAN,14348,1473,12703,28524,0.5030150049081475,0.4453442714906745,0.051640723601177954
2000,NEW YORK,TIOGA,9170,1045,12239,22454,0.408390487218313,0.5450699207268193,0.04653959205486773
2000,NEW YORK,TOMPKINS,21807,4902,13351,40060,0.5443584623065402,0.33327508736894657,0.12236645032451322
2000,NEW YORK,ULSTER,38162,6616,33447,78225,0.4878491530840524,0.42757430488974113,0.08457654202620646
2000,NEW YORK,WARREN,12193,1435,14993,28621,0.4260158624785996,0.5238461269697076,0.05013801055169281
2000,NEW YORK,WASHINGTON,9641,1318,12596,23555,0.4092973890893653,0.5347484610486096,0.05595414986202505
2000,NEW YORK,WAYNE,14977,1651,21701,38329,0.390748519397845,0.5661770461008636,0.04307443450129145
2000,NEW YORK,WESTCHESTER,218010,14487,139278,371775,0.5864030663707888,0.3746298164212225,0.038967117207988705
2000,NEW YORK,WYOMING,5935,883,10809,17627,0.33669938163045326,0.6132070119702728,0.05009360639927384
2000,NEW YORK,YATES,3962,525,5565,10052,0.39415041782729804,0.5536211699164345,0.05222841225626741
2000,NORTH CAROLINA,ALAMANCE,17459,327,29305,47091,0.37075024951689284,0.622305748444501,0.006944002038606103
2000,NORTH CAROLINA,ALEXANDER,4166,84,9242,13492,0.30877557070856804,0.684998517640083,0.006225911651348948
2000,NORTH CAROLINA,ALLEGHANY,1715,67,2531,4313,0.3976350568050081,0.5868305124043589,0.01553443079063297
2000,NORTH CAROLINA,ANSON,4792,32,3161,7985,0.6001252348152787,0.3958672510958046,0.004007514088916719
2000,NORTH CAROLINA,ASHE,4011,79,6226,10316,0.3888134936021714,0.6035284994183793,0.007658006979449399
2000,NORTH CAROLINA,AVERY,1686,52,4956,6694,0.2518673438900508,0.7403645055273379,0.007768150582611294
2000,NORTH CAROLINA,BEAUFORT,6634,148,10531,17313,0.38318026916190145,0.6082712412637902,0.008548489574308323
2000,NORTH CAROLINA,BERTIE,4660,28,2488,7176,0.649386845039019,0.346711259754738,0.0039018952062430325
2000,NORTH CAROLINA,BLADEN,5889,42,4977,10908,0.5398789878987899,0.45627062706270627,0.0038503850385038503
2000,NORTH CAROLINA,BRUNSWICK,13118,294,15427,28839,0.4548701411283332,0.5349353306286626,0.010194528243004266
2000,NORTH CAROLINA,BUNCOMBE,38545,830,46101,85476,0.45094529458561466,0.539344377369086,0.009710328045299265
2000,NORTH CAROLINA,BURKE,11924,268,18466,30658,0.38893600365320635,0.6023223954595864,0.008741600887207254
2000,NORTH CAROLINA,CABARRUS,16284,393,32704,49381,0.32976245924545877,0.6622790141957433,0.007958526558797918
2000,NORTH CAROLINA,CALDWELL,8588,190,17337,26115,0.32885314953092093,0.6638713383113153,0.0072755121577637374
2000,NORTH CAROLINA,CAMDEN,1187,16,1628,2831,0.419286471211586,0.5750618156128576,0.00565171317555634
2000,NORTH CAROLINA,CARTERET,8839,241,17381,26461,0.3340387740448207,0.6568534824836552,0.00910774347152413
2000,NORTH CAROLINA,CASWELL,4091,61,4270,8422,0.48575160294466874,0.5070054618855379,0.007242935169793398
2000,NORTH CAROLINA,CATAWBA,16246,351,34244,50841,0.3195452489132787,0.6735508742943688,0.006903876792352629
2000,NORTH CAROLINA,CHATHAM,10461,222,10248,20931,0.4997850078830443,0.4896087143471406,0.010606277769815107
2000,NORTH CAROLINA,CHEROKEE,3239,130,6305,9674,0.3348149679553442,0.6517469505892082,0.013438081455447592
2000,NORTH CAROLINA,CHOWAN,2430,45,2415,4890,0.49693251533742333,0.4938650306748466,0.009202453987730062
2000,NORTH CAROLINA,CLAY,1361,75,2416,3852,0.35332294911734163,0.6272066458982347,0.019470404984423675
2000,NORTH CAROLINA,CLEVELAND,13455,227,19064,32746,0.41088987967996093,0.5821779759359922,0.006932144384046907
2000,NORTH CAROLINA,COLUMBUS,9986,97,8342,18425,0.5419810040705563,0.4527544097693351,0.005264586160108548
2000,NORTH CAROLINA,CRAVEN,12213,278,19494,31985,0.3818352352665312,0.6094731905580741,0.008691574175394717
2000,NORTH CAROLINA,CUMBERLAND,38626,396,38129,77151,0.5006545605371285,0.4942126479242006,0.005132791538670918
2000,NORTH CAROLINA,CURRITUCK,2595,49,4095,6739,0.3850719691348865,0.6076569223920463,0.007271108473067221
2000,NORTH CAROLINA,DARE,5589,112,7301,13002,0.4298569450853715,0.5615289955391478,0.008614059375480695
2000,NORTH CAROLINA,DAVIDSON,16199,461,35387,52047,0.3112379195726939,0.6799047015197802,0.00885737890752589
2000,NORTH CAROLINA,DAVIE,3651,163,10184,13998,0.26082297471067295,0.7275325046435205,0.011644520645806544
2000,NORTH CAROLINA,DUPLIN,6475,75,7840,14390,0.4499652536483669,0.5448227936066713,0.005211952744961779
2000,NORTH CAROLINA,DURHAM,53907,547,30150,84604,0.63716845539218,0.35636612926102784,0.006465415346792114
2000,NORTH CAROLINA,EDGECOMBE,11315,51,6836,18202,0.6216349851664652,0.3755631249313262,0.0028018899022085484
2000,NORTH CAROLINA,FORSYTH,52457,785,67700,120942,0.43373683253129597,0.5597724529113128,0.006490714557391146
2000,NORTH CAROLINA,FRANKLIN,7454,96,8501,16051,0.46439474176063794,0.5296243224721201,0.005980935767241916
2000,NORTH CAROLINA,GASTON,19281,445,39453,59179,0.32580814140151065,0.6666722992953582,0.0075195593031311785
2000,NORTH CAROLINA,GATES,1944,22,1480,3446,0.5641323273360418,0.4294834590829948,0.006384213580963436
2000,NORTH CAROLINA,GRAHAM,1006,51,2304,3361,0.2993156798571854,0.6855102648021422,0.01517405534067242
2000,NORTH CAROLINA,GRANVILLE,7733,97,7364,15194,0.5089509016717125,0.4846649993418455,0.006384098986442017
2000,NORTH CAROLINA,GREENE,2478,39,3353,5870,0.4221465076660988,0.5712095400340715,0.006643952299829642
2000,NORTH CAROLINA,GUILFORD,80787,1083,84394,166264,0.48589592455372177,0.5075903382572294,0.006513737189048741
2000,NORTH CAROLINA,HALIFAX,10222,50,6698,16970,0.6023571007660578,0.39469652327637006,0.0029463759575721863
2000,NORTH CAROLINA,HARNETT,9155,250,14762,24167,0.3788223610708818,0.6108329540282204,0.010344684900897919
2000,NORTH CAROLINA,HAYWOOD,9793,362,12118,22273,0.4396803304449333,0.5440668073452162,0.01625286220985049
2000,NORTH CAROLINA,HENDERSON,12562,357,25688,38607,0.3253814075167716,0.6653715647421452,0.009247027741083224
2000,NORTH CAROLINA,HERTFORD,5484,31,2382,7897,0.6944409269342788,0.3016335317209067,0.003925541344814486
2000,NORTH CAROLINA,HOKE,5017,126,3439,8582,0.5845956653460732,0.40072244232113724,0.01468189233278956
2000,NORTH CAROLINA,HYDE,1088,17,1132,2237,0.48636566830576666,0.5060348681269558,0.007599463567277604
2000,NORTH CAROLINA,IREDELL,15434,299,29853,45586,0.33856885886017635,0.6548721098582898,0.006559031281533804
2000,NORTH CAROLINA,JACKSON,5722,162,6237,12121,0.47207326128207244,0.5145615048263344,0.013365233891593102
2000,NORTH CAROLINA,JOHNSTON,13704,239,27212,41155,0.33298505649374316,0.6612076296926255,0.005807313813631394
2000,NORTH CAROLINA,JONES,1822,28,2114,3964,0.45963673057517657,0.5332996972754793,0.007063572149344097
2000,NORTH CAROLINA,LEE,6785,92,9406,16283,0.41669225572683166,0.5776576797887367,0.005650064484431616
2000,NORTH CAROLINA,LENOIR,9527,124,11512,21163,0.45017247082171713,0.5439682464678921,0.005859282710390776
2000,NORTH CAROLINA,LINCOLN,8412,166,15951,24529,0.3429410086020629,0.6502914917036977,0.006767499694239472
2000,NORTH CAROLINA,MACON,4683,145,8406,13234,0.3538612664349403,0.6351821066948768,0.010956626870182862
2000,NORTH CAROLINA,MADISON,3505,144,4676,8325,0.421021021021021,0.5616816816816816,0.017297297297297298
2000,NORTH CAROLINA,MARTIN,4929,17,4420,9366,0.5262652146060218,0.47191970958787105,0.0018150758061071962
2000,NORTH CAROLINA,MCDOWELL,4747,155,9109,14011,0.33880522446649064,0.6501320391121261,0.0110627364213832
2000,NORTH CAROLINA,MECKLENBURG,126911,2057,134068,263036,0.4824852871850241,0.5096944904879941,0.007820222326981858
2000,NORTH CAROLINA,MITCHELL,1535,81,4984,6600,0.23257575757575757,0.7551515151515151,0.012272727272727272
2000,NORTH CAROLINA,MONTGOMERY,3979,49,4946,8974,0.4433920213951415,0.5511477601961221,0.00546021840873635
2000,NORTH CAROLINA,MOORE,11232,187,19882,31301,0.3588383757707421,0.6351873742052969,0.005974250023960896
2000,NORTH CAROLINA,NASH,12376,142,17995,30513,0.4055976141316816,0.5897486317307378,0.004653754137580703
2000,NORTH CAROLINA,NEW HANOVER,29292,524,36503,66319,0.44168337882054914,0.5504154163965078,0.007901204782943047
2000,NORTH CAROLINA,NORTHAMPTON,5513,20,2667,8200,0.6723170731707317,0.3252439024390244,0.0024390243902439024
2000,NORTH CAROLINA,ONSLOW,10269,289,19657,30215,0.33986430580837335,0.650570908489161,0.009564785702465663
2000,NORTH CAROLINA,ORANGE,30921,493,17930,49344,0.6266415369649806,0.3633673800259403,0.009991083009079117
2000,NORTH CAROLINA,PAMLICO,2188,55,2999,5242,0.41739793971766503,0.5721098817245326,0.010492178557802366
2000,NORTH CAROLINA,PASQUOTANK,5874,86,4943,10903,0.5387508025314134,0.453361460148583,0.007887737320003668
2000,NORTH CAROLINA,PENDER,6415,78,7661,14154,0.4532287692525081,0.5412604210823796,0.005510809665112336
2000,NORTH CAROLINA,PERQUIMANS,2033,43,2230,4306,0.47213190896423596,0.5178820250812819,0.009986065954482117
2000,NORTH CAROLINA,PERSON,5042,69,6722,11833,0.42609650976083835,0.5680723400659173,0.005831150173244317
2000,NORTH CAROLINA,PITT,19685,198,23192,43075,0.45699361578641906,0.5384097504352873,0.004596633778293674
2000,NORTH CAROLINA,POLK,3114,115,5074,8303,0.37504516439841024,0.6111044200891245,0.013850415512465374
2000,NORTH CAROLINA,RANDOLPH,11366,371,30959,42696,0.26620760727000187,0.7251030541502717,0.008689338579726438
2000,NORTH CAROLINA,RICHMOND,7935,71,6263,14269,0.556100637746163,0.43892354054243465,0.004975821711402341
2000,NORTH CAROLINA,ROBESON,17834,192,11721,29747,0.5995226409385821,0.3940229266816822,0.006454432379735772
2000,NORTH CAROLINA,ROCKINGHAM,13260,289,18979,32528,0.4076487948844073,0.5834665518937531,0.008884653221839647
2000,NORTH CAROLINA,ROWAN,14891,320,28922,44133,0.3374119139872658,0.6553372759612988,0.007250810051435434
2000,NORTH CAROLINA,RUTHERFORD,7697,264,13755,21716,0.35443912322711363,0.6334039417940689,0.012156934978817462
2000,NORTH CAROLINA,SAMPSON,8768,61,10410,19239,0.4557409428764489,0.5410884141587401,0.003170642964811061
2000,NORTH CAROLINA,SCOTLAND,5627,36,3740,9403,0.5984260342443901,0.39774540040412637,0.003828565351483569
2000,NORTH CAROLINA,STANLY,7066,204,15548,22818,0.30966780611797706,0.6813918836006662,0.008940310281356823
2000,NORTH CAROLINA,STOKES,5030,124,12028,17182,0.29274822488650915,0.700034920265394,0.007216854848096845
2000,NORTH CAROLINA,SURRY,7757,200,15401,23358,0.33209178868053774,0.6593458344036305,0.008562376915831836
2000,NORTH CAROLINA,SWAIN,2097,49,2224,4370,0.47986270022883293,0.5089244851258581,0.011212814645308924
2000,NORTH CAROLINA,TRANSYLVANIA,5044,170,9011,14225,0.35458699472759225,0.6334622144112478,0.01195079086115993
2000,NORTH CAROLINA,TYRRELL,849,11,706,1566,0.5421455938697318,0.4508301404853129,0.0070242656449553
2000,NORTH CAROLINA,UNION,14890,395,31876,47161,0.3157269777994529,0.6758974576450881,0.00837556455545896
2000,NORTH CAROLINA,VANCE,7092,45,5564,12701,0.5583812298244233,0.43807574206755373,0.0035430281080229904
2000,NORTH CAROLINA,WAKE,123466,2260,142494,268220,0.4603161583774513,0.53125792260085,0.008425919021698605
2000,NORTH CAROLINA,WARREN,4576,17,2202,6795,0.6734363502575423,0.3240618101545254,0.002501839587932303
2000,NORTH CAROLINA,WASHINGTON,2704,17,2169,4890,0.5529652351738241,0.44355828220858895,0.003476482617586912
2000,NORTH CAROLINA,WATAUGA,7959,326,10438,18723,0.4250921326710463,0.5574961277573038,0.01741173957164984
2000,NORTH CAROLINA,WAYNE,13005,121,20758,33884,0.38380946759532525,0.6126195254397355,0.0035710069649392043
2000,NORTH CAROLINA,WILKES,7226,271,16826,24323,0.297085063520125,0.6917732187641327,0.011141717715742301
2000,NORTH CAROLINA,WILSON,11266,94,13466,24826,0.4537984371223717,0.54241520986063,0.0037863530169983083
2000,NORTH CAROLINA,YADKIN,3127,120,10435,13682,0.22854845782780295,0.7626808946060517,0.0087706475661453
2000,NORTH CAROLINA,YANCEY,3714,80,4970,8764,0.423779096303058,0.5670926517571885,0.009128251939753538
2000,NORTH DAKOTA,ADAMS,286,48,826,1160,0.24655172413793103,0.7120689655172414,0.041379310344827586
2000,NORTH DAKOTA,BARNES,1933,363,3452,5748,0.3362908837856646,0.6005567153792624,0.06315240083507306
2000,NORTH DAKOTA,BENSON,952,147,1055,2154,0.44196843082636955,0.48978644382544106,0.06824512534818941
2000,NORTH DAKOTA,BILLINGS,82,49,394,525,0.15619047619047619,0.7504761904761905,0.09333333333333334
2000,NORTH DAKOTA,BOTTINEAU,1173,168,2349,3690,0.3178861788617886,0.6365853658536585,0.04552845528455285
2000,NORTH DAKOTA,BOWMAN,330,61,1080,1471,0.22433718558803534,0.7341944255608429,0.04146838885112169
2000,NORTH DAKOTA,BURKE,296,45,698,1039,0.2848893166506256,0.6717998075072185,0.04331087584215592
2000,NORTH DAKOTA,BURLEIGH,9842,2173,22467,34482,0.2854242793341453,0.6515573342613538,0.0630183864045009
2000,NORTH DAKOTA,CASS,21451,4008,33536,58995,0.3636070853462158,0.5684549538096448,0.06793796084413933
2000,NORTH DAKOTA,CAVALIER,618,240,1513,2371,0.2606495149725854,0.6381273724167018,0.10122311261071278
2000,NORTH DAKOTA,DICKEY,806,127,1853,2786,0.28930366116295764,0.6651112706389088,0.04558506819813352
2000,NORTH DAKOTA,DIVIDE,306,45,443,794,0.3853904282115869,0.5579345088161209,0.05667506297229219
2000,NORTH DAKOTA,DUNN,474,130,1124,1728,0.2743055555555556,0.6504629629629629,0.07523148148148148
2000,NORTH DAKOTA,EDDY,458,107,703,1268,0.361198738170347,0.554416403785489,0.08438485804416404
2000,NORTH DAKOTA,EMMONS,405,157,1430,1992,0.2033132530120482,0.7178714859437751,0.0788152610441767
2000,NORTH DAKOTA,FOSTER,474,97,1172,1743,0.2719449225473322,0.672403901319564,0.055651176133103844
2000,NORTH DAKOTA,GOLDEN VALLEY,156,45,611,812,0.1921182266009852,0.7524630541871922,0.05541871921182266
2000,NORTH DAKOTA,GRAND FORKS,10593,1917,15875,28385,0.37319006517526865,0.5592742645763608,0.06753567024837062
2000,NORTH DAKOTA,GRANT,235,115,1077,1427,0.1646811492641906,0.7547302032235459,0.0805886475122635
2000,NORTH DAKOTA,GRIGGS,484,65,920,1469,0.32947583390061264,0.6262763784887678,0.04424778761061947
2000,NORTH DAKOTA,HETTINGER,353,109,1057,1519,0.2323897300855826,0.695852534562212,0.07175773535220539
2000,NORTH DAKOTA,KIDDER,283,156,837,1276,0.22178683385579936,0.6559561128526645,0.12225705329153605
2000,NORTH DAKOTA,LAMOURE,689,189,1590,2468,0.2791734197730956,0.6442463533225283,0.07658022690437602
2000,NORTH DAKOTA,LOGAN,223,110,812,1145,0.1947598253275109,0.7091703056768559,0.09606986899563319
2000,NORTH DAKOTA,MCHENRY,888,167,1682,2737,0.3244428206065035,0.6145414687614176,0.06101571063207892
2000,NORTH DAKOTA,MCINTOSH,350,109,1178,1637,0.21380574221136225,0.7196090409285278,0.06658521686010996
2000,NORTH DAKOTA,MCKENZIE,653,77,1634,2364,0.27622673434856176,0.6912013536379019,0.03257191201353638
2000,NORTH DAKOTA,MCLEAN,1465,290,2891,4646,0.31532501076194575,0.6222557038312527,0.06241928540680155
2000,NORTH DAKOTA,MERCER,1011,358,2984,4353,0.23225361819434873,0.6855042499425683,0.08224213186308293
2000,NORTH DAKOTA,MORTON,3439,791,6993,11223,0.3064243072262318,0.6230954290296712,0.07048026374409694
2000,NORTH DAKOTA,MOUNTRAIL,1256,174,1466,2896,0.43370165745856354,0.5062154696132597,0.060082872928176795
2000,NORTH DAKOTA,NELSON,687,122,1031,1840,0.3733695652173913,0.5603260869565218,0.06630434782608696
2000,NORTH DAKOTA,OLIVER,244,98,709,1051,0.23215984776403426,0.6745956232159848,0.09324452901998097
2000,NORTH DAKOTA,PEMBINA,1093,256,2430,3779,0.2892299550145541,0.643027255887801,0.06774278909764488
2000,NORTH DAKOTA,PIERCE,500,123,1348,1971,0.2536783358701167,0.6839167935058346,0.0624048706240487
2000,NORTH DAKOTA,RAMSEY,1658,314,3005,4977,0.33313240908177616,0.6037773759292747,0.06309021498894916
2000,NORTH DAKOTA,RANSOM,1080,151,1488,2719,0.3972048547260022,0.5472600220669364,0.05553512320706142
2000,NORTH DAKOTA,RENVILLE,443,69,820,1332,0.3325825825825826,0.6156156156156156,0.0518018018018018
2000,NORTH DAKOTA,RICHLAND,2490,526,4999,8015,0.3106674984404242,0.6237055520898316,0.06562694946974423
2000,NORTH DAKOTA,ROLETTE,2681,301,1416,4398,0.6095952705775353,0.3219645293315143,0.06844020009095043
2000,NORTH DAKOTA,SARGENT,959,122,1103,2184,0.4391025641025641,0.50503663003663,0.055860805860805864
2000,NORTH DAKOTA,SHERIDAN,161,60,707,928,0.17349137931034483,0.7618534482758621,0.06465517241379311
2000,NORTH DAKOTA,SIOUX,724,48,269,1041,0.6954851104707013,0.2584053794428434,0.04610951008645533
2000,NORTH DAKOTA,SLOPE,85,41,316,442,0.19230769230769232,0.7149321266968326,0.09276018099547512
2000,NORTH DAKOTA,STARK,2784,606,6387,9777,0.28474992328935256,0.653267873580853,0.06198220312979442
2000,NORTH DAKOTA,STEELE,475,80,655,1210,0.3925619834710744,0.5413223140495868,0.06611570247933884
2000,NORTH DAKOTA,STUTSMAN,3067,563,5488,9118,0.33636762447905244,0.6018863785917965,0.06174599692915113
2000,NORTH DAKOTA,TOWNER,410,85,694,1189,0.3448275862068966,0.5836837678721615,0.07148864592094197
2000,NORTH DAKOTA,TRAILL,1512,208,2392,4112,0.36770428015564205,0.5817120622568094,0.05058365758754864
2000,NORTH DAKOTA,WALSH,1743,340,3099,5182,0.3363566190659977,0.5980316480123504,0.06561173292165187
2000,NORTH DAKOTA,WARD,7533,952,13997,22482,0.33506805444355486,0.6225869584556534,0.042344987100791744
2000,NORTH DAKOTA,WELLS,661,139,1610,2410,0.27427385892116185,0.6680497925311203,0.057676348547717846
2000,NORTH DAKOTA,WILLIAMS,2330,290,5187,7807,0.29845010887664913,0.6644037402331241,0.03714615089022672
2000,OHIO,ADAMS,3581,274,6380,10235,0.34987787005373716,0.6233512457254519,0.026770884220810944
2000,OHIO,ALLEN,13996,1152,28647,43795,0.31957986071469346,0.6541157666400274,0.026304372645279142
2000,OHIO,ASHLAND,6685,1040,13533,21258,0.31446984664596855,0.6366073948631104,0.048922758490921064
2000,OHIO,ASHTABULA,19831,1701,17940,39472,0.5024067693554926,0.4544993919740576,0.04309383867044994
2000,OHIO,ATHENS,13158,2586,9703,25447,0.5170747042873424,0.38130231461468933,0.10162298109796833
2000,OHIO,AUGLAIZE,5564,558,13770,19892,0.27971043635632414,0.6922380856625779,0.02805147798109793
2000,OHIO,BELMONT,15980,1536,12625,30141,0.530174844895657,0.41886466938721345,0.050960485717129494
2000,OHIO,BROWN,5972,430,10027,16429,0.3635035607766754,0.6103232089597662,0.02617323026355834
2000,OHIO,BUTLER,46390,3760,86587,136737,0.33926442733130024,0.6332375289789889,0.027498043689710906
2000,OHIO,CARROLL,4960,569,6732,12261,0.4045347035315227,0.5490579887448006,0.0464073077236767
2000,OHIO,CHAMPAIGN,5955,505,9220,15680,0.37978316326530615,0.5880102040816326,0.03220663265306122
2000,OHIO,CLARK,27984,1915,27660,57559,0.4861793985302038,0.480550391771921,0.033270209697875225
2000,OHIO,CLERMONT,20927,1821,47129,69877,0.29948337793551527,0.6744565450720552,0.026060076992429553
2000,OHIO,CLINTON,4791,455,9824,15070,0.3179163901791639,0.6518911745189118,0.030192435301924354
2000,OHIO,COLUMBIANA,20657,1966,21804,44427,0.4649649987620141,0.4907826321831319,0.04425236905485403
2000,OHIO,COSHOCTON,5594,431,8243,14268,0.39206616204093075,0.5777263807120829,0.03020745724698626
2000,OHIO,CRAWFORD,6721,789,11666,19176,0.35049019607843135,0.6083646224447226,0.04114518147684606
2000,OHIO,CUYAHOGA,359913,22770,192099,574782,0.6261730534359113,0.33421192730461285,0.03961501925947577
2000,OHIO,DARKE,7741,709,14817,23267,0.33270296987149184,0.6368246873253964,0.0304723428031117
2000,OHIO,DEFIANCE,6175,527,9540,16242,0.3801871690678488,0.5873660879202068,0.03244674301194434
2000,OHIO,DELAWARE,17134,1630,36639,55403,0.3092612313412631,0.661317979170803,0.029420789487933866
2000,OHIO,ERIE,17732,1178,16105,35015,0.5064115379123233,0.45994573754105383,0.03364272454662288
2000,OHIO,FAIRFIELD,19065,1506,33523,54094,0.35244204532850226,0.6197175287462565,0.027840425925241247
2000,OHIO,FAYETTE,3363,230,5685,9278,0.36247035999137744,0.6127398146152188,0.024789825393403752
2000,OHIO,FRANKLIN,202018,14194,197862,414074,0.4878789781536634,0.4778421248375894,0.03427889700874723
2000,OHIO,FULTON,6805,545,11546,18896,0.36012912785774764,0.6110287891617273,0.02884208298052498
2000,OHIO,GALLIA,4872,393,7511,12776,0.38134001252348154,0.5878991859737007,0.030760801502817785
2000,OHIO,GEAUGA,15327,1856,25417,42600,0.3597887323943662,0.5966431924882629,0.04356807511737089
2000,OHIO,GREENE,25059,2199,37946,65204,0.3843169130728176,0.5819581620759463,0.03372492485123612
2000,OHIO,GUERNSEY,6643,606,8181,15430,0.4305249513933895,0.530200907323396,0.03927414128321452
2000,OHIO,HAMILTON,161578,12146,204175,377899,0.4275692711544619,0.540289865810706,0.03214086303483206
2000,OHIO,HANCOCK,8798,834,20985,30617,0.2873566972596923,0.6854035339843878,0.027239768755919914
2000,OHIO,HARDIN,4557,387,7124,12068,0.3776102088167053,0.5903215114352005,0.03206827974809413
2000,OHIO,HARRISON,3351,393,3417,7161,0.4679514034352744,0.47716799329702553,0.05488060326770004
2000,OHIO,HENRY,4367,355,8530,13252,0.3295351645034712,0.6436764261998189,0.02678840929670993
2000,OHIO,HIGHLAND,5328,391,9728,15447,0.3449213439502816,0.6297662976629766,0.025312358386741764
2000,OHIO,HOCKING,4474,580,5702,10756,0.41595388620304946,0.5301227222015619,0.05392339159538862
2000,OHIO,HOLMES,2066,325,6754,9145,0.22591580098414435,0.7385456533624931,0.035538545653362494
2000,OHIO,HURON,8183,891,12286,21360,0.38309925093632957,0.5751872659176029,0.04171348314606742
2000,OHIO,JACKSON,5131,401,6958,12490,0.41080864691753405,0.5570856685348279,0.03210568454763811
2000,OHIO,JEFFERSON,17488,2110,15038,34636,0.5049081880124726,0.4341725372444855,0.06091927474304192
2000,OHIO,KNOX,7133,734,13393,21260,0.33551269990592664,0.6299623706491063,0.03452492944496707
2000,OHIO,LAKE,46497,4320,51747,102564,0.45334620334620335,0.5045337545337545,0.04212004212004212
2000,OHIO,LAWRENCE,11307,614,12531,24452,0.46241616227711435,0.5124734173073777,0.025110420415507935
2000,OHIO,LICKING,23196,2090,37180,62466,0.3713380078762847,0.5952037908622291,0.03345820126148625
2000,OHIO,LOGAN,5945,661,11849,18455,0.3221349227851531,0.6420482254131672,0.03581685180167976
2000,OHIO,LORAIN,59809,4414,47957,112180,0.5331520770190765,0.42750044571224816,0.039347477268675345
2000,OHIO,LUCAS,108344,5664,73342,187350,0.5782973045102748,0.39147050974112624,0.03023218574859888
2000,OHIO,MADISON,5287,488,8892,14667,0.3604690802481762,0.6062589486602578,0.0332719710915661
2000,OHIO,MAHONING,69212,4447,40460,114119,0.6064897168744907,0.3545421884173538,0.03896809470815552
2000,OHIO,MARION,10370,828,13617,24815,0.41789240378803144,0.5487406810396938,0.03336691517227484
2000,OHIO,MEDINA,26635,2899,37349,66883,0.398232734775653,0.5584229176322832,0.04334434759206375
2000,OHIO,MEIGS,3674,371,5750,9795,0.37508933129147526,0.587034201123022,0.03787646758550281
2000,OHIO,MERCER,5212,597,12485,18294,0.28490215371159944,0.6824641959112278,0.03263365037717284
2000,OHIO,MIAMI,15584,1220,26037,42841,0.3637636843210943,0.6077589225274853,0.02847739315142037
2000,OHIO,MONROE,3605,365,3145,7115,0.5066760365425158,0.44202389318341534,0.05130007027406887
2000,OHIO,MONTGOMERY,114597,6598,109792,230987,0.49611882919818,0.4753167927199366,0.028564378081883397
2000,OHIO,MORGAN,2261,281,3451,5993,0.37727348573335556,0.5758384782245953,0.04688803604204906
2000,OHIO,MORROW,4529,468,7842,12839,0.35275332969857465,0.6107952332736194,0.03645143702780591
2000,OHIO,MUSKINGUM,13415,1214,17995,32624,0.41120034330554195,0.5515877881314369,0.03721186856302109
2000,OHIO,NOBLE,2296,257,3435,5988,0.3834335337341349,0.5736472945891784,0.042919171676686706
2000,OHIO,OTTAWA,9485,566,9917,19968,0.475010016025641,0.4966446314102564,0.028345352564102564
2000,OHIO,PAULDING,3384,352,5210,8946,0.3782696177062374,0.5823831880169908,0.03934719427677174
2000,OHIO,PERRY,5895,493,6440,12828,0.45954162768942936,0.5020268163392578,0.03843155597131275
2000,OHIO,PICKAWAY,6598,425,10717,17740,0.37192784667418266,0.6041149943630214,0.023957158962795943
2000,OHIO,PIKE,4923,304,5333,10560,0.4661931818181818,0.5050189393939394,0.02878787878787879
2000,OHIO,PORTAGE,31446,3182,28271,62899,0.49994435523617226,0.4494666051924514,0.05058903957137633
2000,OHIO,PREBLE,6375,615,11176,18166,0.35093030936915115,0.615215237256413,0.03385445337443576
2000,OHIO,PUTNAM,4063,444,12837,17344,0.23425968634686348,0.7401406826568265,0.025599630996309963
2000,OHIO,RICHLAND,20572,2069,30138,52779,0.3897762367608329,0.5710225657932132,0.039201197445953885
2000,OHIO,ROSS,11662,648,13706,26016,0.4482626076260763,0.526829643296433,0.024907749077490774
2000,OHIO,SANDUSKY,11146,899,13699,25744,0.4329552517091361,0.5321239900559354,0.034920758234928524
2000,OHIO,SCIOTO,13997,926,15022,29945,0.4674236099515779,0.5016530305560194,0.030923359492402738
2000,OHIO,SENECA,9512,976,13863,24351,0.3906205083980124,0.5692990020943698,0.04008048950761776
2000,OHIO,SHELBY,6593,601,12476,19670,0.33518047788510424,0.6342653787493645,0.030554143365531267
2000,OHIO,STARK,75308,6383,78153,159844,0.4711343559970972,0.48893295963564476,0.039932684367258074
2000,OHIO,SUMMIT,119759,8359,96721,224839,0.5326433581362664,0.430178928032948,0.03717771383078559
2000,OHIO,TRUMBULL,57643,3942,34654,96239,0.5989567638898992,0.3600827107513586,0.0409605253587423
2000,OHIO,TUSCARAWAS,15879,1690,19549,37118,0.427797833935018,0.5266716956732582,0.04553047039172369
2000,OHIO,UNION,5040,482,11502,17024,0.29605263157894735,0.6756343984962406,0.02831296992481203
2000,OHIO,VAN WERT,4209,331,8679,13219,0.31840532566759966,0.6565549587714653,0.025039715560935018
2000,OHIO,VINTON,2037,189,2720,4946,0.4118479579458148,0.549939344925192,0.038212697128993126
2000,OHIO,WARREN,19142,1618,48318,69078,0.2771070384203364,0.6994701641622514,0.0234227974174122
2000,OHIO,WASHINGTON,10383,790,15342,26515,0.39158966622666413,0.578615877805016,0.029794455968319818
2000,OHIO,WAYNE,14779,1756,25901,42436,0.34826562352719387,0.6103544160618343,0.04137996041097182
2000,OHIO,WILLIAMS,5454,524,9941,15919,0.3426094603932408,0.624473899114266,0.032916640492493245
2000,OHIO,WOOD,22687,2003,27504,52194,0.4346668199409894,0.5269571215082194,0.03837605855079128
2000,OHIO,WYANDOT,3397,317,6113,9827,0.34568026864760354,0.6220616668362674,0.03225806451612903
2000,OKLAHOMA,ADAIR,2361,113,3503,5977,0.39501422118119456,0.5860799732307177,0.01890580558808767
2000,OKLAHOMA,ALFALFA,583,38,1886,2507,0.23254886318308735,0.7522935779816514,0.015157558835261268
2000,OKLAHOMA,ATOKA,1906,43,2375,4324,0.44079555966697503,0.5492599444958371,0.009944495837187789
2000,OKLAHOMA,BEAVER,339,25,2092,2456,0.13802931596091206,0.8517915309446255,0.01017915309446254
2000,OKLAHOMA,BECKHAM,2408,57,4067,6532,0.36864666258420087,0.622627066748316,0.00872627066748316
2000,OKLAHOMA,BLAINE,1402,59,2633,4094,0.3424523693209575,0.6431362970200293,0.01441133365901319
2000,OKLAHOMA,BRYAN,5554,108,6084,11746,0.47284181849140133,0.5179635620636812,0.009194619444917418
2000,OKLAHOMA,CADDO,4272,103,4835,9210,0.4638436482084691,0.5249728555917481,0.011183496199782844
2000,OKLAHOMA,CANADIAN,8367,314,22679,31360,0.2668048469387755,0.7231823979591837,0.010012755102040817
2000,OKLAHOMA,CARTER,6659,132,9667,16458,0.4046056628995018,0.5873739214971443,0.008020415603353991
2000,OKLAHOMA,CHEROKEE,7256,294,6918,14468,0.5015205971799834,0.4781586950511474,0.02032070776886923
2000,OKLAHOMA,CHOCTAW,2799,55,2461,5315,0.5266227657572907,0.4630291627469426,0.010348071495766699
2000,OKLAHOMA,CIMARRON,227,27,1230,1484,0.15296495956873316,0.8288409703504043,0.018194070080862535
2000,OKLAHOMA,CLEVELAND,27792,986,47393,76171,0.3648632681729267,0.6221921728741909,0.01294455895288233
2000,OKLAHOMA,COAL,1148,18,1196,2362,0.48602878916172737,0.506350550381033,0.007620660457239628
2000,OKLAHOMA,COMANCHE,11971,259,17103,29333,0.40810691030579893,0.5830634439027716,0.008829645791429449
2000,OKLAHOMA,COTTON,1068,26,1388,2482,0.43029814665592264,0.5592264302981467,0.010475423045930701
2000,OKLAHOMA,CRAIG,2568,101,2815,5484,0.4682713347921225,0.5133114514952589,0.018417213712618525
2000,OKLAHOMA,CREEK,9753,408,13580,23741,0.4108083063055474,0.572006233941283,0.01718545975316962
2000,OKLAHOMA,CUSTER,3115,101,6527,9743,0.31971671969619214,0.6699168633890998,0.010366416914707995
2000,OKLAHOMA,DELAWARE,5514,221,7618,13353,0.412940912154572,0.5705084999625553,0.016550587882872763
2000,OKLAHOMA,DEWEY,599,14,1607,2220,0.26981981981981984,0.7238738738738739,0.006306306306306306
2000,OKLAHOMA,ELLIS,468,32,1513,2013,0.23248882265275708,0.7516145057128664,0.015896671634376552
2000,OKLAHOMA,GARFIELD,6543,238,14902,21683,0.3017571369275469,0.6872665221602177,0.010976340912235392
2000,OKLAHOMA,GARVIN,4189,118,5536,9843,0.42558163161637713,0.5624301534085137,0.011988214975109214
2000,OKLAHOMA,GRADY,6037,199,10040,16276,0.37091422954042763,0.6168591791594986,0.012226591300073728
2000,OKLAHOMA,GRANT,709,32,1762,2503,0.28326008789452656,0.7039552536955653,0.01278465840990811
2000,OKLAHOMA,GREER,839,26,1287,2152,0.3898698884758364,0.5980483271375465,0.012081784386617101
2000,OKLAHOMA,HARMON,507,6,692,1205,0.420746887966805,0.5742738589211618,0.004979253112033195
2000,OKLAHOMA,HARPER,374,13,1296,1683,0.2222222222222222,0.7700534759358288,0.007724301841948901
2000,OKLAHOMA,HASKELL,2510,79,2039,4628,0.5423509075194468,0.4405790838375108,0.01707000864304235
2000,OKLAHOMA,HUGHES,2334,55,2196,4585,0.509051254089422,0.47895310796074153,0.011995637949836423
2000,OKLAHOMA,JACKSON,2515,53,5591,8159,0.3082485598725334,0.6852555460227969,0.00649589410466969
2000,OKLAHOMA,JEFFERSON,1245,28,1320,2593,0.48013883532587737,0.5090628615503278,0.010798303123794832
2000,OKLAHOMA,JOHNSTON,1809,49,2072,3930,0.46030534351145036,0.5272264631043257,0.012468193384223919
2000,OKLAHOMA,KAY,6122,272,11768,18162,0.33707741438167604,0.6479462614249532,0.014976324193370773
2000,OKLAHOMA,KINGFISHER,1304,59,4693,6056,0.21532364597093792,0.7749339498018494,0.009742404227212682
2000,OKLAHOMA,KIOWA,1544,33,2173,3750,0.41173333333333334,0.5794666666666667,0.0088
2000,OKLAHOMA,LATIMER,1865,65,1739,3669,0.5083128917961297,0.4739711092940856,0.017715998909784682
2000,OKLAHOMA,LE FLORE,6536,234,8215,14985,0.4361695028361695,0.5482148815482148,0.015615615615615615
2000,OKLAHOMA,LINCOLN,4140,174,7387,11701,0.35381591316981453,0.6313135629433382,0.014870523886847278
2000,OKLAHOMA,LOGAN,4510,173,8187,12870,0.3504273504273504,0.6361305361305362,0.013442113442113442
2000,OKLAHOMA,LOVE,1530,35,1807,3372,0.45373665480427045,0.5358837485172004,0.010379596678529062
2000,OKLAHOMA,MAJOR,635,45,2672,3352,0.18943914081145585,0.7971360381861575,0.013424821002386634
2000,OKLAHOMA,MARSHALL,2210,49,2641,4900,0.45102040816326533,0.5389795918367347,0.01
2000,OKLAHOMA,MAYES,6618,251,7132,14001,0.4726805228197986,0.5093921862724091,0.0179272909077923
2000,OKLAHOMA,MCCLAIN,3679,110,6750,10539,0.3490843533542082,0.6404782237403929,0.010437422905398994
2000,OKLAHOMA,MCCURTAIN,3752,129,6601,10482,0.357946956687655,0.6297462316351842,0.012306811677160847
2000,OKLAHOMA,MCINTOSH,4206,131,3444,7781,0.5405474874694769,0.4426166302531808,0.016835882277342243
2000,OKLAHOMA,MURRAY,2263,50,2609,4922,0.4597724502234864,0.5300690776107273,0.010158472165786265
2000,OKLAHOMA,MUSKOGEE,12520,353,11820,24693,0.507026282752197,0.47867816790183454,0.014295549345968493
2000,OKLAHOMA,NOBLE,1416,51,3230,4697,0.3014690227804982,0.6876729827549499,0.010857994464551842
2000,OKLAHOMA,NOWATA,1703,77,2069,3849,0.4424525850870356,0.537542218758119,0.020005196154845414
2000,OKLAHOMA,OKFUSKEE,1814,64,1910,3788,0.4788806758183738,0.5042238648363252,0.01689545934530095
2000,OKLAHOMA,OKLAHOMA,81590,2443,139078,223111,0.3656924131934329,0.6233578801583068,0.010949706648260282
2000,OKLAHOMA,OKMULGEE,7186,195,5797,13178,0.5453027773561997,0.43989983305509184,0.014797389588708453
2000,OKLAHOMA,OSAGE,7540,231,8138,15909,0.47394556540323085,0.5115343516248664,0.014520082971902697
2000,OKLAHOMA,OTTAWA,5647,139,5625,11411,0.4948733678029971,0.4929454035579704,0.012181228639032513
2000,OKLAHOMA,PAWNEE,2435,104,3386,5925,0.4109704641350211,0.5714767932489452,0.017552742616033755
2000,OKLAHOMA,PAYNE,9319,372,15256,24947,0.3735519300917946,0.6115364572894536,0.014911612618751754
2000,OKLAHOMA,PITTSBURG,7627,216,8514,16357,0.466283548327933,0.5205110961667787,0.013205355505288256
2000,OKLAHOMA,PONTOTOC,5387,150,7299,12836,0.4196790277344967,0.5686350888127143,0.011685883452789031
2000,OKLAHOMA,POTTAWATOMIE,8763,318,13235,22316,0.39267789926510127,0.5930722351675928,0.014249865567305968
2000,OKLAHOMA,PUSHMATAHA,1969,48,2331,4348,0.452851885924563,0.5361085556577737,0.011039558417663294
2000,OKLAHOMA,ROGER MILLS,441,12,1234,1687,0.26141078838174275,0.7314759928867812,0.007113218731475993
2000,OKLAHOMA,ROGERS,10813,425,17713,28951,0.37349314358744085,0.6118268799005215,0.014679976512037582
2000,OKLAHOMA,SEMINOLE,3783,72,4011,7866,0.48093058733791,0.5099160945842868,0.009153318077803204
2000,OKLAHOMA,SEQUOYAH,5425,215,6614,12254,0.44271258364615634,0.5397421250204015,0.017545291333442143
2000,OKLAHOMA,STEPHENS,6467,161,10860,17488,0.3697964318389753,0.6209972552607502,0.009206312900274474
2000,OKLAHOMA,TEXAS,1084,40,4964,6088,0.17805519053876478,0.8153745072273325,0.006570302233902759
2000,OKLAHOMA,TILLMAN,1400,29,1920,3349,0.41803523439832785,0.5733054643177068,0.008659301283965363
2000,OKLAHOMA,TULSA,81656,2883,134152,218691,0.37338527877233174,0.6134317370170698,0.013182984210598516
2000,OKLAHOMA,WAGONER,8244,292,12981,21517,0.38313891341729794,0.6032904215271646,0.013570665055537482
2000,OKLAHOMA,WASHINGTON,6644,312,13788,20744,0.3202853837254146,0.6646741226378712,0.01504049363671423
2000,OKLAHOMA,WASHITA,1564,54,2850,4468,0.35004476275738583,0.6378692927484333,0.012085944494180842
2000,OKLAHOMA,WOODS,1235,37,2774,4046,0.3052397429560059,0.6856154226396441,0.009144834404349975
2000,OKLAHOMA,WOODWARD,1950,83,5067,7100,0.2746478873239437,0.7136619718309859,0.011690140845070423
2000,OREGON,BAKER,2195,445,5618,8258,0.2658028578348268,0.6803100024218939,0.053887139743279244
2000,OREGON,BENTON,19444,2957,15825,38226,0.5086590278867786,0.41398524564432587,0.07735572646889552
2000,OREGON,CLACKAMAS,76421,8302,77539,162262,0.4709728710357323,0.47786296236950115,0.05116416659476649
2000,OREGON,CLATSOP,8296,1228,6950,16474,0.5035814009955081,0.4218768969284934,0.07454170207599854
2000,OREGON,COLUMBIA,10331,1495,9369,21195,0.4874262797829677,0.44203821656050957,0.07053550365652277
2000,OREGON,COOS,11610,2143,15626,29379,0.3951802307770857,0.531876510432622,0.07294325879029238
2000,OREGON,CROOK,2474,440,5363,8277,0.29890056783858887,0.6479400749063671,0.0531593572550441
2000,OREGON,CURRY,4090,872,6551,11513,0.3552505862937549,0.5690089464084079,0.07574046729783723
2000,OREGON,DESCHUTES,22061,3692,32132,57885,0.3811177334369871,0.5551006305605943,0.06378163600241858
2000,OREGON,DOUGLAS,14193,2733,30294,47220,0.300571791613723,0.6415501905972045,0.05787801778907243
2000,OREGON,GILLIAM,359,52,679,1090,0.3293577981651376,0.6229357798165137,0.047706422018348627
2000,OREGON,GRANT,589,179,3078,3846,0.15314612584503381,0.8003120124804992,0.04654186167446698
2000,OREGON,HARNEY,766,169,2799,3734,0.2051419389394751,0.7495982860203535,0.045259775040171396
2000,OREGON,HOOD RIVER,4072,756,3721,8549,0.4763130190665575,0.4352555854485905,0.08843139548485203
2000,OREGON,JACKSON,33153,5591,46052,84796,0.390973630831643,0.5430916552667578,0.06593471390159913
2000,OREGON,JEFFERSON,2681,378,3838,6897,0.3887197332173409,0.5564738292011019,0.0548064375815572
2000,OREGON,JOSEPHINE,11864,2683,22186,36733,0.322979337380557,0.6039800724144502,0.07304059020499279
2000,OREGON,KLAMATH,7541,1448,18855,27844,0.2708303404683235,0.6771656371211033,0.05200402241057319
2000,OREGON,LAKE,707,192,2830,3729,0.1895950657012604,0.7589165996245643,0.05148833467417538
2000,OREGON,LANE,78583,12027,61578,152188,0.5163547717297028,0.4046179725076879,0.07902725576260941
2000,OREGON,LINCOLN,10861,1811,8446,21118,0.5143005966474098,0.3999431764371626,0.0857562269154276
2000,OREGON,LINN,16682,2347,25359,44388,0.3758222943137785,0.5713030548796972,0.05287465080652429
2000,OREGON,MALHEUR,2336,444,7624,10404,0.2245290272971934,0.73279507881584,0.04267589388696655
2000,OREGON,MARION,49430,6461,57443,113334,0.4361444932676867,0.5068470185469497,0.057008488185363616
2000,OREGON,MORROW,1197,188,2224,3609,0.3316708229426434,0.6162371848157384,0.052091992241618174
2000,OREGON,MULTNOMAH,188441,24567,83677,296685,0.6351551308626995,0.2820398739403745,0.08280499519692604
2000,OREGON,POLK,11921,1540,14988,28449,0.41903054588913496,0.5268374986818517,0.05413195542901332
2000,OREGON,SHERMAN,326,57,679,1062,0.3069679849340866,0.6393596986817326,0.05367231638418079
2000,OREGON,TILLAMOOK,5762,839,5775,12376,0.4655785391079509,0.4666289592760181,0.06779250161603102
2000,OREGON,UMATILLA,7809,1111,14140,23060,0.3386383347788378,0.6131830008673027,0.0481786643538595
2000,OREGON,UNION,3577,663,7836,12076,0.2962073534282875,0.6488903610467042,0.05490228552500828
2000,OREGON,WALLOWA,836,179,3279,4294,0.19469026548672566,0.763623660922217,0.04168607359105729
2000,OREGON,WASCO,4616,692,5356,10664,0.43285821455363843,0.5022505626406601,0.06489122280570142
2000,OREGON,WASHINGTON,90662,9221,86091,185974,0.48749825244389,0.4629195478937916,0.04958219966231839
2000,OREGON,WHEELER,202,55,584,841,0.24019024970273484,0.6944114149821641,0.06539833531510107
2000,OREGON,YAMHILL,14254,2092,19193,35539,0.40108050310926024,0.540054587917499,0.05886490897324066
2000,PENNSYLVANIA,ADAMS,11682,903,20848,33433,0.3494152484072623,0.62357550922741,0.02700924236532767
2000,PENNSYLVANIA,ALLEGHENY,329963,17154,235361,582478,0.5664814808456285,0.40406847983958194,0.02945003931478957
2000,PENNSYLVANIA,ARMSTRONG,11127,788,15508,27423,0.4057542938409364,0.5655107026948182,0.028735003464245342
2000,PENNSYLVANIA,BEAVER,38925,2177,32491,73593,0.5289225877461171,0.4414957944369709,0.029581617816911935
2000,PENNSYLVANIA,BEDFORD,5474,363,13598,19435,0.2816568047337278,0.6996655518394649,0.018677643426807305
2000,PENNSYLVANIA,BERKS,59150,4740,71273,135163,0.4376197628049096,0.527311468375221,0.035068768819869346
2000,PENNSYLVANIA,BLAIR,15774,990,28376,45140,0.34944616747895435,0.6286220646876385,0.021931767833407178
2000,PENNSYLVANIA,BRADFORD,7911,759,14660,23330,0.33909129875696525,0.6283754822117446,0.03253321903129018
2000,PENNSYLVANIA,BUCKS,132914,8581,121927,263422,0.504566816742717,0.4628580756352924,0.03257510762199057
2000,PENNSYLVANIA,BUTLER,25037,1778,44009,70824,0.3535101095673783,0.6213854060770361,0.02510448435558568
2000,PENNSYLVANIA,CAMBRIA,30308,1977,28001,60286,0.5027369538532993,0.46446936270444217,0.03279368344225857
2000,PENNSYLVANIA,CAMERON,779,84,1383,2246,0.3468388245770258,0.6157613535173642,0.037399821905609976
2000,PENNSYLVANIA,CARBON,10668,892,9717,21277,0.5013864736570005,0.4566903228838652,0.04192320345913428
2000,PENNSYLVANIA,CENTRE,21409,1957,26172,49538,0.43217328111752595,0.5283216924381283,0.03950502644434575
2000,PENNSYLVANIA,CHESTER,82047,5435,100080,187562,0.4374393533871466,0.5335835617022637,0.028977084910589566
2000,PENNSYLVANIA,CLARION,5605,442,9796,15843,0.35378400555450357,0.618317237896863,0.027898756548633465
2000,PENNSYLVANIA,CLEARFIELD,11718,872,18019,30609,0.38282857982946195,0.5886830670717763,0.028488353098761802
2000,PENNSYLVANIA,CLINTON,5521,409,6064,11994,0.4603134900783725,0.5055861263965316,0.03410038352509588
2000,PENNSYLVANIA,COLUMBIA,8975,824,12095,21894,0.40992966109436374,0.552434456928839,0.0376358819767973
2000,PENNSYLVANIA,CRAWFORD,13250,1213,18858,33321,0.39764712943789204,0.565949401278473,0.03640346928363494
2000,PENNSYLVANIA,CUMBERLAND,31053,2207,54802,88062,0.3526265585610138,0.622311553223865,0.025061888215121165
2000,PENNSYLVANIA,DAUPHIN,44390,2637,53631,100658,0.4409982316358362,0.5328041487015438,0.02619761966261996
2000,PENNSYLVANIA,DELAWARE,134861,7380,105836,248077,0.543625567868041,0.4266256041470995,0.02974882798485954
2000,PENNSYLVANIA,ELK,5754,477,7347,13578,0.42377375165709236,0.541095890410959,0.03513035793194874
2000,PENNSYLVANIA,ERIE,59399,3909,49027,112335,0.5287666355098589,0.43643566119197047,0.03479770329817065
2000,PENNSYLVANIA,FAYETTE,28152,1367,20013,49532,0.568359848178955,0.40404183154324474,0.02759832027780021
2000,PENNSYLVANIA,FOREST,843,69,1371,2283,0.3692509855453351,0.6005256241787122,0.030223390275952694
2000,PENNSYLVANIA,FRANKLIN,14922,1005,33042,48969,0.30472339643447893,0.6747534154260859,0.020523188139435152
2000,PENNSYLVANIA,FULTON,1425,107,3753,5285,0.2696310312204352,0.7101229895931883,0.020245979186376536
2000,PENNSYLVANIA,GREENE,7230,514,5890,13634,0.5302919172656594,0.43200821475722456,0.03769986797711603
2000,PENNSYLVANIA,HUNTINGDON,5073,476,10408,15957,0.3179169016732469,0.6522529297486996,0.02983016857805352
2000,PENNSYLVANIA,INDIANA,13667,935,16799,31401,0.4352409158943983,0.5349829623260406,0.02977612177956116
2000,PENNSYLVANIA,JEFFERSON,5566,535,11473,17574,0.31671787868442014,0.6528394218732219,0.03044269944235803
2000,PENNSYLVANIA,JUNIATA,2656,216,5795,8667,0.306449751932618,0.6686281296873198,0.024922118380062305
2000,PENNSYLVANIA,LACKAWANNA,57471,3814,35096,96381,0.5962897251532978,0.3641381600107905,0.039572114835911644
2000,PENNSYLVANIA,LANCASTER,54968,4449,115900,175317,0.31353491104684655,0.6610882002315805,0.025376888721572923
2000,PENNSYLVANIA,LAWRENCE,20593,987,18060,39640,0.5195005045408678,0.4556004036326943,0.02489909182643794
2000,PENNSYLVANIA,LEBANON,16093,1253,28534,45880,0.35076285963382736,0.6219267654751526,0.02731037489102005
2000,PENNSYLVANIA,LEHIGH,56667,4121,55492,116280,0.4873323013415893,0.47722738218094257,0.03544031647746818
2000,PENNSYLVANIA,LUZERNE,62199,5059,52328,119586,0.520119411971301,0.43757630491863597,0.042304283110063054
2000,PENNSYLVANIA,LYCOMING,14663,1383,27137,43183,0.33955491744436467,0.628418590649098,0.032026491906537294
2000,PENNSYLVANIA,MCKEAN,5510,633,9661,15804,0.3486459124272336,0.6113009364717793,0.04005315110098709
2000,PENNSYLVANIA,MERCER,23817,1776,23132,48725,0.4888045151359672,0.4747460236018471,0.036449461262185734
2000,PENNSYLVANIA,MIFFLIN,4835,379,9400,14614,0.33084713288627343,0.6432188312576981,0.025934035856028465
2000,PENNSYLVANIA,MONROE,21939,1674,23265,46878,0.4680020478689364,0.4962882375527966,0.03570971457826699
2000,PENNSYLVANIA,MONTGOMERY,177990,8809,145623,332422,0.5354338762175789,0.438066674287502,0.02649944949491911
2000,PENNSYLVANIA,MONTOUR,2356,176,3960,6492,0.3629081947011707,0.609981515711645,0.027110289587184228
2000,PENNSYLVANIA,NORTHAMPTON,53097,4197,47396,104690,0.5071831120450855,0.45272709905435093,0.04008978890056357
2000,PENNSYLVANIA,NORTHUMBERLAND,13670,1439,18142,33251,0.4111154551742805,0.5456076508977173,0.043276893928002165
2000,PENNSYLVANIA,PERRY,4459,428,11184,16071,0.27745628772322817,0.6959118909837596,0.026631821293012257
2000,PENNSYLVANIA,PHILADELPHIA,449182,11039,100959,561180,0.8004241063473395,0.17990484336576498,0.01967105028689547
2000,PENNSYLVANIA,PIKE,7330,695,9339,17364,0.42213775627735545,0.5378369039391845,0.04002533978346003
2000,PENNSYLVANIA,POTTER,2037,195,4858,7090,0.28730606488011284,0.6851904090267983,0.027503526093088856
2000,PENNSYLVANIA,SCHUYLKILL,26215,2244,29841,58300,0.44965694682675816,0.511852487135506,0.038490566037735846
2000,PENNSYLVANIA,SNYDER,3536,342,8963,12841,0.27536796199672925,0.6979985982400124,0.026633439763258313
2000,PENNSYLVANIA,SOMERSET,12028,739,20218,32985,0.3646505987570108,0.6129452781567379,0.022404123086251327
2000,PENNSYLVANIA,SULLIVAN,1066,111,1928,3105,0.343317230273752,0.6209339774557165,0.035748792270531404
2000,PENNSYLVANIA,SUSQUEHANNA,6481,564,10226,17271,0.3752533148051647,0.592090788026171,0.03265589716866423
2000,PENNSYLVANIA,TIOGA,4617,520,9635,14772,0.31255077173030055,0.6522474952613052,0.035201733008394256
2000,PENNSYLVANIA,UNION,4209,443,8523,13175,0.3194686907020873,0.6469070208728652,0.03362428842504744
2000,PENNSYLVANIA,VENANGO,8196,685,11642,20523,0.3993568191784827,0.5672659942503533,0.03337718657116406
2000,PENNSYLVANIA,WARREN,7537,714,9290,17541,0.42967903768314236,0.5296163274613762,0.040704634855481446
2000,PENNSYLVANIA,WASHINGTON,44961,2141,37339,84441,0.5324546132802785,0.4421904051349463,0.025354981584775168
2000,PENNSYLVANIA,WAYNE,6904,809,11201,18914,0.3650206196468225,0.592206830918896,0.042772549434281486
2000,PENNSYLVANIA,WESTMORELAND,71792,4059,80858,156709,0.4581230178228436,0.5159754704579826,0.025901511719173754
2000,PENNSYLVANIA,WYOMING,4363,408,6922,11693,0.373129222611819,0.59197810655948,0.034892670828700935
2000,PENNSYLVANIA,YORK,51958,4634,87652,144244,0.3602090901527967,0.6076647902165775,0.032126119630625886
2000,RHODE ISLAND,BRISTOL,13424,1473,8375,23272,0.576830525953936,0.359874527328979,0.06329494671708491
2000,RHODE ISLAND,FEDERAL PRECINCT,0,0,0,0,,,
2000,RHODE ISLAND,KENT,43265,4914,25291,73470,0.5888798148904315,0.3442357424799238,0.06688444262964476
2000,RHODE ISLAND,NEWPORT,20790,2790,14258,37838,0.5494476452243776,0.37681695649875785,0.07373539827686452
2000,RHODE ISLAND,PROVIDENCE,142469,14461,61378,218308,0.6526054931564579,0.2811532330468879,0.06624127379665427
2000,RHODE ISLAND,WASHINGTON,29560,5411,21253,56224,0.5257541263517359,0.37800583380762665,0.09624003984063745
2000,SOUTH CAROLINA,ABBEVILLE,3766,158,4450,8374,0.44972534033914496,0.5314067351325531,0.018867924528301886
2000,SOUTH CAROLINA,AIKEN,16409,1170,33203,50782,0.32312630459611674,0.6538340356819345,0.023039659721948724
2000,SOUTH CAROLINA,ALLENDALE,2338,35,967,3340,0.7,0.2895209580838323,0.010479041916167664
2000,SOUTH CAROLINA,ANDERSON,19606,1248,35827,56681,0.34590074275330357,0.6320812970836789,0.02201796016301759
2000,SOUTH CAROLINA,BAMBERG,3451,53,2047,5551,0.6216897856242118,0.36876238515582777,0.009547829219960368
2000,SOUTH CAROLINA,BARNWELL,3661,94,4521,8276,0.44236346060898984,0.5462783953600774,0.011358144030932818
2000,SOUTH CAROLINA,BEAUFORT,17487,1100,25561,44148,0.39609948355531394,0.5789843254507565,0.02491619099392951
2000,SOUTH CAROLINA,BERKELEY,17707,813,24796,43316,0.4087865915597008,0.5724443623603287,0.01876904607997045
2000,SOUTH CAROLINA,CALHOUN,3063,94,3216,6373,0.48062137141063865,0.5046289031853131,0.01474972540404833
2000,SOUTH CAROLINA,CHARLESTON,49520,3727,58229,111476,0.4442211776525889,0.5223456169937923,0.03343320535361872
2000,SOUTH CAROLINA,CHEROKEE,6138,285,9900,16323,0.37603381731299396,0.6065061569564418,0.017460025730564235
2000,SOUTH CAROLINA,CHESTER,5242,204,4986,10432,0.5024923312883436,0.47795245398773006,0.019555214723926382
2000,SOUTH CAROLINA,CHESTERFIELD,6111,149,6266,12526,0.48786524030017564,0.5002395018361807,0.011895257863643621
2000,SOUTH CAROLINA,CLARENDON,5999,105,5186,11290,0.5313551815766164,0.45934455270150576,0.009300265721877768
2000,SOUTH CAROLINA,COLLETON,6449,174,6767,13390,0.48162808065720686,0.5053771471247199,0.01299477221807319
2000,SOUTH CAROLINA,DARLINGTON,10253,320,11290,21863,0.46896583268535885,0.516397566665142,0.014636600649499154
2000,SOUTH CAROLINA,DILLON,4930,85,3975,8990,0.5483870967741935,0.4421579532814238,0.009454949944382647
2000,SOUTH CAROLINA,DORCHESTER,12168,739,20734,33641,0.3617014951993104,0.6163312624476086,0.021967242353081062
2000,SOUTH CAROLINA,EDGEFIELD,3950,124,4760,8834,0.4471360652026262,0.5388272583201268,0.014036676477247
2000,SOUTH CAROLINA,FAIRFIELD,5263,124,3011,8398,0.6266968325791855,0.35853774708263875,0.014765420338175756
2000,SOUTH CAROLINA,FLORENCE,17157,602,23678,41437,0.4140502449501653,0.5714216762796535,0.01452807877018124
2000,SOUTH CAROLINA,GEORGETOWN,9445,371,10535,20351,0.4641049579873225,0.5176649796078817,0.018230062404795834
2000,SOUTH CAROLINA,GREENVILLE,43810,3769,92714,140293,0.3122750244131924,0.6608597720484986,0.02686520353830911
2000,SOUTH CAROLINA,GREENWOOD,8139,528,12193,20860,0.3901725790987536,0.5845158197507191,0.025311601150527326
2000,SOUTH CAROLINA,HAMPTON,4896,65,2798,7759,0.6310091506637453,0.36061348111870084,0.008377368217553808
2000,SOUTH CAROLINA,HORRY,29113,1852,40300,71265,0.4085175050866484,0.565494983512243,0.02598751140110854
2000,SOUTH CAROLINA,JASPER,3646,409,2414,6469,0.5636110681712784,0.3731643221518009,0.0632246096769207
2000,SOUTH CAROLINA,KERSHAW,7428,338,11911,19677,0.3774965695990242,0.6053260151445851,0.01717741525639071
2000,SOUTH CAROLINA,LANCASTER,8782,247,11676,20705,0.4241487563390485,0.5639217580294614,0.011929485631489978
2000,SOUTH CAROLINA,LAURENS,7920,388,12102,20410,0.3880450759431651,0.5929446349828515,0.01901028907398334
2000,SOUTH CAROLINA,LEE,3899,68,2675,6642,0.5870219813309244,0.40274013851249624,0.010237880156579343
2000,SOUTH CAROLINA,LEXINGTON,22830,2156,58095,83081,0.27479207038913833,0.6992573512596141,0.025950578351247578
2000,SOUTH CAROLINA,MARION,7358,104,4687,12149,0.6056465552720388,0.38579306938842706,0.008560375339534118
2000,SOUTH CAROLINA,MARLBORO,5060,124,2699,7883,0.6418876062412787,0.3423823417480655,0.015730052010655842
2000,SOUTH CAROLINA,MCCORMICK,1896,61,1704,3661,0.517891286533734,0.4654465992898115,0.01666211417645452
2000,SOUTH CAROLINA,NEWBERRY,4428,452,7492,12372,0.35790494665373423,0.6055609440672486,0.03653410927901714
2000,SOUTH CAROLINA,OCONEE,7571,640,15364,23575,0.3211452810180276,0.6517073170731708,0.027147401908801695
2000,SOUTH CAROLINA,ORANGEBURG,19802,275,12657,32734,0.6049367629987169,0.3866621861061893,0.008401050895093786
2000,SOUTH CAROLINA,PICKENS,8927,974,24681,34582,0.25814007287027935,0.7136949858307791,0.028164941298941645
2000,SOUTH CAROLINA,RICHLAND,63179,3138,50164,116481,0.5423974725491711,0.4306625114825594,0.026940015968269504
2000,SOUTH CAROLINA,SALUDA,2682,111,4098,6891,0.3892033086634741,0.5946887244231607,0.01610796691336526
2000,SOUTH CAROLINA,SPARTANBURG,29559,1880,52114,83553,0.3537754479192848,0.6237238638947734,0.022500688185941857
2000,SOUTH CAROLINA,SUMTER,14365,392,15915,30672,0.46834246218049036,0.518877151799687,0.01278038601982264
2000,SOUTH CAROLINA,UNION,4662,159,5768,10589,0.44026820285201623,0.5447162149400321,0.015015582207951648
2000,SOUTH CAROLINA,WILLIAMSBURG,6723,84,4524,11331,0.5933280381254964,0.39925867090283296,0.007413290971670638
2000,SOUTH CAROLINA,YORK,19251,1324,33776,54351,0.3541977148534526,0.6214421077809056,0.024360177365641847
2000,SOUTH DAKOTA,AURORA,513,53,847,1413,0.3630573248407643,0.5994338287331918,0.03750884642604388
2000,SOUTH DAKOTA,BEADLE,3216,176,4347,7739,0.41555756557694795,0.5617004780979454,0.022741956325106602
2000,SOUTH DAKOTA,BENNETT,377,27,712,1116,0.3378136200716846,0.6379928315412187,0.024193548387096774
2000,SOUTH DAKOTA,BON HOMME,1162,76,1901,3139,0.37018158649251354,0.6056068811723478,0.024211532335138577
2000,SOUTH DAKOTA,BROOKINGS,4546,226,6212,10984,0.41387472687545523,0.5655498907501821,0.02057538237436271
2000,SOUTH DAKOTA,BROWN,7173,323,9060,16556,0.43325682532012566,0.547233631311911,0.019509543367963275
2000,SOUTH DAKOTA,BRULE,818,81,1268,2167,0.3774803876326719,0.5851407475772958,0.0373788647900323
2000,SOUTH DAKOTA,BUFFALO,256,12,140,408,0.6274509803921569,0.3431372549019608,0.029411764705882353
2000,SOUTH DAKOTA,BUTTE,840,89,2760,3689,0.22770398481973433,0.74817023583627,0.024125779343995662
2000,SOUTH DAKOTA,CAMPBELL,147,31,739,917,0.16030534351145037,0.8058887677208287,0.03380588876772083
2000,SOUTH DAKOTA,CHARLES MIX,1300,74,2205,3579,0.3632299525006985,0.6160938809723386,0.020676166526962837
2000,SOUTH DAKOTA,CLARK,791,45,1272,2108,0.3752371916508539,0.603415559772296,0.021347248576850095
2000,SOUTH DAKOTA,CLAY,2638,104,2363,5105,0.5167482859941234,0.46287952987267383,0.020372184133202742
2000,SOUTH DAKOTA,CODINGTON,4192,228,6718,11138,0.3763691865685042,0.6031603519482851,0.02047046148321063
2000,SOUTH DAKOTA,CORSON,549,65,629,1243,0.4416733708769107,0.5060337892196299,0.05229283990345937
2000,SOUTH DAKOTA,CUSTER,955,123,2495,3573,0.2672823957458718,0.6982927511894766,0.03442485306465155
2000,SOUTH DAKOTA,DAVISON,2936,147,4445,7528,0.3900106269925611,0.5904622741764081,0.019527098831030817
2000,SOUTH DAKOTA,DAY,1492,82,1623,3197,0.4666875195495777,0.5076634344698154,0.02564904598060682
2000,SOUTH DAKOTA,DEUEL,926,53,1245,2224,0.41636690647482016,0.5598021582733813,0.023830935251798562
2000,SOUTH DAKOTA,DEWEY,880,40,761,1681,0.5234979179060083,0.4527067221891731,0.02379535990481856
2000,SOUTH DAKOTA,DOUGLAS,363,35,1311,1709,0.21240491515506144,0.7671152720889409,0.02047981275599766
2000,SOUTH DAKOTA,EDMUNDS,676,53,1257,1986,0.3403826787512588,0.6329305135951662,0.026686807653575024
2000,SOUTH DAKOTA,FALL RIVER,1133,111,2185,3429,0.3304170312044328,0.6372120151647711,0.03237095363079615
2000,SOUTH DAKOTA,FAULK,388,37,904,1329,0.29194883370955604,0.6802106847253574,0.02784048156508653
2000,SOUTH DAKOTA,GRANT,1475,120,2235,3830,0.38511749347258484,0.5835509138381201,0.031331592689295036
2000,SOUTH DAKOTA,GREGORY,718,52,1487,2257,0.3181214000886132,0.6588391670358883,0.02303943287549845
2000,SOUTH DAKOTA,HAAKON,164,27,938,1129,0.14526129317980513,0.8308237378210807,0.023914968999114262
2000,SOUTH DAKOTA,HAMLIN,923,69,1731,2723,0.33896437752478886,0.6356959236136615,0.025339698861549763
2000,SOUTH DAKOTA,HAND,565,47,1419,2031,0.2781880846873461,0.6986706056129985,0.023141309699655343
2000,SOUTH DAKOTA,HANSON,457,20,944,1421,0.3216045038705137,0.6643209007741028,0.014074595355383532
2000,SOUTH DAKOTA,HARDING,64,17,650,731,0.08755129958960328,0.8891928864569083,0.023255813953488372
2000,SOUTH DAKOTA,HUGHES,2212,134,5188,7534,0.2936023360764534,0.6886116272896204,0.0177860366339262
2000,SOUTH DAKOTA,HUTCHINSON,1052,76,2497,3625,0.29020689655172416,0.6888275862068965,0.020965517241379312
2000,SOUTH DAKOTA,HYDE,218,25,592,835,0.26107784431137726,0.7089820359281437,0.029940119760479042
2000,SOUTH DAKOTA,JACKSON,319,34,687,1040,0.30673076923076925,0.6605769230769231,0.032692307692307694
2000,SOUTH DAKOTA,JERAULD,468,30,624,1122,0.41711229946524064,0.5561497326203209,0.026737967914438502
2000,SOUTH DAKOTA,JONES,137,18,509,664,0.2063253012048193,0.766566265060241,0.02710843373493976
2000,SOUTH DAKOTA,KINGSBURY,1049,66,1612,2727,0.3846718005133847,0.5911257792445911,0.0242024202420242
2000,SOUTH DAKOTA,LAKE,2331,99,2724,5154,0.4522700814901048,0.5285215366705471,0.01920838183934808
2000,SOUTH DAKOTA,LAWRENCE,2797,282,6327,9406,0.2973633850733574,0.6726557516478844,0.02998086327875824
2000,SOUTH DAKOTA,LINCOLN,3844,166,6546,10556,0.36415308829101933,0.6201212580522926,0.01572565365668814
2000,SOUTH DAKOTA,LYMAN,482,29,875,1386,0.3477633477633478,0.6313131313131313,0.020923520923520924
2000,SOUTH DAKOTA,MARSHALL,939,43,1097,2079,0.45165945165945165,0.5276575276575276,0.02068302068302068
2000,SOUTH DAKOTA,MCCOOK,965,56,1610,2631,0.3667806917521855,0.6119346256176359,0.021284682630178638
2000,SOUTH DAKOTA,MCPHERSON,295,49,1073,1417,0.2081863091037403,0.7572335920959774,0.03458009880028229
2000,SOUTH DAKOTA,MEADE,2267,229,6870,9366,0.24204569720264787,0.7335041639974376,0.024450138799914586
2000,SOUTH DAKOTA,MELLETTE,222,16,495,733,0.30286493860845837,0.6753069577080492,0.021828103683492497
2000,SOUTH DAKOTA,MINER,523,19,724,1266,0.41311216429699843,0.5718799368088467,0.015007898894154818
2000,SOUTH DAKOTA,MINNEHAHA,27042,899,33428,61369,0.4406459287262299,0.5447049813423716,0.014649089931398589
2000,SOUTH DAKOTA,MOODY,1318,56,1361,2735,0.4819012797074954,0.4976234003656307,0.020475319926873858
2000,SOUTH DAKOTA,OGLALA LAKOTA,1667,34,252,1953,0.8535586277521762,0.12903225806451613,0.017409114183307733
2000,SOUTH DAKOTA,PENNINGTON,11123,738,24696,36557,0.30426457313236865,0.6755477747079902,0.02018765215964111
2000,SOUTH DAKOTA,PERKINS,297,80,1237,1614,0.18401486988847585,0.7664188351920694,0.04956629491945477
2000,SOUTH DAKOTA,POTTER,356,26,1112,1494,0.23828647925033467,0.7443105756358769,0.01740294511378849
2000,SOUTH DAKOTA,ROBERTS,1700,137,2237,4074,0.4172803141875307,0.5490918016691213,0.03362788414334806
2000,SOUTH DAKOTA,SANBORN,468,33,767,1268,0.36908517350157727,0.6048895899053628,0.026025236593059938
2000,SOUTH DAKOTA,SPINK,1274,53,1957,3284,0.3879415347137637,0.5959196102314251,0.016138855054811205
2000,SOUTH DAKOTA,STANLEY,402,24,955,1381,0.29109341057204924,0.6915278783490224,0.017378711078928313
2000,SOUTH DAKOTA,SULLY,209,29,633,871,0.2399540757749713,0.7267508610792193,0.03329506314580941
2000,SOUTH DAKOTA,TODD,993,23,478,1494,0.6646586345381527,0.31994645247657294,0.015394912985274432
2000,SOUTH DAKOTA,TRIPP,799,57,1909,2765,0.2889692585895118,0.6904159132007234,0.02061482820976492
2000,SOUTH DAKOTA,TURNER,1414,76,2514,4004,0.3531468531468531,0.6278721278721279,0.01898101898101898
2000,SOUTH DAKOTA,UNION,2358,149,3265,5772,0.4085239085239085,0.5656618156618156,0.025814275814275815
2000,SOUTH DAKOTA,WALWORTH,721,74,1758,2553,0.28241284763023894,0.6886016451233843,0.028985507246376812
2000,SOUTH DAKOTA,YANKTON,3596,240,4904,8740,0.411441647597254,0.5610983981693364,0.02745995423340961
2000,SOUTH DAKOTA,ZIEBACH,314,23,384,721,0.435506241331484,0.5325936199722607,0.0319001386962552
2000,TENNESSEE,ANDERSON,13556,535,14688,28779,0.47103790958685154,0.5103721463567185,0.018589944056430035
2000,TENNESSEE,BEDFORD,6136,160,5911,12207,0.5026624068157615,0.48423035962972066,0.0131072335545179
2000,TENNESSEE,BENTON,3700,127,2484,6311,0.5862779274282998,0.39359847884645854,0.020123593725241643
2000,TENNESSEE,BLEDSOE,1756,60,2380,4196,0.4184938036224976,0.567206863679695,0.014299332697807437
2000,TENNESSEE,BLOUNT,14688,701,25273,40662,0.3612217795484728,0.621538537209188,0.017239683242339286
2000,TENNESSEE,BRADLEY,8768,508,20167,29443,0.29779574092313965,0.6849505824814047,0.017253676595455625
2000,TENNESSEE,CAMPBELL,6492,145,5784,12421,0.5226632316238629,0.4656629900974157,0.01167377827872152
2000,TENNESSEE,CANNON,2697,76,1924,4697,0.574196295507771,0.40962316372152435,0.016180540770704705
2000,TENNESSEE,CARROLL,5239,123,5465,10827,0.48388288537914476,0.5047566269511407,0.011360487669714602
2000,TENNESSEE,CARTER,6724,267,12111,19102,0.3520050256517642,0.6340173803790179,0.013977593969217883
2000,TENNESSEE,CHEATHAM,6062,198,6356,12616,0.48050095117311353,0.5038046924540266,0.01569435637285986
2000,TENNESSEE,CHESTER,2192,49,3487,5728,0.38268156424581007,0.608763966480447,0.008554469273743016
2000,TENNESSEE,CLAIBORNE,3841,136,5023,9000,0.42677777777777776,0.5581111111111111,0.015111111111111112
2000,TENNESSEE,CLAY,1931,43,1468,3442,0.5610110400929692,0.4264962231260895,0.012492736780941312
2000,TENNESSEE,COCKE,3872,182,6185,10239,0.3781619298759645,0.6040628967672624,0.017775173356773123
2000,TENNESSEE,COFFEE,8741,259,8788,17788,0.49139869574994377,0.4940409264672813,0.014560377782774905
2000,TENNESSEE,CROCKETT,2705,59,2676,5440,0.49724264705882354,0.4919117647058823,0.010845588235294117
2000,TENNESSEE,CUMBERLAND,7644,379,10994,19017,0.40195614450228745,0.5781143187674186,0.019929536730293948
2000,TENNESSEE,DAVIDSON,120508,3963,84117,208588,0.5777321801829444,0.40326864440907434,0.018999175407981284
2000,TENNESSEE,DECATUR,2278,46,2046,4370,0.5212814645308924,0.46819221967963387,0.010526315789473684
2000,TENNESSEE,DEKALB,3765,89,2411,6265,0.6009577015163607,0.3848363926576217,0.014205905826017558
2000,TENNESSEE,DICKSON,8332,208,7016,15556,0.5356132681923373,0.4510156852661353,0.013371046541527385
2000,TENNESSEE,DYER,5425,134,6282,11841,0.4581538721391774,0.5305295160881682,0.011316611772654337
2000,TENNESSEE,FAYETTE,5037,90,6402,11529,0.4368982565703877,0.5552953421805881,0.0078064012490242
2000,TENNESSEE,FENTRESS,2529,83,3417,6029,0.4194725493448333,0.5667606568253442,0.013766793829822524
2000,TENNESSEE,FRANKLIN,7828,303,6560,14691,0.5328432373562044,0.44653189027295626,0.02062487237083929
2000,TENNESSEE,GIBSON,8663,188,8286,17137,0.5055143840812277,0.48351520102701756,0.010970414891754683
2000,TENNESSEE,GILES,5527,162,4377,10066,0.5490760977548182,0.43483012120007947,0.016093781045102326
2000,TENNESSEE,GRAINGER,2361,87,3746,6194,0.3811753309654504,0.6047788182111721,0.014045850823377462
2000,TENNESSEE,GREENE,7909,367,12540,20816,0.37994811683320523,0.6024212144504227,0.017630668716372023
2000,TENNESSEE,GRUNDY,2970,73,1553,4596,0.6462140992167101,0.3379025239338555,0.01588337684943429
2000,TENNESSEE,HAMBLEN,7564,311,11824,19699,0.38397888217676024,0.6002335143915934,0.015787603431646275
2000,TENNESSEE,HAMILTON,51708,2066,66605,120379,0.429543358891501,0.5532941792173054,0.017162461891193647
2000,TENNESSEE,HANCOCK,690,42,1343,2075,0.3325301204819277,0.6472289156626506,0.020240963855421686
2000,TENNESSEE,HARDEMAN,4953,121,3729,8803,0.5626490968987845,0.42360558900374873,0.013745314097466772
2000,TENNESSEE,HARDIN,3735,96,4951,8782,0.42530175358688227,0.5637667957185152,0.010931450694602596
2000,TENNESSEE,HAWKINS,6753,274,10071,17098,0.39495847467540063,0.5890162592116037,0.01602526611299567
2000,TENNESSEE,HAYWOOD,3887,37,2554,6478,0.6000308737264588,0.39425748687866624,0.005711639394874961
2000,TENNESSEE,HENDERSON,3166,80,5153,8399,0.37694963686153116,0.6135254196928206,0.009524943445648292
2000,TENNESSEE,HENRY,6093,272,5944,12309,0.4950036558615647,0.4828986920139735,0.022097652124461777
2000,TENNESSEE,HICKMAN,4239,111,2914,7264,0.5835627753303965,0.40115638766519823,0.015280837004405287
2000,TENNESSEE,HOUSTON,2081,53,993,3127,0.6654940837863768,0.3175567636712504,0.01694915254237288
2000,TENNESSEE,HUMPHREYS,4205,89,2387,6681,0.6293967968866936,0.35728184403532404,0.013321359077982337
2000,TENNESSEE,JACKSON,3304,66,1384,4754,0.6949936895246108,0.29112326461926796,0.013883045856121162
2000,TENNESSEE,JEFFERSON,5226,204,8657,14087,0.370980336480443,0.6145382267338682,0.014481436785688933
2000,TENNESSEE,JOHNSON,1813,104,3740,5657,0.32048789110836134,0.6611278062577338,0.018384302633904896
2000,TENNESSEE,KNOX,60969,2766,86851,150586,0.4048782755369025,0.5767534830595141,0.018368241403583334
2000,TENNESSEE,LAKE,1419,24,781,2224,0.6380395683453237,0.3511690647482014,0.01079136690647482
2000,TENNESSEE,LAUDERDALE,4224,65,3329,7618,0.5544762404830664,0.43699133630874243,0.008532423208191127
2000,TENNESSEE,LAWRENCE,6643,214,7613,14470,0.45908776779543886,0.526123013130615,0.014789219073946095
2000,TENNESSEE,LEWIS,2281,102,2037,4420,0.5160633484162896,0.4608597285067873,0.023076923076923078
2000,TENNESSEE,LINCOLN,5060,164,5435,10659,0.47471620227038186,0.5098977389999062,0.015386058729711981
2000,TENNESSEE,LOUDON,5905,235,10266,16406,0.35992929416067293,0.6257466780446178,0.014324027794709253
2000,TENNESSEE,MACON,3059,66,3366,6491,0.4712679094130334,0.5185641657679865,0.010167924818980127
2000,TENNESSEE,MADISON,15781,287,17862,33930,0.4651046271735927,0.5264367816091954,0.008458591217211906
2000,TENNESSEE,MARION,5441,158,4651,10250,0.530829268292683,0.4537560975609756,0.015414634146341463
2000,TENNESSEE,MARSHALL,5107,147,4105,9359,0.545677957046693,0.43861523667058444,0.015706806282722512
2000,TENNESSEE,MAURY,11127,343,11930,23400,0.4755128205128205,0.5098290598290598,0.014658119658119658
2000,TENNESSEE,MCMINN,6142,303,10155,16600,0.37,0.6117469879518073,0.01825301204819277
2000,TENNESSEE,MCNAIRY,4003,89,4897,8989,0.44532206029591725,0.5447769496050728,0.009900990099009901
2000,TENNESSEE,MEIGS,1555,38,1797,3390,0.45870206489675514,0.5300884955752212,0.011209439528023599
2000,TENNESSEE,MONROE,5327,162,7514,13003,0.4096746904560486,0.5778666461585787,0.012458663385372607
2000,TENNESSEE,MONTGOMERY,18818,582,19644,39044,0.4819690605470751,0.5031246798483762,0.014906259604548715
2000,TENNESSEE,MOORE,1107,49,1145,2301,0.4810951760104302,0.49760973489787047,0.021295089091699262
2000,TENNESSEE,MORGAN,2921,97,3144,6162,0.47403440441415123,0.5102239532619279,0.015741642323920804
2000,TENNESSEE,OBION,6056,216,6168,12440,0.4868167202572347,0.4958199356913183,0.017363344051446947
2000,TENNESSEE,OVERTON,4507,114,2875,7496,0.6012540021344717,0.38353788687299895,0.015208110992529349
2000,TENNESSEE,PERRY,1650,51,1165,2866,0.5757152826238661,0.40648988136775993,0.01779483600837404
2000,TENNESSEE,PICKETT,939,19,1281,2239,0.41938365341670386,0.5721304153640018,0.008485931219294328
2000,TENNESSEE,POLK,2574,113,2907,5594,0.4601358598498391,0.5196639256346085,0.020200214515552376
2000,TENNESSEE,PUTNAM,10785,405,11248,22438,0.48065781263927265,0.501292450307514,0.018049737053213298
2000,TENNESSEE,RHEA,3722,150,5900,9772,0.3808841588211216,0.6037658616455178,0.015349979533360623
2000,TENNESSEE,ROANE,9575,406,11345,21326,0.44898246272156056,0.5319797430366688,0.019037794241770607
2000,TENNESSEE,ROBERTSON,10249,240,9675,20164,0.5082820868875223,0.47981551279508033,0.011902400317397342
2000,TENNESSEE,RUTHERFORD,27360,1377,33445,62182,0.4399987134540542,0.5378566144543437,0.02214467209160207
2000,TENNESSEE,SCOTT,2967,69,3579,6615,0.4485260770975057,0.5410430839002267,0.010430839002267574
2000,TENNESSEE,SEQUATCHIE,1648,70,2169,3887,0.4239773604322099,0.558013892462053,0.018008747105737074
2000,TENNESSEE,SEVIER,8208,423,16734,25365,0.3235955056179775,0.6597279716144293,0.01667652276759314
2000,TENNESSEE,SHELBY,190404,4595,141756,336755,0.5654080859972384,0.42094697925791746,0.013644934744844175
2000,TENNESSEE,SMITH,4884,80,2384,7348,0.6646706586826348,0.3244420250408274,0.010887316276537834
2000,TENNESSEE,STEWART,2870,86,1826,4782,0.6001672940192389,0.3818485989125889,0.017984107068172314
2000,TENNESSEE,SULLIVAN,21354,891,33482,55727,0.3831894772731351,0.6008218637285337,0.01598865899833115
2000,TENNESSEE,SUMNER,22118,758,27601,50477,0.4381797650415041,0.5468034946609347,0.015016740297561266
2000,TENNESSEE,TIPTON,6300,182,10070,16552,0.3806186563557274,0.6083856935717739,0.01099565007249879
2000,TENNESSEE,TROUSDALE,1966,29,950,2945,0.667572156196944,0.3225806451612903,0.009847198641765705
2000,TENNESSEE,UNICOI,2566,83,3780,6429,0.3991289469590916,0.5879608026131591,0.012910250427749261
2000,TENNESSEE,UNION,2564,58,3199,5821,0.44047414533585294,0.5495619309397011,0.009963923724445971
2000,TENNESSEE,VAN BUREN,1255,31,845,2131,0.5889253871421868,0.3965274519005162,0.014547160957297044
2000,TENNESSEE,WARREN,7378,201,5552,13131,0.5618764755159547,0.42281623638717536,0.015307288096870002
2000,TENNESSEE,WASHINGTON,14769,594,22579,37942,0.38925201623530653,0.5950925096199462,0.015655474144747245
2000,TENNESSEE,WAYNE,1859,77,3370,5306,0.35035808518658124,0.6351300414624953,0.014511873350923483
2000,TENNESSEE,WEAKLEY,5570,168,6106,11844,0.47028031070584264,0.5155352921310368,0.014184397163120567
2000,TENNESSEE,WHITE,4135,115,3525,7775,0.5318327974276528,0.4533762057877814,0.014790996784565916
2000,TENNESSEE,WILLIAMSON,18745,783,38901,58429,0.32081671772578685,0.6657824025740643,0.013400879700148898
2000,TENNESSEE,WILSON,16561,511,18844,35916,0.4611036863793295,0.5246686713442477,0.014227642276422764
2000,TEXAS,ANDERSON,5041,204,9835,15080,0.3342838196286472,0.6521883289124668,0.013527851458885942
2000,TEXAS,ANDREWS,876,57,3091,4024,0.21769383697813122,0.768141153081511,0.014165009940357853
2000,TEXAS,ANGELINA,9957,369,16648,26974,0.36913323941573367,0.6171869207384889,0.013679839845777416
2000,TEXAS,ARANSAS,2637,220,5390,8247,0.3197526373226628,0.65357099551352,0.026676367163817147
2000,TEXAS,ARCHER,993,53,2951,3997,0.24843632724543407,0.7383037277958469,0.013259944958719039
2000,TEXAS,ARMSTRONG,150,16,772,938,0.15991471215351813,0.8230277185501066,0.017057569296375266
2000,TEXAS,ATASCOSA,4322,193,6231,10746,0.4021961660152615,0.5798436627582356,0.017960171226502886
2000,TEXAS,AUSTIN,2407,159,6661,9227,0.26086485314836894,0.7219031104367617,0.017232036414869405
2000,TEXAS,BAILEY,488,13,1589,2090,0.23349282296650717,0.7602870813397129,0.006220095693779904
2000,TEXAS,BANDERA,1426,234,5613,7273,0.19606764746322014,0.7717585590540355,0.0321737934827444
2000,TEXAS,BASTROP,6973,1025,10310,18308,0.38087175005462093,0.5631417959362027,0.05598645400917632
2000,TEXAS,BAYLOR,663,36,1285,1984,0.3341733870967742,0.6476814516129032,0.018145161290322582
2000,TEXAS,BEE,3795,106,4429,8330,0.45558223289315725,0.5316926770708283,0.012725090036014406
2000,TEXAS,BELL,21011,1072,41208,63291,0.33197453034396673,0.6510878323932313,0.016937637262801977
2000,TEXAS,BEXAR,185158,11955,215613,412726,0.44862208826194616,0.5224119633849091,0.028965948353144703
2000,TEXAS,BLANCO,811,179,2777,3767,0.21529068224050968,0.7371913989912398,0.047517918768250594
2000,TEXAS,BORDEN,62,8,283,353,0.17563739376770537,0.8016997167138811,0.0226628895184136
2000,TEXAS,BOSQUE,1930,95,4745,6770,0.28508124076809455,0.7008862629246676,0.014032496307237814
2000,TEXAS,BOWIE,11662,333,18325,30320,0.3846306068601583,0.60438654353562,0.010982849604221636
2000,TEXAS,BRAZORIA,24883,1691,53445,80019,0.31096364613404315,0.6679038728302028,0.02113248103575401
2000,TEXAS,BRAZOS,12359,1718,32864,46941,0.26328795722289683,0.7001129076926355,0.036599135084467736
2000,TEXAS,BREWSTER,1349,364,1867,3580,0.37681564245810056,0.5215083798882681,0.10167597765363129
2000,TEXAS,BRISCOE,224,4,544,772,0.29015544041450775,0.7046632124352331,0.0051813471502590676
2000,TEXAS,BROOKS,1854,21,556,2431,0.762649115590292,0.22871246400658166,0.008638420403126285
2000,TEXAS,BROWN,3138,173,9609,12920,0.24287925696594428,0.7437306501547988,0.013390092879256965
2000,TEXAS,BURLESON,2235,89,3542,5866,0.3810092055915445,0.60381861575179,0.01517217865666553
2000,TEXAS,BURNET,3557,389,9286,13232,0.2688180169286578,0.7017835550181378,0.02939842805320435
2000,TEXAS,CALDWELL,3872,337,5216,9425,0.4108222811671087,0.5534217506631299,0.035755968169761274
2000,TEXAS,CALHOUN,2766,73,3724,6563,0.42145360353496875,0.5674234344049978,0.011122962060033522
2000,TEXAS,CALLAHAN,1174,66,3656,4896,0.2397875816993464,0.7467320261437909,0.013480392156862746
2000,TEXAS,CAMERON,33214,1043,27800,62057,0.5352176225083392,0.4479752485618061,0.016807128929854812
2000,TEXAS,CAMP,1625,38,2121,3784,0.4294397463002114,0.5605179704016914,0.01004228329809725
2000,TEXAS,CARSON,480,46,2216,2742,0.175054704595186,0.8081692195477753,0.016776075857038657
2000,TEXAS,CASS,4618,106,6295,11019,0.4190942916780107,0.5712859606134858,0.009619747708503493
2000,TEXAS,CASTRO,727,20,1607,2354,0.3088360237892948,0.6826677994902294,0.008496176720475786
2000,TEXAS,CHAMBERS,2888,149,6769,9806,0.2945135631246176,0.6902916581684683,0.015194778706914134
2000,TEXAS,CHEROKEE,4755,183,9599,14537,0.3270963747678338,0.6603150581275367,0.012588567104629566
2000,TEXAS,CHILDRESS,602,18,1506,2126,0.2831608654750706,0.7083725305738476,0.008466603951081843
2000,TEXAS,CLAY,1460,65,3112,4637,0.31485874487815396,0.6711235712745309,0.014017683847315074
2000,TEXAS,COCHRAN,344,20,807,1171,0.2937660119555935,0.6891545687446626,0.017079419299743808
2000,TEXAS,COKE,355,23,1137,1515,0.23432343234323433,0.7504950495049505,0.015181518151815182
2000,TEXAS,COLEMAN,853,38,2687,3578,0.23840134153158188,0.7509782001117943,0.010620458356623811
2000,TEXAS,COLLIN,42884,4357,128179,175420,0.24446471325960553,0.7306977539619199,0.02483753277847452
2000,TEXAS,COLLINGSWORTH,429,12,974,1415,0.30318021201413425,0.688339222614841,0.008480565371024734
2000,TEXAS,COLORADO,2229,107,4913,7249,0.3074906883708098,0.6777486549868947,0.01476065664229549
2000,TEXAS,COMAL,7131,1018,24599,32748,0.21775375595456212,0.7511603762061805,0.031085867839257358
2000,TEXAS,COMANCHE,1636,52,3334,5022,0.32576662684189567,0.663878932696137,0.010354440461967344
2000,TEXAS,CONCHO,268,17,818,1103,0.242973708068903,0.7416137805983681,0.015412511332728921
2000,TEXAS,COOKE,3153,188,10128,13469,0.23409310268022868,0.7519489197416289,0.013957977578142402
2000,TEXAS,CORYELL,4493,273,10321,15087,0.2978060581957977,0.6840988930867634,0.018095048717438854
2000,TEXAS,COTTLE,241,14,502,757,0.31836195508586523,0.6631439894319683,0.018494055482166448
2000,TEXAS,CRANE,387,21,1246,1654,0.23397823458282951,0.7533252720677146,0.012696493349455865
2000,TEXAS,CROCKETT,467,7,924,1398,0.3340486409155937,0.6609442060085837,0.005007153075822604
2000,TEXAS,CROSBY,705,27,1270,2002,0.35214785214785216,0.6343656343656343,0.013486513486513486
2000,TEXAS,CULBERSON,577,22,413,1012,0.5701581027667985,0.40810276679841895,0.021739130434782608
2000,TEXAS,DALLAM,341,18,1385,1744,0.19552752293577982,0.794151376146789,0.010321100917431193
2000,TEXAS,DALLAS,275308,15386,322345,613039,0.4490872521976579,0.5258148339665176,0.025097913835824475
2000,TEXAS,DAWSON,1463,39,3337,4839,0.30233519322174,0.6896052903492457,0.008059516429014259
2000,TEXAS,DEAF SMITH,1240,57,3687,4984,0.24879614767255218,0.7397672552166934,0.011436597110754414
2000,TEXAS,DELTA,726,31,1143,1900,0.3821052631578947,0.6015789473684211,0.01631578947368421
2000,TEXAS,DENTON,40144,4475,102171,146790,0.27347911983105117,0.6960351522583282,0.030485727910620614
2000,TEXAS,DEWITT,1570,72,4541,6183,0.25392204431505744,0.7344331230794113,0.011644832605531296
2000,TEXAS,DICKENS,284,8,589,881,0.322360953461975,0.6685584562996595,0.009080590238365494
2000,TEXAS,DIMMIT,2678,43,1032,3753,0.7135624833466561,0.2749800159872102,0.01145750066613376
2000,TEXAS,DONLEY,360,26,1333,1719,0.2094240837696335,0.7754508435136708,0.015125072716695753
2000,TEXAS,DUVAL,3990,30,1010,5030,0.7932405566600398,0.20079522862823063,0.005964214711729622
2000,TEXAS,EASTLAND,1774,109,4531,6414,0.2765824758341129,0.7064234487059557,0.0169940754599314
2000,TEXAS,ECTOR,9425,583,22893,32901,0.2864654569769916,0.6958147168779064,0.017719826145101973
2000,TEXAS,EDWARDS,261,13,663,937,0.27854855923159016,0.7075773745997865,0.013874066168623266
2000,TEXAS,EL PASO,83848,3620,57574,145042,0.5780946208684381,0.3969470911873802,0.024958287944181687
2000,TEXAS,ELLIS,10629,587,26091,37307,0.2849063178491972,0.6993593695553113,0.015734312595491462
2000,TEXAS,ERATH,2804,185,8126,11115,0.2522717049032839,0.7310841205578048,0.016644174538911382
2000,TEXAS,FALLS,2417,59,3239,5715,0.4229221347331584,0.5667541557305337,0.010323709536307962
2000,TEXAS,FANNIN,4102,164,6074,10340,0.3967117988394584,0.5874274661508704,0.01586073500967118
2000,TEXAS,FAYETTE,2542,187,6658,9387,0.27080004261212315,0.7092787898157026,0.019921167572174284
2000,TEXAS,FISHER,884,20,968,1872,0.4722222222222222,0.5170940170940171,0.010683760683760684
2000,TEXAS,FLOYD,580,10,1830,2420,0.2396694214876033,0.756198347107438,0.004132231404958678
2000,TEXAS,FOARD,263,7,286,556,0.47302158273381295,0.5143884892086331,0.012589928057553957
2000,TEXAS,FORT BEND,47569,2373,73567,123509,0.38514602174740303,0.5956408035041981,0.0192131747483989
2000,TEXAS,FRANKLIN,1018,34,2420,3472,0.2932027649769585,0.6970046082949308,0.009792626728110598
2000,TEXAS,FREESTONE,2316,78,4247,6641,0.3487426592380666,0.6395121216684234,0.011745219093510013
2000,TEXAS,FRIO,2317,37,1774,4128,0.5612887596899225,0.42974806201550386,0.008963178294573644
2000,TEXAS,GAINES,723,45,2691,3459,0.20901994796183868,0.7779705117085863,0.013009540329575022
2000,TEXAS,GALVESTON,40020,2566,50397,92983,0.43040125614359614,0.5420023014959724,0.027596442360431475
2000,TEXAS,GARZA,454,14,1302,1770,0.25649717514124293,0.735593220338983,0.007909604519774011
2000,TEXAS,GILLESPIE,1511,313,8096,9920,0.15231854838709677,0.8161290322580645,0.03155241935483871
2000,TEXAS,GLASSCOCK,39,4,528,571,0.06830122591943957,0.9246935201401051,0.0070052539404553416
2000,TEXAS,GOLIAD,1233,51,2108,3392,0.36350235849056606,0.6214622641509434,0.015035377358490566
2000,TEXAS,GONZALES,1877,100,4092,6069,0.3092766518372055,0.6742461690558577,0.01647717910693689
2000,TEXAS,GRAY,1376,77,6732,8185,0.16811240073304826,0.8224801466096519,0.009407452657299939
2000,TEXAS,GRAYSON,13647,697,25596,39940,0.3416875312969454,0.6408612919379069,0.017451176765147722
2000,TEXAS,GREGG,11244,450,26739,38433,0.2925610803215986,0.6957302318320193,0.011708687846382015
2000,TEXAS,GRIMES,2450,155,4197,6802,0.3601881799470744,0.6170244045868862,0.0227874154660394
2000,TEXAS,GUADALUPE,8311,757,21499,30567,0.2718945267772434,0.7033402034874211,0.024765269735335493
2000,TEXAS,HALE,2158,84,6868,9110,0.23688254665203073,0.7538968166849616,0.009220636663007684
2000,TEXAS,HALL,472,8,966,1446,0.326417704011065,0.6680497925311203,0.005532503457814661
2000,TEXAS,HAMILTON,878,51,2447,3376,0.26007109004739337,0.7248222748815166,0.015106635071090047
2000,TEXAS,HANSFORD,198,16,1874,2088,0.09482758620689655,0.8975095785440613,0.007662835249042145
2000,TEXAS,HARDEMAN,566,15,976,1557,0.363519588953115,0.6268464996788696,0.009633911368015413
2000,TEXAS,HARDIN,5595,279,11962,17836,0.31369141063018613,0.6706660686252524,0.015642520744561562
2000,TEXAS,HARRIS,418267,27396,529159,974822,0.42907012767459085,0.5428262800798505,0.028103592245558678
2000,TEXAS,HARRISON,8878,258,13834,22970,0.3865041358293426,0.6022638223770135,0.011232041793643883
2000,TEXAS,HARTLEY,359,27,1645,2031,0.17676021664204825,0.809945839487937,0.013293943870014771
2000,TEXAS,HASKELL,1401,38,1488,2927,0.4786470789203963,0.5083703450632047,0.012982576016399043
2000,TEXAS,HAYS,11387,2760,20170,34317,0.33181804936328935,0.5877553399189905,0.08042661071772009
2000,TEXAS,HEMPHILL,251,20,1203,1474,0.17028493894165536,0.816146540027137,0.013568521031207599
2000,TEXAS,HENDERSON,8704,316,16607,25627,0.3396417840558786,0.6480274710266516,0.012330744917469856
2000,TEXAS,HIDALGO,61390,1359,38301,101050,0.6075210291934686,0.3790301830776843,0.013448787728847106
2000,TEXAS,HILL,3524,157,7054,10735,0.328272007452259,0.6571029343269679,0.014625058220773172
2000,TEXAS,HOCKLEY,1419,76,5250,6745,0.21037805782060787,0.7783543365455893,0.011267605633802818
2000,TEXAS,HOOD,4704,372,12429,17505,0.26872322193658954,0.7100257069408741,0.02125107112253642
2000,TEXAS,HOPKINS,3692,142,7076,10910,0.3384051329055912,0.6485792850595784,0.013015582034830431
2000,TEXAS,HOUSTON,2833,95,5308,8236,0.34397765905779504,0.644487615347256,0.011534725594949004
2000,TEXAS,HOWARD,2744,136,6668,9548,0.2873900293255132,0.6983661499790532,0.014243820695433599
2000,TEXAS,HUDSPETH,380,28,514,922,0.4121475054229935,0.5574837310195228,0.03036876355748373
2000,TEXAS,HUNT,7857,432,16177,24466,0.321139540586937,0.6612033025423036,0.01765715687075942
2000,TEXAS,HUTCHINSON,1796,112,7443,9351,0.19206501978398033,0.7959576515880654,0.01197732862795423
2000,TEXAS,IRION,162,7,624,793,0.2042875157629256,0.7868852459016393,0.008827238335435058
2000,TEXAS,JACK,822,45,2107,2974,0.27639542703429726,0.7084734364492267,0.015131136516476126
2000,TEXAS,JACKSON,1446,45,3365,4856,0.29777594728171336,0.6929571663920923,0.009266886326194398
2000,TEXAS,JASPER,4533,138,7071,11742,0.3860500766479305,0.6021972406745018,0.011752682677567705
2000,TEXAS,JEFF DAVIS,283,69,708,1060,0.2669811320754717,0.6679245283018868,0.06509433962264151
2000,TEXAS,JEFFERSON,45409,1180,40320,86909,0.5224890402605024,0.4639335396794348,0.013577420060062824
2000,TEXAS,JIM HOGG,1512,22,623,2157,0.7009735744089013,0.2888270746407047,0.010199350950394067
2000,TEXAS,JIM WELLS,7418,107,4498,12023,0.616984113781918,0.3741162771354903,0.008899609082591698
2000,TEXAS,JOHNSON,11778,746,26202,38726,0.30413675566802667,0.6765997004596395,0.01926354387233383
2000,TEXAS,JONES,1899,69,4080,6048,0.31398809523809523,0.6746031746031746,0.011408730158730158
2000,TEXAS,KARNES,1617,53,2638,4308,0.3753481894150418,0.6123491179201486,0.012302692664809656
2000,TEXAS,KAUFMAN,7455,318,15290,23063,0.3232450244981139,0.6629666565494515,0.013788318952434635
2000,TEXAS,KENDALL,1901,384,8788,11073,0.17167885848460218,0.7936421927210331,0.03467894879436467
2000,TEXAS,KENEDY,119,3,106,228,0.5219298245614035,0.4649122807017544,0.013157894736842105
2000,TEXAS,KENT,185,5,346,536,0.3451492537313433,0.6455223880597015,0.009328358208955223
2000,TEXAS,KERR,4002,589,14637,19228,0.20813397129186603,0.7612336176409403,0.030632411067193676
2000,TEXAS,KIMBLE,328,25,1313,1666,0.19687875150060025,0.7881152460984394,0.015006002400960384
2000,TEXAS,KING,14,3,120,137,0.10218978102189781,0.8759124087591241,0.021897810218978103
2000,TEXAS,KINNEY,486,26,932,1444,0.3365650969529086,0.6454293628808865,0.018005540166204988
2000,TEXAS,KLEBERG,4481,187,4526,9194,0.48738307591907765,0.4922775723297803,0.02033935175114205
2000,TEXAS,KNOX,617,12,947,1576,0.39149746192893403,0.6008883248730964,0.007614213197969543
2000,TEXAS,LA SALLE,1266,17,731,2014,0.6285998013902682,0.36295928500496527,0.008440913604766634
2000,TEXAS,LAMAR,5553,102,9775,15430,0.35988334413480233,0.6335061568373299,0.00661049902786779
2000,TEXAS,LAMB,1114,33,3451,4598,0.24227925184862983,0.7505437146585472,0.007177033492822967
2000,TEXAS,LAMPASAS,1569,119,4526,6214,0.25249436755712906,0.7283553266816866,0.019150305761184424
2000,TEXAS,LAVACA,2171,87,5288,7546,0.2877020938245428,0.7007686191359661,0.011529287039491121
2000,TEXAS,LEE,1733,104,3699,5536,0.3130419075144509,0.6681719653179191,0.01878612716763006
2000,TEXAS,LEON,1893,71,4362,6326,0.2992412266835283,0.6895352513436611,0.011223521972810622
2000,TEXAS,LIBERTY,7311,308,12458,20077,0.3641480300841759,0.6205110325247796,0.015340937391044479
2000,TEXAS,LIMESTONE,2768,95,4212,7075,0.3912367491166078,0.5953356890459364,0.01342756183745583
2000,TEXAS,LIPSCOMB,206,16,1072,1294,0.15919629057187018,0.8284389489953632,0.012364760432766615
2000,TEXAS,LIVE OAK,1114,62,2828,4004,0.27822177822177824,0.7062937062937062,0.015484515484515484
2000,TEXAS,LLANO,2143,189,6295,8627,0.24840616668598586,0.7296858699432016,0.021907963370812564
2000,TEXAS,LOVING,29,3,124,156,0.1858974358974359,0.7948717948717948,0.019230769230769232
2000,TEXAS,LUBBOCK,18469,1485,56054,76008,0.24298758025471004,0.737475002631302,0.019537417113988
2000,TEXAS,LYNN,562,15,1507,2084,0.2696737044145873,0.7231285988483686,0.007197696737044146
2000,TEXAS,MADISON,1241,49,2333,3623,0.3425338117582114,0.6439414849572178,0.013524703284570798
2000,TEXAS,MARION,1852,39,2039,3930,0.4712468193384224,0.5188295165394402,0.009923664122137405
2000,TEXAS,MARTIN,415,14,1520,1949,0.2129297075423294,0.779887121600821,0.007183170856849667
2000,TEXAS,MASON,417,32,1352,1801,0.23153803442531926,0.750694058856191,0.01776790671848973
2000,TEXAS,MATAGORDA,4696,179,7584,12459,0.376916285416165,0.6087165904165663,0.014367124167268642
2000,TEXAS,MAVERICK,5995,91,3143,9229,0.6495828367103695,0.34055694008018206,0.009860223209448477
2000,TEXAS,MCCULLOCH,794,42,2084,2920,0.2719178082191781,0.7136986301369863,0.014383561643835616
2000,TEXAS,MCLENNAN,23462,1372,43955,68789,0.341071973716728,0.6389829769294509,0.019945049353821104
2000,TEXAS,MCMULLEN,77,4,358,439,0.17539863325740318,0.8154897494305239,0.009111617312072893
2000,TEXAS,MEDINA,4025,258,8590,12873,0.3126699293094073,0.6672881224267847,0.02004194826380797
2000,TEXAS,MENARD,334,14,642,990,0.3373737373737374,0.6484848484848484,0.014141414141414142
2000,TEXAS,MIDLAND,7534,692,31514,39740,0.18958228485153497,0.7930045294413689,0.017413185707096126
2000,TEXAS,MILAM,3429,134,4706,8269,0.41468133994437056,0.569113556657395,0.01620510339823437
2000,TEXAS,MILLS,548,28,1738,2314,0.23681936041486604,0.7510803802938635,0.012100259291270527
2000,TEXAS,MITCHELL,837,29,1708,2574,0.32517482517482516,0.6635586635586636,0.011266511266511266
2000,TEXAS,MONTAGUE,2256,123,4951,7330,0.3077762619372442,0.6754433833560709,0.016780354706684857
2000,TEXAS,MONTGOMERY,23286,2327,80600,106213,0.21923869959421163,0.7588524945157372,0.021908805890051123
2000,TEXAS,MOORE,1040,49,4201,5290,0.19659735349716445,0.7941398865784499,0.009262759924385633
2000,TEXAS,MORRIS,2455,53,2381,4889,0.5021476784618532,0.4870116588259358,0.010840662712211086
2000,TEXAS,MOTLEY,118,10,514,642,0.1838006230529595,0.8006230529595015,0.01557632398753894
2000,TEXAS,NACOGDOCHES,6204,450,13145,19799,0.3133491590484368,0.6639224203242589,0.02272842062730441
2000,TEXAS,NAVARRO,5366,166,8358,13890,0.386321094312455,0.6017278617710583,0.011951043916486681
2000,TEXAS,NEWTON,2503,64,2423,4990,0.5016032064128256,0.48557114228456916,0.01282565130260521
2000,TEXAS,NOLAN,1874,101,3337,5312,0.35278614457831325,0.6282003012048193,0.01901355421686747
2000,TEXAS,NUECES,45349,2071,49906,97326,0.4659494893450876,0.512771510182274,0.021279000472638348
2000,TEXAS,OCHILTREE,251,24,2687,2962,0.08474004051316678,0.9071573261309925,0.008102633355840648
2000,TEXAS,OLDHAM,108,7,659,774,0.13953488372093023,0.851421188630491,0.00904392764857881
2000,TEXAS,ORANGE,11887,442,17325,29654,0.40085654549133337,0.5842382140689283,0.014905240439738315
2000,TEXAS,PALO PINTO,3263,165,5690,9118,0.3578635665716166,0.6240403597280105,0.01809607370037289
2000,TEXAS,PANOLA,3011,88,5975,9074,0.33182719858937626,0.6584747630592903,0.00969803835133348
2000,TEXAS,PARKER,8878,696,23651,33225,0.2672084273890143,0.7118434913468773,0.020948081264108354
2000,TEXAS,PARMER,447,23,2274,2744,0.16290087463556852,0.8287172011661808,0.008381924198250729
2000,TEXAS,PECOS,1539,64,2700,4303,0.3576574482918894,0.6274692075296305,0.01487334417848013
2000,TEXAS,POLK,6877,371,11746,18994,0.36206170369590396,0.6184058123617985,0.019532483942297566
2000,TEXAS,POTTER,7242,505,17629,25376,0.2853877679697352,0.6947115384615384,0.019900693568726355
2000,TEXAS,PRESIDIO,1064,75,618,1757,0.6055776892430279,0.35173591348890154,0.042686397268070574
2000,TEXAS,RAINS,1225,59,2049,3333,0.36753675367536753,0.6147614761476148,0.0177017701770177
2000,TEXAS,RANDALL,7209,660,33921,41790,0.172505384063173,0.8117013639626705,0.015793251974156496
2000,TEXAS,REAGAN,282,14,959,1255,0.22470119521912352,0.7641434262948207,0.011155378486055778
2000,TEXAS,REAL,316,28,1146,1490,0.21208053691275167,0.7691275167785235,0.01879194630872483
2000,TEXAS,RED RIVER,2219,42,2941,5202,0.42656670511341793,0.565359477124183,0.008073817762399077
2000,TEXAS,REEVES,1872,31,1273,3176,0.5894206549118388,0.40081863979848864,0.009760705289672544
2000,TEXAS,REFUGIO,1172,28,1721,2921,0.40123245463882234,0.5891817870592263,0.009585758301951387
2000,TEXAS,ROBERTS,72,5,472,549,0.13114754098360656,0.8597449908925319,0.009107468123861567
2000,TEXAS,ROBERTSON,3283,79,3007,6369,0.5154655361909248,0.4721306327523944,0.012403831056680798
2000,TEXAS,ROCKWALL,3642,344,13666,17652,0.2063222297756628,0.7741898934964877,0.019487876727849535
2000,TEXAS,RUNNELS,969,57,3020,4046,0.23949579831932774,0.7464162135442413,0.014087988136431043
2000,TEXAS,RUSK,4841,181,11611,16633,0.29104791679191966,0.6980701016052426,0.010881981602837732
2000,TEXAS,SABINE,1753,74,2764,4591,0.3818340230886517,0.6020474842082335,0.01611849270311479
2000,TEXAS,SAN AUGUSTINE,1636,53,2116,3805,0.4299605781865966,0.5561103810775295,0.01392904073587385
2000,TEXAS,SAN JACINTO,2946,145,4623,7714,0.38190303344568316,0.5992999740731139,0.018796992481203006
2000,TEXAS,SAN PATRICIO,7840,260,10599,18699,0.41927375795497085,0.5668217551740735,0.013904486870955666
2000,TEXAS,SAN SABA,618,24,1691,2333,0.26489498499785685,0.7248178311187312,0.010287183883411917
2000,TEXAS,SCHLEICHER,338,9,826,1173,0.28815004262574595,0.7041773231031543,0.0076726342710997444
2000,TEXAS,SCURRY,1193,73,4060,5326,0.22399549380398048,0.7622981599699586,0.013706346226060834
2000,TEXAS,SHACKELFORD,264,17,1066,1347,0.19599109131403117,0.791388270230141,0.012620638455827766
2000,TEXAS,SHELBY,3227,86,5692,9005,0.3583564686285397,0.6320932815102721,0.009550249861188229
2000,TEXAS,SHERMAN,144,21,998,1163,0.12381771281169389,0.8581255374032674,0.018056749785038694
2000,TEXAS,SMITH,16470,834,43320,60624,0.27167458432304037,0.7145684877276326,0.013756927949327
2000,TEXAS,SOMERVELL,752,46,2120,2918,0.2577107607950651,0.726525017135024,0.015764222069910898
2000,TEXAS,STARR,6505,48,1911,8464,0.7685491493383743,0.22577977315689982,0.005671077504725898
2000,TEXAS,STEPHENS,811,55,2425,3291,0.24642965663931934,0.736858097842601,0.01671224551807961
2000,TEXAS,STERLING,132,7,520,659,0.20030349013657056,0.7890743550834598,0.010622154779969651
2000,TEXAS,STONEWALL,294,9,496,799,0.36795994993742176,0.6207759699624531,0.011264080100125156
2000,TEXAS,SUTTON,468,9,1063,1540,0.3038961038961039,0.6902597402597402,0.005844155844155844
2000,TEXAS,SWISHER,856,33,1612,2501,0.34226309476209515,0.6445421831267493,0.013194722111155539
2000,TEXAS,TARRANT,173758,11710,286921,472389,0.3678282093782878,0.6073828984163475,0.024788892205364645
2000,TEXAS,TAYLOR,10504,815,31701,43020,0.24416550441655044,0.7368898186889818,0.018944676894467688
2000,TEXAS,TERRELL,219,15,243,477,0.4591194968553459,0.5094339622641509,0.031446540880503145
2000,TEXAS,TERRY,1108,36,2910,4054,0.27331031080414403,0.7178095707942772,0.008880118401578688
2000,TEXAS,THROCKMORTON,228,6,608,842,0.27078384798099764,0.7220902612826603,0.007125890736342043
2000,TEXAS,TITUS,3008,100,4995,8103,0.37122053560409723,0.6164383561643836,0.012341108231519191
2000,TEXAS,TOM GREEN,9288,605,24733,34626,0.2682377404262693,0.7142898400046208,0.01747241956910992
2000,TEXAS,TRAVIS,125526,34502,141235,301263,0.4166658368269585,0.46880964472902414,0.11452451844401736
2000,TEXAS,TRINITY,2142,62,3093,5297,0.4043798376439494,0.5839154238248065,0.0117047385312441
2000,TEXAS,TYLER,2775,105,4236,7116,0.3899662731871838,0.5952782462057336,0.01475548060708263
2000,TEXAS,UPSHUR,4180,180,8448,12808,0.3263585259212992,0.6595877576514678,0.014053716427232979
2000,TEXAS,UPTON,266,25,982,1273,0.208955223880597,0.7714061272584446,0.019638648860958365
2000,TEXAS,UVALDE,3436,129,4855,8420,0.40807600950118766,0.5766033254156769,0.015320665083135392
2000,TEXAS,VAL VERDE,5056,195,6223,11474,0.4406484225204811,0.5423566323862646,0.016994945093254315
2000,TEXAS,VAN ZANDT,5245,263,12383,17891,0.2931641607512157,0.692135710692527,0.014700128556257337
2000,TEXAS,VICTORIA,8176,445,18787,27408,0.29830706363105663,0.6854568009340338,0.016236135434909517
2000,TEXAS,WALKER,4943,355,9076,14374,0.3438847919855294,0.6314178377626269,0.024697370251843608
2000,TEXAS,WALLER,5046,126,5686,10858,0.4647264689629766,0.5236691840117885,0.01160434702523485
2000,TEXAS,WARD,1256,84,2534,3874,0.3242127000516262,0.6541042849767682,0.021683014971605574
2000,TEXAS,WASHINGTON,2996,168,8645,11809,0.25370480142264373,0.7320687611144042,0.014226437462951986
2000,TEXAS,WEBB,18120,375,13076,31571,0.5739444426847423,0.41417756802128536,0.011877989293972317
2000,TEXAS,WHARTON,4838,133,8455,13426,0.3603455980932519,0.6297482496648295,0.009906152241918665
2000,TEXAS,WHEELER,579,23,1787,2389,0.2423608204269569,0.7480117203850983,0.009627459187944746
2000,TEXAS,WICHITA,14108,803,27802,42713,0.3302975674853089,0.6509025355278253,0.018799896986865825
2000,TEXAS,WILBARGER,1356,83,3138,4577,0.2962639283373389,0.6856019226567621,0.01813414900589906
2000,TEXAS,WILLACY,3218,55,1789,5062,0.6357171078625049,0.3534176214934808,0.010865270644014224
2000,TEXAS,WILLIAMSON,26591,4303,65041,95935,0.27717725543336635,0.6779694584875176,0.04485328607911607
2000,TEXAS,WILSON,3997,192,7509,11698,0.3416823388613438,0.6419045990767652,0.016413062061890922
2000,TEXAS,WINKLER,556,19,1468,2043,0.272148800783162,0.7185511502692119,0.00930004894762604
2000,TEXAS,WISE,4830,304,11234,16368,0.29508797653958946,0.6863391984359726,0.01857282502443793
2000,TEXAS,WOOD,3893,181,9810,13884,0.2803946989340248,0.7065687121866897,0.013036588879285509
2000,TEXAS,YOAKUM,531,23,1911,2465,0.2154158215010142,0.7752535496957403,0.009330628803245436
2000,TEXAS,YOUNG,1843,89,5022,6954,0.2650273224043716,0.722174288179465,0.01279838941616336
2000,TEXAS,ZAPATA,1638,25,953,2616,0.6261467889908257,0.3642966360856269,0.0095565749235474
2000,TEXAS,ZAVALA,2616,24,751,3391,0.7714538484222944,0.22146859333529934,0.00707755824240637
2000,UTAH,BEAVER,541,58,1653,2252,0.24023090586145648,0.7340142095914742,0.02575488454706927
2000,UTAH,BOX ELDER,2555,640,12288,15483,0.16501969902473682,0.7936446425111412,0.04133565846412194
2000,UTAH,CACHE,5170,2052,25920,33142,0.15599541367449157,0.7820891919618611,0.06191539436364733
2000,UTAH,CARBON,3298,328,3758,7384,0.44664138678223186,0.5089382448537378,0.044420368364030335
2000,UTAH,DAGGETT,104,14,317,435,0.23908045977011494,0.728735632183908,0.03218390804597701
2000,UTAH,DAVIS,18845,4635,64375,87855,0.21450116669512265,0.7327414489784304,0.052757384326446985
2000,UTAH,DUCHESNE,779,145,3622,4546,0.1713594368675759,0.7967443906731192,0.031896172459304886
2000,UTAH,EMERY,958,197,3243,4398,0.2178262846748522,0.737380627557981,0.044793087767166895
2000,UTAH,GARFIELD,178,71,1719,1968,0.09044715447154472,0.8734756097560976,0.036077235772357726
2000,UTAH,GRAND,1158,634,1822,3614,0.32042058660763695,0.5041505257332596,0.1754288876591035
2000,UTAH,IRON,1789,699,10106,12594,0.1420517706844529,0.8024456090201684,0.05550262029537875
2000,UTAH,JUAB,619,143,2023,2785,0.222262118491921,0.7263913824057451,0.05134649910233393
2000,UTAH,KANE,387,161,2254,2802,0.1381156316916488,0.8044254104211278,0.05745895788722341
2000,UTAH,MILLARD,696,229,3850,4775,0.14575916230366492,0.806282722513089,0.047958115183246074
2000,UTAH,MORGAN,553,154,2464,3171,0.17439293598233996,0.7770419426048565,0.04856512141280353
2000,UTAH,PIUTE,133,22,626,781,0.1702944942381562,0.8015364916773368,0.028169014084507043
2000,UTAH,RICH,152,15,736,903,0.16832779623477298,0.8150609080841639,0.016611295681063124
2000,UTAH,SALT LAKE,107576,28097,171585,307258,0.35011618900077457,0.5584394873363753,0.09144432366285012
2000,UTAH,SAN JUAN,1838,185,2721,4744,0.3874367622259696,0.573566610455312,0.038996627318718384
2000,UTAH,SANPETE,1211,438,5781,7430,0.1629878869448183,0.7780619111709287,0.058950201884253026
2000,UTAH,SEVIER,1046,268,5763,7077,0.14780274127455137,0.8143281051292921,0.037869153596156564
2000,UTAH,SUMMIT,4601,1352,6168,12121,0.37958914280999917,0.508868905205841,0.11154195198415973
2000,UTAH,TOOELE,4001,672,7807,12480,0.32059294871794874,0.6255608974358975,0.05384615384615385
2000,UTAH,UINTAH,1387,277,6733,8397,0.1651780397761105,0.8018339883291652,0.032987971894724306
2000,UTAH,UTAH,16445,5556,98255,120256,0.1367499334752528,0.8170486295902075,0.046201436934539646
2000,UTAH,WASATCH,1476,380,3819,5675,0.26008810572687224,0.6729515418502202,0.06696035242290749
2000,UTAH,WASHINGTON,5465,1515,25481,32461,0.16835587320168818,0.7849727365145868,0.046671390283725085
2000,UTAH,WAYNE,202,70,953,1225,0.16489795918367348,0.7779591836734694,0.05714285714285714
2000,UTAH,WEBER,19890,3598,39254,62742,0.31701252749354497,0.625641516049855,0.057345956456600046
2000,VERMONT,ADDISON,8936,1538,6953,17427,0.5127675446146783,0.3989785964308257,0.0882538589544959
2000,VERMONT,BENNINGTON,9021,1372,7284,17677,0.5103241500254568,0.4120608700571364,0.0776149799174068
2000,VERMONT,CALEDONIA,5859,1036,6746,13641,0.4295139652518144,0.4945385235686533,0.07594751117953229
2000,VERMONT,CHITTENDEN,39156,6756,26105,72017,0.5437049585514532,0.36248385797797744,0.09381118347056945
2000,VERMONT,ESSEX,1129,199,1564,2892,0.390387275242047,0.5408022130013831,0.06881051175656985
2000,VERMONT,FRANKLIN,9514,1285,8395,19194,0.4956757319995832,0.4373762634156507,0.06694800458476607
2000,VERMONT,GRAND ISLE,1835,253,1550,3638,0.5043980208905993,0.42605827377680044,0.06954370533260033
2000,VERMONT,LAMOILLE,5676,1114,4456,11246,0.5047127867686289,0.3962297705850969,0.09905744264627422
2000,VERMONT,ORANGE,6694,1143,6858,14695,0.4555290915277305,0.46668935011908813,0.07778155835318136
2000,VERMONT,ORLEANS,5472,861,5799,12132,0.45103857566765576,0.47799208704253215,0.07096933728981207
2000,VERMONT,RUTLAND,13990,1826,13546,29362,0.47646618077787617,0.4613445950548328,0.06218922416729106
2000,VERMONT,WASHINGTON,15281,3020,11448,29749,0.5136643248512555,0.38481965780362365,0.10151601734512085
2000,VERMONT,WINDHAM,11319,2814,7358,21491,0.526685589316458,0.34237587827462657,0.13093853240891537
2000,VERMONT,WINDSOR,15140,2294,11713,29147,0.5194359625347377,0.40185953957525644,0.07870449789000583
2000,VIRGINIA,ACCOMACK,5092,481,6352,11925,0.4270020964360587,0.5326624737945492,0.040335429769392035
2000,VIRGINIA,ALBEMARLE,16255,2300,18291,36846,0.4411605058893774,0.4964175215762905,0.062421972534332085
2000,VIRGINIA,ALEXANDRIA,33633,2523,19043,55199,0.6093045163861665,0.3449881338430044,0.04570734977082918
2000,VIRGINIA,ALLEGHANY,2214,101,2808,5123,0.43216865118094866,0.5481163380831544,0.019715010735896935
2000,VIRGINIA,AMELIA,1754,87,2947,4788,0.3663324979114453,0.6154970760233918,0.018170426065162906
2000,VIRGINIA,AMHERST,4812,240,6660,11712,0.4108606557377049,0.5686475409836066,0.020491803278688523
2000,VIRGINIA,APPOMATTOX,2132,141,3654,5927,0.35970980259827906,0.6165007592373882,0.023789438164332714
2000,VIRGINIA,ARLINGTON,50260,4744,28555,83559,0.6014911619334842,0.34173458274991325,0.05677425531660264
2000,VIRGINIA,AUGUSTA,6643,884,17744,25271,0.2628704839539393,0.7021487080052233,0.03498080804083732
2000,VIRGINIA,BATH,822,77,1311,2210,0.3719457013574661,0.5932126696832579,0.03484162895927602
2000,VIRGINIA,BEDFORD,9238,859,18493,28590,0.32311997201818815,0.6468345575376006,0.030045470444211263
2000,VIRGINIA,BLAND,851,78,1759,2688,0.3165922619047619,0.6543898809523809,0.029017857142857144
2000,VIRGINIA,BOTETOURT,4627,346,8867,13840,0.3343208092485549,0.6406791907514451,0.025
2000,VIRGINIA,BRISTOL,2646,138,3495,6279,0.4214046822742475,0.5566172957477306,0.02197802197802198
2000,VIRGINIA,BRUNSWICK,3387,49,2561,5997,0.5647823911955978,0.42704685676171417,0.008170752042688011
2000,VIRGINIA,BUCHANAN,5745,244,3867,9856,0.5828936688311688,0.39234983766233766,0.024756493506493508
2000,VIRGINIA,BUCKINGHAM,2561,155,2738,5454,0.4695636230289696,0.502016868353502,0.02841950861752842
2000,VIRGINIA,BUENA VISTA,941,54,980,1975,0.47645569620253164,0.4962025316455696,0.027341772151898733
2000,VIRGINIA,CAMPBELL,6659,506,13162,20327,0.3275938407044817,0.6475131598366705,0.024892999458847837
2000,VIRGINIA,CAROLINE,4314,164,3873,8351,0.5165848401389055,0.46377679319841936,0.019638366662675127
2000,VIRGINIA,CARROLL,3638,221,7142,11001,0.33069720934460506,0.6492137078447414,0.020089082810653577
2000,VIRGINIA,CHARLES CITY,1981,62,1023,3066,0.6461187214611872,0.3336594911937378,0.020221787345075015
2000,VIRGINIA,CHARLOTTE,2017,122,2855,4994,0.4038846615939127,0.5716860232278734,0.024429315178213857
2000,VIRGINIA,CHARLOTTESVILLE,7762,1428,4034,13224,0.586963097398669,0.30505142165759225,0.10798548094373865
2000,VIRGINIA,CHESAPEAKE,33578,1323,39684,74585,0.4501977609438895,0.5320640879533418,0.017738151102768652
2000,VIRGINIA,CHESTERFIELD,38638,2389,69924,110951,0.3482438193436742,0.6302241530044794,0.021532027651846312
2000,VIRGINIA,CLARKE,2166,235,2883,5284,0.4099167297501892,0.5456093868281605,0.04447388342165026
2000,VIRGINIA,COLONIAL HEIGHTS,2100,163,5519,7782,0.26985350809560527,0.7092007196093549,0.020945772295039834
2000,VIRGINIA,COVINGTON,1168,80,966,2214,0.5275519421860885,0.4363143631436314,0.036133694670280034
2000,VIRGINIA,CRAIG,851,62,1580,2493,0.34135579622944245,0.6337745687926193,0.02486963497793823
2000,VIRGINIA,CULPEPER,4364,440,7440,12244,0.3564194707611891,0.6076445606011107,0.0359359686377001
2000,VIRGINIA,CUMBERLAND,1405,128,1974,3507,0.4006273167949815,0.562874251497006,0.03649843170801255
2000,VIRGINIA,DANVILLE,8221,659,9427,18307,0.4490631998689026,0.5149396405746436,0.035997159556453814
2000,VIRGINIA,DICKENSON,3951,153,3122,7226,0.5467755327982287,0.4320509272073069,0.021173539994464433
2000,VIRGINIA,DINWIDDIE,4001,176,4959,9136,0.4379378283712785,0.5427977232924693,0.01926444833625219
2000,VIRGINIA,EMPORIA,1116,26,938,2080,0.5365384615384615,0.45096153846153847,0.0125
2000,VIRGINIA,ESSEX,1750,86,1995,3831,0.45679979117723835,0.5207517619420516,0.02244844688071
2000,VIRGINIA,FAIRFAX,200862,15526,206943,423331,0.4744797805972159,0.48884442670156447,0.036675792701219616
2000,VIRGINIA,FALLS CHURCH,3109,353,2131,5593,0.5558734131950652,0.381011979259789,0.06311460754514572
2000,VIRGINIA,FAUQUIER,8296,729,14456,23481,0.35330692900643074,0.6156466930709936,0.0310463779225757
2000,VIRGINIA,FLOYD,1957,359,3423,5739,0.3410001742463844,0.5964453737584945,0.06255445199512111
2000,VIRGINIA,FLUVANNA,3431,313,4962,8706,0.394096025729382,0.5699517574086836,0.0359522168619343
2000,VIRGINIA,FRANKLIN,8908,494,12618,22020,0.4045413260672116,0.5730245231607629,0.022434150772025433
2000,VIRGINIA,FREDERICK,7158,660,14574,22392,0.3196677384780279,0.6508574490889604,0.02947481243301179
2000,VIRGINIA,FREDERICKSBURG,3360,386,2935,6681,0.5029187247418051,0.4393054931896423,0.05777578206855261
2000,VIRGINIA,GALAX,996,57,1160,2213,0.4500677812923633,0.5241753276095797,0.025756891098056935
2000,VIRGINIA,GILES,3004,242,3574,6820,0.4404692082111437,0.5240469208211144,0.035483870967741936
2000,VIRGINIA,GLOUCESTER,4553,428,8718,13699,0.33236002627929045,0.6363968172859332,0.03124315643477626
2000,VIRGINIA,GOOCHLAND,3197,202,5378,8777,0.36424746496525007,0.6127378375299077,0.0230146975048422
2000,VIRGINIA,GRAYSON,2467,149,4236,6852,0.36004086398131935,0.6182136602451839,0.021745475773496788
2000,VIRGINIA,GREENE,1774,263,3375,5412,0.32779009608277904,0.6236141906873615,0.048595713229859575
2000,VIRGINIA,GREENSVILLE,2314,27,1565,3906,0.5924219150025601,0.40066564260112647,0.0069124423963133645
2000,VIRGINIA,HALIFAX,5963,377,7732,14072,0.4237492893689596,0.5494599204093235,0.026790790221716886
2000,VIRGINIA,HAMPTON,27490,836,19561,47887,0.574059765698415,0.4084824691461148,0.017457765155470168
2000,VIRGINIA,HANOVER,12044,927,28614,41585,0.28962366237826137,0.6880846459059757,0.022291691715762896
2000,VIRGINIA,HARRISONBURG,3482,735,5741,9958,0.34966860815424783,0.5765213898373167,0.07381000200843543
2000,VIRGINIA,HENRICO,48645,2720,62887,114252,0.42576935195882787,0.5504236249693659,0.023807023071806183
2000,VIRGINIA,HENRY,8898,695,11870,21463,0.41457391790523224,0.5530447747286027,0.03238130736616503
2000,VIRGINIA,HIGHLAND,453,42,942,1437,0.31524008350730687,0.6555323590814196,0.029227557411273485
2000,VIRGINIA,HOPEWELL,3024,205,3749,6978,0.43336199484092863,0.5372599598738894,0.029378045285182
2000,VIRGINIA,ISLE OF WIGHT,5162,201,7587,12950,0.39861003861003863,0.5858687258687258,0.015521235521235521
2000,VIRGINIA,JAMES CITY,9090,774,14628,24492,0.37114159725624696,0.5972562469377756,0.031602155805977465
2000,VIRGINIA,KING AND QUEEN,1387,49,1423,2859,0.4851346624693949,0.49772647778943685,0.01713885974116824
2000,VIRGINIA,KING GEORGE,2070,192,3590,5852,0.3537252221462748,0.6134654818865345,0.032809295967190705
2000,VIRGINIA,KING WILLIAM,2125,97,3547,5769,0.3683480672560236,0.6148379268504074,0.016814005893569076
2000,VIRGINIA,LANCASTER,1937,107,3411,5455,0.3550870760769936,0.6252978918423465,0.019615032080659945
2000,VIRGINIA,LEE,4031,166,4551,8748,0.46079103795153176,0.5202331961591221,0.018975765889346137
2000,VIRGINIA,LEXINGTON,1048,135,957,2140,0.4897196261682243,0.44719626168224297,0.0630841121495327
2000,VIRGINIA,LOUDOUN,30938,2262,42453,75653,0.4089461092091523,0.5611542172815355,0.029899673509312254
2000,VIRGINIA,LOUISA,4309,326,5461,10096,0.4268026941362916,0.5409072900158478,0.03229001584786054
2000,VIRGINIA,LUNENBURG,2026,55,2510,4591,0.44129819211500765,0.5467218470921368,0.011979960792855586
2000,VIRGINIA,LYNCHBURG,10374,614,12518,23506,0.44133412745681955,0.532544882157747,0.026120990385433505
2000,VIRGINIA,MADISON,1844,243,2940,5027,0.3668191764471852,0.5848418539884623,0.0483389695643525
2000,VIRGINIA,MANASSAS,5262,396,6752,12410,0.42401289282836424,0.5440773569701853,0.03190975020145044
2000,VIRGINIA,MANASSAS PARK,1048,72,1460,2580,0.4062015503875969,0.5658914728682171,0.027906976744186046
2000,VIRGINIA,MARTINSVILLE,3048,86,2560,5694,0.5353003161222339,0.4495960660344222,0.01510361784334387
2000,VIRGINIA,MATHEWS,1499,159,2951,4609,0.3252332393143849,0.6402690388370579,0.03449772184855717
2000,VIRGINIA,MECKLENBURG,4797,257,6600,11654,0.4116183284709113,0.5663291573708598,0.022052514158228936
2000,VIRGINIA,MIDDLESEX,1671,174,2844,4689,0.3563659628918746,0.6065259117082533,0.037108125399872044
2000,VIRGINIA,MONTGOMERY,11720,1449,13991,27160,0.43151693667157587,0.5151325478645066,0.053350515463917524
2000,VIRGINIA,NELSON,2907,325,2913,6145,0.4730675345809601,0.47404393816110657,0.05288852725793328
2000,VIRGINIA,NEW KENT,2055,125,3934,6114,0.3361138370951914,0.6434412823029113,0.020444880601897284
2000,VIRGINIA,NEWPORT NEWS,29779,1040,27006,57825,0.5149848681366191,0.467029831387808,0.017985300475572848
2000,VIRGINIA,NORFOLK,38221,1805,21920,61946,0.6170051335033739,0.353856584767378,0.029138281729248056
2000,VIRGINIA,NORTHAMPTON,2340,253,2299,4892,0.4783319705641864,0.4699509403107114,0.05171708912510221
2000,VIRGINIA,NORTHUMBERLAND,2118,125,3362,5605,0.37787689562890275,0.599821587867975,0.02230151650312221
2000,VIRGINIA,NORTON,867,24,639,1530,0.5666666666666667,0.4176470588235294,0.01568627450980392
2000,VIRGINIA,NOTTOWAY,2460,162,2870,5492,0.4479242534595776,0.5225782957028405,0.029497450837581936
2000,VIRGINIA,ORANGE,4126,366,5991,10483,0.393589621291615,0.5714967089573595,0.03491366975102547
2000,VIRGINIA,PAGE,2726,181,5089,7996,0.3409204602301151,0.6364432216108054,0.02263631815907954
2000,VIRGINIA,PATRICK,2254,230,4901,7385,0.3052132701421801,0.663642518618822,0.03114421123899797
2000,VIRGINIA,PETERSBURG,8751,202,2109,11062,0.7910866027843066,0.19065268486711265,0.018260712348580725
2000,VIRGINIA,PITTSYLVANIA,7834,661,15760,24255,0.32298495155638013,0.6497629354772212,0.027252112966398682
2000,VIRGINIA,POQUOSON,1448,142,4271,5861,0.24705681624296194,0.7287152363077973,0.024227947449240745
2000,VIRGINIA,PORTSMOUTH,22286,541,12628,35455,0.6285714285714286,0.35616979269496546,0.015258778733605979
2000,VIRGINIA,POWHATAN,2708,183,6820,9711,0.27885902584697764,0.7022963649469673,0.01884460920605499
2000,VIRGINIA,PRINCE EDWARD,2922,227,3214,6363,0.4592173503064592,0.5051076536225051,0.03567499607103568
2000,VIRGINIA,PRINCE GEORGE,4182,139,6579,10900,0.3836697247706422,0.6035779816513761,0.012752293577981652
2000,VIRGINIA,PRINCE WILLIAM,44745,2978,52788,100511,0.4451751549581638,0.5251962471769259,0.02962859786491031
2000,VIRGINIA,PULASKI,5255,353,7089,12697,0.4138772938489407,0.5583208631960306,0.027801842955028747
2000,VIRGINIA,RADFORD,2063,195,2190,4448,0.46380395683453235,0.49235611510791366,0.043839928057553955
2000,VIRGINIA,RAPPAHANNOCK,1462,201,1850,3513,0.4161685169370908,0.5266154284087674,0.05721605465414176
2000,VIRGINIA,RICHMOND,43793,3033,22049,68875,0.6358330308529946,0.3201306715063521,0.04403629764065336
2000,VIRGINIA,ROANOKE,34061,1828,40370,76259,0.4466489201274604,0.5293801387377227,0.023970941134816875
2000,VIRGINIA,ROCKBRIDGE,2953,352,4522,7827,0.3772837613389549,0.5777437076785487,0.044972530982496484
2000,VIRGINIA,ROCKINGHAM,5834,678,17482,23994,0.24314411936317412,0.7285988163707594,0.028257064266066518
2000,VIRGINIA,RUSSELL,5442,285,5065,10792,0.5042624166048925,0.4693291326908821,0.02640845070422535
2000,VIRGINIA,SALEM,4348,234,6188,10770,0.40371402042711235,0.5745589600742804,0.021727019498607242
2000,VIRGINIA,SCOTT,3552,248,5535,9335,0.3805034815211569,0.5929298339582217,0.026566684520621317
2000,VIRGINIA,SHENANDOAH,4420,396,9636,14452,0.305840022142264,0.6667589261001937,0.02740105175754221
2000,VIRGINIA,SMYTH,4836,324,6580,11740,0.4119250425894378,0.5604770017035775,0.02759795570698467
2000,VIRGINIA,SOUTHAMPTON,3359,62,3293,6714,0.5002978850163837,0.4904676794757224,0.009234435507893953
2000,VIRGINIA,SPOTSYLVANIA,13455,827,20739,35021,0.38419805259701323,0.5921875446160875,0.02361440278689929
2000,VIRGINIA,STAFFORD,12596,919,20731,34246,0.3678093791975705,0.6053553699702156,0.02683525083221398
2000,VIRGINIA,STAUNTON,3324,312,4878,8514,0.390415785764623,0.572938689217759,0.036645525017618044
2000,VIRGINIA,SUFFOLK,12471,354,11836,24661,0.5056972547747456,0.47994809618425854,0.014354649040995905
2000,VIRGINIA,SURRY,1845,72,1313,3230,0.5712074303405573,0.4065015479876161,0.022291021671826627
2000,VIRGINIA,SUSSEX,2006,155,1745,3906,0.5135688684075781,0.44674859190988225,0.03968253968253968
2000,VIRGINIA,TAZEWELL,7227,462,8655,16344,0.44218061674008813,0.5295521292217328,0.02826725403817915
2000,VIRGINIA,VIRGINIA BEACH,62268,3829,83674,149771,0.41575471887080945,0.5586795841651588,0.025565696964031756
2000,VIRGINIA,WARREN,4313,518,6335,11166,0.3862618663800824,0.5673473043166756,0.04639082930324198
2000,VIRGINIA,WASHINGTON,7549,609,12064,20222,0.37330630006923154,0.5965779843734547,0.030115715557313818
2000,VIRGINIA,WAYNESBORO,2737,281,4084,7102,0.3853843987609124,0.5750492818924247,0.03956631934666291
2000,VIRGINIA,WESTMORELAND,2922,172,2932,6026,0.48489877198805176,0.4865582475937604,0.02854298041818785
2000,VIRGINIA,WILLIAMSBURG,1724,224,1777,3725,0.4628187919463087,0.4770469798657718,0.06013422818791946
2000,VIRGINIA,WINCHESTER,3318,254,4314,7886,0.4207456251585088,0.5470453969059093,0.03220897793558204
2000,VIRGINIA,WISE,6412,394,6504,13310,0.48174305033809167,0.4886551465063862,0.029601803155522164
2000,VIRGINIA,WYTHE,3462,224,6539,10225,0.33858190709046454,0.6395110024449878,0.02190709046454768
2000,VIRGINIA,YORK,8622,649,15312,24583,0.3507301793922629,0.6228694626367816,0.026400357970955537
2000,WASHINGTON,ADAMS,1406,128,3440,4974,0.28266988339364696,0.6915963007639726,0.025733815842380377
2000,WASHINGTON,ASOTIN,2736,340,4909,7985,0.34264245460237946,0.6147777082028804,0.042579837194740136
2000,WASHINGTON,BENTON,19512,1896,38367,59775,0.3264240903387704,0.6418569636135508,0.031718946047678796
2000,WASHINGTON,CHELAN,8412,1177,16980,26569,0.3166095825962588,0.639090669577327,0.04429974782641424
2000,WASHINGTON,CLALLAM,13779,2200,16251,32230,0.4275209432206019,0.5042196711138691,0.06825938566552901
2000,WASHINGTON,CLARK,61767,6544,67219,135530,0.4557441156939423,0.49597137165203276,0.04828451265402494
2000,WASHINGTON,COLUMBIA,515,68,1523,2106,0.24453941120607786,0.7231718898385565,0.032288698955365625
2000,WASHINGTON,COWLITZ,18233,1851,16873,36957,0.49335714478989096,0.4565576210190221,0.05008523419108694
2000,WASHINGTON,DOUGLAS,3822,517,8512,12851,0.2974087619640495,0.6623609057660882,0.040230332269862265
2000,WASHINGTON,FERRY,932,209,1896,3037,0.3068817912413566,0.6243002963450773,0.06881791241356602
2000,WASHINGTON,FRANKLIN,4653,365,8594,13612,0.3418307375844843,0.6313546870408463,0.02681457537466941
2000,WASHINGTON,GARFIELD,300,47,982,1329,0.22573363431151242,0.7389014296463506,0.035364936042136946
2000,WASHINGTON,GRANT,7073,892,15830,23795,0.2972473208657281,0.6652658121454087,0.03748686698886321
2000,WASHINGTON,GRAYS HARBOR,13304,1441,11225,25970,0.5122834039276087,0.4322294955718136,0.05548710050057759
2000,WASHINGTON,ISLAND,14778,1817,16408,33003,0.44777747477502045,0.4971669242190104,0.05505560100596915
2000,WASHINGTON,JEFFERSON,8281,1456,6095,15832,0.5230545730166751,0.3849797877716018,0.0919656392117231
2000,WASHINGTON,KING,476700,44207,273171,794078,0.6003188603638433,0.34401028614317486,0.0556708534929818
2000,WASHINGTON,KITSAP,50302,6128,46427,102857,0.4890479014554187,0.45137423801977505,0.059577860524806285
2000,WASHINGTON,KITTITAS,5516,843,7727,14086,0.3915944909839557,0.5485588527616073,0.05984665625443703
2000,WASHINGTON,KLICKITAT,3062,561,4557,8180,0.3743276283618582,0.5570904645476773,0.06858190709046455
2000,WASHINGTON,LEWIS,9891,1527,18565,29983,0.32988693593036056,0.6191842043824834,0.050928859687156054
2000,WASHINGTON,LINCOLN,1417,233,3546,5196,0.27270977675134717,0.6824480369515011,0.04484218629715166
2000,WASHINGTON,MASON,10876,1346,10257,22479,0.48382935183949466,0.45629253970372347,0.05987810845678188
2000,WASHINGTON,OKANOGAN,4335,1077,9384,14796,0.2929845904298459,0.6342254663422546,0.07278994322789943
2000,WASHINGTON,PACIFIC,4895,581,4042,9518,0.5142887161168312,0.4246690481193528,0.06104223576381593
2000,WASHINGTON,PEND OREILLE,1973,388,3076,5437,0.36288394335111274,0.5657531727055362,0.07136288394335111
2000,WASHINGTON,PIERCE,138249,12214,118431,268894,0.5141394006560206,0.44043749581619523,0.045423103527784184
2000,WASHINGTON,SAN JUAN,4426,993,3005,8424,0.525403608736942,0.35671889838556503,0.11787749287749288
2000,WASHINGTON,SKAGIT,20432,2625,22163,45220,0.45183547103051747,0.49011499336576736,0.05804953560371517
2000,WASHINGTON,SKAMANIA,1753,344,2151,4248,0.4126647834274953,0.5063559322033898,0.08097928436911488
2000,WASHINGTON,SNOHOMISH,129612,12078,109615,251305,0.5157557549591134,0.43618312409223853,0.048061120948648055
2000,WASHINGTON,SPOKANE,74604,8186,89299,172089,0.4335198647211617,0.5189117259092679,0.047568409369570394
2000,WASHINGTON,STEVENS,5560,1136,11299,17995,0.3089747151986663,0.6278966379549875,0.06312864684634621
2000,WASHINGTON,THURSTON,50467,7016,39924,97407,0.5181044483456014,0.40986787397209645,0.07202767768230209
2000,WASHINGTON,WAHKIAKUM,803,135,1033,1971,0.4074074074074074,0.5240994419076611,0.0684931506849315
2000,WASHINGTON,WALLA WALLA,7188,870,13304,21362,0.3364853478138751,0.6227881284523921,0.0407265237337328
2000,WASHINGTON,WHATCOM,34033,5432,34287,73752,0.46145189283002497,0.4648958672307192,0.07365223993925589
2000,WASHINGTON,WHITMAN,6509,722,9003,16234,0.40094862633978073,0.554576814093877,0.04447455956634225
2000,WASHINGTON,YAKIMA,25546,2335,39494,67375,0.37916141001855286,0.5861818181818181,0.03465677179962894
2000,WEST VIRGINIA,BARBOUR,2503,137,3411,6051,0.41365063625846965,0.563708477937531,0.02264088580399934
2000,WEST VIRGINIA,BERKELEY,8797,594,13619,23010,0.38231203824424165,0.5918730986527597,0.025814863102998697
2000,WEST VIRGINIA,BOONE,5656,132,3353,9141,0.6187506837326332,0.3668088830543704,0.01444043321299639
2000,WEST VIRGINIA,BRAXTON,2719,80,2529,5328,0.5103228228228228,0.47466216216216217,0.015015015015015015
2000,WEST VIRGINIA,BROOKE,4678,532,4195,9405,0.49739500265816056,0.4460393407761829,0.05656565656565657
2000,WEST VIRGINIA,CABELL,14896,880,16440,32216,0.46237894214055125,0.5103054382915322,0.027315619567916564
2000,WEST VIRGINIA,CALHOUN,1112,78,1425,2615,0.42523900573613765,0.5449330783938815,0.02982791586998088
2000,WEST VIRGINIA,CLAY,1617,78,1887,3582,0.45142378559463986,0.5268006700167505,0.021775544388609715
2000,WEST VIRGINIA,DODDRIDGE,773,88,1955,2816,0.2745028409090909,0.6942471590909091,0.03125
2000,WEST VIRGINIA,FAYETTE,8371,351,5897,14619,0.5726109857035365,0.40337916410151176,0.024009850194951776
2000,WEST VIRGINIA,GILMER,1092,88,1560,2740,0.39854014598540144,0.5693430656934306,0.032116788321167884
2000,WEST VIRGINIA,GRANT,891,72,3571,4534,0.1965152183502426,0.7876047640052933,0.015880017644464048
2000,WEST VIRGINIA,GREENBRIER,5627,315,6866,12808,0.43933479075577764,0.5360712054965646,0.024594003747657713
2000,WEST VIRGINIA,HAMPSHIRE,2069,149,3879,6097,0.3393472199442349,0.6362145317369198,0.024438248318845335
2000,WEST VIRGINIA,HANCOCK,6249,765,6458,13472,0.46385095011876487,0.4793646080760095,0.056784441805225655
2000,WEST VIRGINIA,HARDY,1621,77,2816,4514,0.35910500664599027,0.6238369517058041,0.017058041648205582
2000,WEST VIRGINIA,HARRISON,13009,621,12948,26578,0.4894649710286703,0.48716983971705924,0.02336518925427045
2000,WEST VIRGINIA,JACKSON,4937,240,6341,11518,0.4286334433061295,0.5505296058343463,0.020836950859524223
2000,WEST VIRGINIA,JEFFERSON,6860,473,7045,14378,0.4771178188899708,0.48998469884545837,0.03289748226457087
2000,WEST VIRGINIA,KANAWHA,38524,1337,36809,76670,0.5024651102125994,0.48009651754271554,0.017438372244685012
2000,WEST VIRGINIA,LEWIS,2355,173,3606,6134,0.3839256602543202,0.5878708835996087,0.02820345614607108
2000,WEST VIRGINIA,LINCOLN,3939,136,3389,7464,0.5277331189710611,0.4540460878885316,0.01822079314040729
2000,WEST VIRGINIA,LOGAN,8927,178,5334,14439,0.618256111919108,0.369416164554332,0.012327723526560011
2000,WEST VIRGINIA,MARION,12315,586,9972,22873,0.5384077296375639,0.435972544047567,0.02561972631486906
2000,WEST VIRGINIA,MARSHALL,6000,639,6859,13498,0.44451029782189955,0.5081493554600681,0.0473403467180323
2000,WEST VIRGINIA,MASON,4963,288,5972,11223,0.442216876058095,0.5321215361311592,0.02566158781074579
2000,WEST VIRGINIA,MCDOWELL,4845,110,2348,7303,0.6634259893194577,0.32151170751745856,0.015062303163083664
2000,WEST VIRGINIA,MERCER,8347,322,10206,18875,0.4422251655629139,0.5407152317880795,0.017059602649006623
2000,WEST VIRGINIA,MINERAL,3341,261,6180,9782,0.341545696176651,0.6317726436311593,0.026681660192189736
2000,WEST VIRGINIA,MINGO,6049,128,3866,10043,0.6023100667131335,0.38494473762819875,0.012745195658667729
2000,WEST VIRGINIA,MONONGALIA,12603,1169,13595,27367,0.4605181422881573,0.49676617824387037,0.042715679467972376
2000,WEST VIRGINIA,MONROE,2094,105,2940,5139,0.407472270869819,0.5720957384705195,0.020431990659661413
2000,WEST VIRGINIA,MORGAN,1939,194,3639,5772,0.33593208593208596,0.6304573804573804,0.03361053361053361
2000,WEST VIRGINIA,NICHOLAS,4059,161,4359,8579,0.4731320666744376,0.5081011772933909,0.01876675603217158
2000,WEST VIRGINIA,OHIO,7653,704,9607,17964,0.4260187040748163,0.53479180583389,0.039189490091293695
2000,WEST VIRGINIA,PENDLETON,1172,53,1996,3221,0.36386215461036947,0.6196833281589569,0.016454517230673704
2000,WEST VIRGINIA,PLEASANTS,1267,57,1884,3208,0.3949501246882793,0.587281795511222,0.017768079800498753
2000,WEST VIRGINIA,POCAHONTAS,1392,105,1970,3467,0.40149985578309777,0.5682145947505047,0.03028554946639746
2000,WEST VIRGINIA,PRESTON,3515,317,6607,10439,0.33671807644410384,0.6329150301753041,0.030366893380592012
2000,WEST VIRGINIA,PUTNAM,7891,362,12173,20426,0.3863213551356115,0.5959561343385881,0.017722510525800452
2000,WEST VIRGINIA,RALEIGH,11047,427,12587,24061,0.4591247246581605,0.5231287145172686,0.017746560824570882
2000,WEST VIRGINIA,RANDOLPH,4028,266,5248,9542,0.42213372458604065,0.5499895200167679,0.027876755397191366
2000,WEST VIRGINIA,RITCHIE,1024,71,2717,3812,0.26862539349422876,0.7127492130115425,0.018625393494228752
2000,WEST VIRGINIA,ROANE,2332,121,3172,5625,0.41457777777777777,0.5639111111111111,0.021511111111111113
2000,WEST VIRGINIA,SUMMERS,2299,110,2304,4713,0.4877997029492892,0.48886059834500317,0.023339698705707616
2000,WEST VIRGINIA,TAYLOR,2473,115,3124,5712,0.4329481792717087,0.5469187675070029,0.020133053221288517
2000,WEST VIRGINIA,TUCKER,1319,92,1935,3346,0.39420203227734607,0.578302450687388,0.02749551703526599
2000,WEST VIRGINIA,TYLER,1214,132,2582,3928,0.3090631364562118,0.6573319755600815,0.03360488798370672
2000,WEST VIRGINIA,UPSHUR,2770,188,5165,8123,0.34100701711190445,0.6358488243259879,0.023144158562107595
2000,WEST VIRGINIA,WAYNE,7940,308,7993,16241,0.4888861523305215,0.49214949818360937,0.018964349485869097
2000,WEST VIRGINIA,WEBSTER,1764,60,1484,3308,0.5332527206771464,0.4486094316807739,0.018137847642079808
2000,WEST VIRGINIA,WETZEL,2849,200,3239,6288,0.4530852417302799,0.5151081424936387,0.031806615776081425
2000,WEST VIRGINIA,WIRT,818,46,1518,2382,0.3434089000839631,0.6372795969773299,0.019311502938706968
2000,WEST VIRGINIA,WOOD,12664,765,20428,33857,0.37404377233659214,0.6033611956168592,0.02259503204654872
2000,WEST VIRGINIA,WYOMING,4289,116,3473,7878,0.5444275196750444,0.44084793094694086,0.014724549378014725
2000,WISCONSIN,ADAMS,4826,370,3920,9116,0.5293988591487494,0.4300131636682756,0.04058797718297499
2000,WISCONSIN,ASHLAND,4356,496,3038,7890,0.5520912547528517,0.3850443599493029,0.06286438529784537
2000,WISCONSIN,BARRON,8928,1128,9848,19904,0.44855305466237944,0.49477491961414793,0.05667202572347267
2000,WISCONSIN,BAYFIELD,4427,566,3266,8259,0.5360213100859669,0.3954473907252694,0.06853129918876377
2000,WISCONSIN,BROWN,49096,4415,54258,107769,0.45556699978658055,0.503465746179328,0.04096725403409144
2000,WISCONSIN,BUFFALO,3237,366,3038,6641,0.48742659238066555,0.4574612257190182,0.05511218190031622
2000,WISCONSIN,BURNETT,3626,558,3967,8151,0.44485339222181325,0.48668874984664456,0.06845785793154215
2000,WISCONSIN,CALUMET,8202,908,10837,19947,0.41118965257933526,0.5432897177520429,0.045520629668621845
2000,WISCONSIN,CHIPPEWA,12102,1236,12835,26173,0.46238490046994996,0.49039086081075917,0.04722423871929087
2000,WISCONSIN,CLARK,5931,757,7461,14149,0.4191815676019507,0.527316418121422,0.053502014276627326
2000,WISCONSIN,COLUMBIA,12636,964,11987,25587,0.4938445304256068,0.4684800875444562,0.037675382029937074
2000,WISCONSIN,CRAWFORD,4005,365,3024,7394,0.5416553962672437,0.408980254260211,0.04936434947254531
2000,WISCONSIN,DANE,142317,14632,75790,232739,0.6114875461353705,0.32564374685806846,0.062868707006561
2000,WISCONSIN,DODGE,14580,1437,21684,37701,0.3867271425161136,0.575157157635076,0.03811569984881038
2000,WISCONSIN,DOOR,6560,850,7810,15220,0.43101182654402104,0.5131406044678055,0.05584756898817345
2000,WISCONSIN,DOUGLAS,13593,1183,6930,21706,0.6262323781442919,0.3192665622408551,0.054501059614853034
2000,WISCONSIN,DUNN,9172,1247,8911,19330,0.474495602690119,0.4609932747025349,0.0645111226073461
2000,WISCONSIN,EAU CLAIRE,24078,2876,20921,47875,0.502934725848564,0.4369921671018277,0.06007310704960835
2000,WISCONSIN,FLORENCE,816,61,1528,2405,0.3392931392931393,0.6353430353430354,0.025363825363825365
2000,WISCONSIN,FOND DU LAC,18181,1860,26548,46589,0.3902423318809161,0.5698340810062461,0.03992358711283779
2000,WISCONSIN,FOREST,2158,154,2404,4716,0.4575911789652248,0.5097540288379983,0.03265479219677693
2000,WISCONSIN,GRANT,10691,1025,10240,21956,0.4869284022590636,0.46638732009473494,0.04668427764620149
2000,WISCONSIN,GREEN,7863,623,6790,15276,0.5147289866457188,0.4444880858863577,0.04078292746792354
2000,WISCONSIN,GREEN LAKE,3301,355,5451,9107,0.3624684308773471,0.5985505654990666,0.03898100362358625
2000,WISCONSIN,IOWA,5842,478,4221,10541,0.5542168674698795,0.40043639123422825,0.04534674129589223
2000,WISCONSIN,IRON,1620,153,1734,3507,0.4619332763045338,0.49443969204448246,0.04362703165098375
2000,WISCONSIN,JACKSON,4380,367,3670,8417,0.5203754306760129,0.4360223357490792,0.043602233574907924
2000,WISCONSIN,JEFFERSON,15203,1692,19204,36099,0.4211474002049918,0.5319814953322807,0.0468711044627275
2000,WISCONSIN,JUNEAU,4813,495,4910,10218,0.47103151301624585,0.48052456449403014,0.04844392248972402
2000,WISCONSIN,KENOSHA,32429,2389,28891,63709,0.5090175642373919,0.4534838091949332,0.03749862656767489
2000,WISCONSIN,KEWAUNEE,4670,531,4883,10084,0.46310987703292344,0.48423244744149146,0.05265767552558508
2000,WISCONSIN,LA CROSSE,28455,2777,24327,55559,0.5121582461887363,0.43785885275112946,0.04998290106013427
2000,WISCONSIN,LAFAYETTE,3710,217,3336,7263,0.5108082059754923,0.4593143329202809,0.029877461104226902
2000,WISCONSIN,LANGLADE,4199,397,5125,9721,0.4319514453245551,0.5272091348626684,0.040839419812776466
2000,WISCONSIN,LINCOLN,6664,848,6727,14239,0.4680103939883419,0.47243486199873586,0.05955474401292225
2000,WISCONSIN,MANITOWOC,17667,1799,19358,38824,0.4550535751081805,0.4986091077683907,0.046337317123428805
2000,WISCONSIN,MARATHON,26546,2945,28883,58374,0.4547572549422688,0.49479220200774315,0.05045054304998801
2000,WISCONSIN,MARINETTE,8676,710,10535,19921,0.43552030520556195,0.5288389137091511,0.035640781085286885
2000,WISCONSIN,MARQUETTE,3437,235,3522,7194,0.4777592438142897,0.48957464553794827,0.03266611064776202
2000,WISCONSIN,MENOMINEE,949,59,225,1233,0.7696674776966748,0.18248175182481752,0.047850770478507706
2000,WISCONSIN,MILWAUKEE,252329,17717,163491,433537,0.5820241409614404,0.37710968152660557,0.040866177511954
2000,WISCONSIN,MONROE,7460,658,8217,16335,0.4566880930517294,0.503030303030303,0.040281603917967555
2000,WISCONSIN,OCONTO,7260,630,8706,16596,0.4374548083875633,0.5245842371655821,0.03796095444685466
2000,WISCONSIN,ONEIDA,8339,1040,9512,18891,0.4414271346143666,0.5035201948017575,0.05505267058387592
2000,WISCONSIN,OUTAGAMIE,32735,3547,39460,75742,0.4321908584404954,0.5209791133056957,0.046830028253808983
2000,WISCONSIN,OZAUKEE,15030,1566,31155,47751,0.3147578061192436,0.6524470691713262,0.03279512470943017
2000,WISCONSIN,PEPIN,1854,179,1631,3664,0.506004366812227,0.4451419213973799,0.048853711790393016
2000,WISCONSIN,PIERCE,8559,1234,8169,17962,0.47650595702037635,0.45479345284489475,0.06870059013472887
2000,WISCONSIN,POLK,8961,1244,9557,19762,0.45344600748912056,0.4836048982896468,0.06294909422123267
2000,WISCONSIN,PORTAGE,17942,2604,13214,33760,0.531457345971564,0.3914099526066351,0.07713270142180095
2000,WISCONSIN,PRICE,3413,381,4136,7930,0.430390920554855,0.52156368221942,0.048045397225725095
2000,WISCONSIN,RACINE,41563,3288,44014,88865,0.4677094469138581,0.4952906093512632,0.03699994373487875
2000,WISCONSIN,RICHLAND,3837,462,3994,8293,0.4626793681418063,0.48161099722657663,0.055709634631617024
2000,WISCONSIN,ROCK,40472,2465,27467,70404,0.5748537014942333,0.39013408329072213,0.0350122152150446
2000,WISCONSIN,RUSK,3161,447,3758,7366,0.42913385826771655,0.5101819169155579,0.060684224816725495
2000,WISCONSIN,SAUK,13035,1032,11586,25653,0.5081277043620629,0.4516430826803883,0.040229212957548825
2000,WISCONSIN,SAWYER,3333,462,3972,7767,0.429123213595983,0.511394360757049,0.05948242564696794
2000,WISCONSIN,SHAWANO,7335,720,9548,17603,0.4166903368743964,0.5424075441686076,0.04090211895699597
2000,WISCONSIN,SHEBOYGAN,23569,1984,29648,55201,0.42696690277350047,0.5370917193529102,0.035941377873589246
2000,WISCONSIN,ST. CROIX,13077,1637,15240,29954,0.4365694064231822,0.508780129531949,0.0546504640448688
2000,WISCONSIN,TAYLOR,3254,460,5278,8992,0.36187722419928825,0.5869661921708185,0.05115658362989324
2000,WISCONSIN,TREMPEALEAU,6678,488,5002,12168,0.5488165680473372,0.41107823800131493,0.040105193951347796
2000,WISCONSIN,VERNON,6577,783,5684,13044,0.5042164980067464,0.43575590309720946,0.06002759889604416
2000,WISCONSIN,VILAS,4706,658,6958,12322,0.3819185197208245,0.5646810582697614,0.053400422009414056
2000,WISCONSIN,WALWORTH,15492,1984,22982,40458,0.38291561619457215,0.5680458747342924,0.0490385090711355
2000,WISCONSIN,WASHBURN,3695,438,3912,8045,0.4592914853946551,0.4862647607209447,0.05444375388440025
2000,WISCONSIN,WASHINGTON,18115,2135,41162,61412,0.2949749234677262,0.6702598840617469,0.03476519247052693
2000,WISCONSIN,WAUKESHA,64319,6310,133105,203734,0.31570086485319093,0.6533273778554389,0.03097175729137012
2000,WISCONSIN,WAUPACA,8787,1037,12980,22804,0.38532713559024734,0.5691983862480267,0.04547447816172601
2000,WISCONSIN,WAUSHARA,4239,438,5571,10248,0.4136416861826698,0.5436182669789227,0.04274004683840749
2000,WISCONSIN,WINNEBAGO,33983,3767,38330,76080,0.4466745531019979,0.5038117770767613,0.0495136698212408
2000,WISCONSIN,WOOD,15936,2022,17803,35761,0.4456251223399793,0.49783283465227485,0.05654204300774587
2000,WYOMING,ALBANY,5069,1268,7814,14151,0.35820790050173135,0.552187124584835,0.08960497491343368
2000,WYOMING,BIG HORN,1004,194,3720,4918,0.2041480276535177,0.7564050427002846,0.03944692964619764
2000,WYOMING,CAMPBELL,1967,370,10203,12540,0.15685805422647528,0.8136363636363636,0.029505582137161084
2000,WYOMING,CARBON,2206,264,4498,6968,0.3165901262916188,0.6455223880597015,0.03788748564867968
2000,WYOMING,CONVERSE,1076,180,3919,5175,0.20792270531400966,0.7572946859903381,0.034782608695652174
2000,WYOMING,CROOK,361,88,2289,2738,0.13184806428049672,0.8360116873630388,0.03214024835646457
2000,WYOMING,FREMONT,4172,712,10560,15444,0.2701372701372701,0.6837606837606838,0.0461020461020461
2000,WYOMING,GOSHEN,1439,159,3922,5520,0.26068840579710145,0.7105072463768116,0.028804347826086957
2000,WYOMING,HOT SPRINGS,544,75,1733,2352,0.23129251700680273,0.7368197278911565,0.03188775510204082
2000,WYOMING,JOHNSON,555,109,2886,3550,0.1563380281690141,0.8129577464788732,0.030704225352112677
2000,WYOMING,LARAMIE,12162,1364,21797,35323,0.3443082410893752,0.6170766922401835,0.03861506667044136
2000,WYOMING,LINCOLN,1184,246,5415,6845,0.17297297297297298,0.7910883856829802,0.03593864134404675
2000,WYOMING,NATRONA,8646,1303,18439,28388,0.30456530928561365,0.6495350147949838,0.04589967591940256
2000,WYOMING,NIOBRARA,190,49,888,1127,0.16858917480035493,0.7879325643300799,0.043478260869565216
2000,WYOMING,PARK,2424,528,9884,12836,0.18884387659707075,0.7700218136491118,0.04113430975381739
2000,WYOMING,PLATTE,1249,199,2925,4373,0.2856162817287903,0.6688772010061742,0.04550651726503544
2000,WYOMING,SHERIDAN,3330,482,8424,12236,0.27214776070611313,0.6884602811376267,0.03939195815626022
2000,WYOMING,SUBLETTE,458,134,2624,3216,0.1424129353233831,0.8159203980099502,0.041666666666666664
2000,WYOMING,SWEETWATER,5521,745,9425,15691,0.35185775285195336,0.6006628003314002,0.04747944681664649
2000,WYOMING,TETON,4019,958,5454,10431,0.3852938356821014,0.5228645383951682,0.09184162592273032
2000,WYOMING,UINTA,1650,299,5469,7418,0.222431922351038,0.7372607171744405,0.040307360474521436
2000,WYOMING,WASHAKIE,806,107,3138,4051,0.1989632189582819,0.7746235497408047,0.026413231300913356
2000,WYOMING,WESTON,449,90,2521,3060,0.14673202614379086,0.8238562091503268,0.029411764705882353
2004,ALABAMA,AUTAUGA,4758,127,15196,20081,0.2369403914147702,0.7567352223494845,0.006324386235745232
2004,ALABAMA,BALDWIN,15599,750,52971,69320,0.22502885170225043,0.7641517599538373,0.01081938834391229
2004,ALABAMA,BARBOUR,4832,46,5899,10777,0.4483622529460889,0.5473693977915932,0.0042683492623178994
2004,ALABAMA,BIBB,2089,39,5472,7600,0.2748684210526316,0.72,0.005131578947368421
2004,ALABAMA,BLOUNT,3938,180,17386,21504,0.18312872023809523,0.8085007440476191,0.008370535714285714
2004,ALABAMA,BULLOCK,3210,13,1494,4717,0.6805172779308882,0.31672673309306765,0.002755988976044096
2004,ALABAMA,BUTLER,3413,24,4979,8416,0.405537072243346,0.591611216730038,0.0028517110266159697
2004,ALABAMA,CALHOUN,15083,352,29814,45249,0.3333333333333333,0.6588874892262813,0.0077791774403854225
2004,ALABAMA,CHAMBERS,5347,63,7622,13032,0.41029772866789443,0.5848680171884592,0.004834254143646409
2004,ALABAMA,CHEROKEE,3040,86,5923,9049,0.33594872361586914,0.6545474638081556,0.009503812575975245
2004,ALABAMA,CHILTON,3778,86,12829,16693,0.2263224105912658,0.7685257293476307,0.005151860061103457
2004,ALABAMA,CHOCTAW,3303,27,3897,7227,0.45703611457036114,0.539227895392279,0.0037359900373599006
2004,ALABAMA,CLARKE,4627,37,6730,11394,0.40609092504827105,0.5906617517991926,0.0032473231525364226
2004,ALABAMA,CLAY,1893,59,4624,6576,0.28786496350364965,0.7031630170316302,0.008972019464720194
2004,ALABAMA,CLEBURNE,1391,37,4370,5798,0.2399103139013453,0.753708175232839,0.006381510865815798
2004,ALABAMA,COFFEE,4480,117,13019,17616,0.254314259763851,0.739044050862852,0.006641689373297003
2004,ALABAMA,COLBERT,10598,149,13188,23935,0.44278253603509504,0.5509922707332359,0.0062251932316691036
2004,ALABAMA,CONECUH,2719,31,3271,6021,0.4515861152632453,0.543265238332503,0.0051486464042517855
2004,ALABAMA,COOSA,2055,41,2905,5001,0.41091781643671266,0.5808838232353529,0.008198360327934412
2004,ALABAMA,COVINGTON,3423,85,11119,14627,0.23401927941478087,0.7601695494633213,0.00581117112189786
2004,ALABAMA,CRENSHAW,1698,25,3777,5500,0.30872727272727274,0.6867272727272727,0.004545454545454545
2004,ALABAMA,CULLMAN,8045,328,26818,35191,0.22860958767866785,0.7620698474041658,0.00932056491716632
2004,ALABAMA,DALE,4484,126,13621,18231,0.2459546925566343,0.7471340025231749,0.006911304920190884
2004,ALABAMA,DALLAS,11175,63,7335,18573,0.6016798578581812,0.39492812146664513,0.003392020675173639
2004,ALABAMA,DEKALB,7092,139,16904,24135,0.29384711000621505,0.7003936192251916,0.005759270768593329
2004,ALABAMA,ELMORE,6471,153,22056,28680,0.2256276150627615,0.7690376569037657,0.005334728033472803
2004,ALABAMA,ESCAMBIA,3814,68,8513,12395,0.30770471964501817,0.6868091972569584,0.005486083098023397
2004,ALABAMA,ETOWAH,15328,353,26999,42680,0.3591377694470478,0.6325913776944705,0.008270852858481724
2004,ALABAMA,FAYETTE,2408,60,5534,8002,0.30092476880779806,0.6915771057235691,0.007498125468632842
2004,ALABAMA,FRANKLIN,4514,65,7690,12269,0.36791914581465485,0.6267829488955905,0.005297905289754666
2004,ALABAMA,GENEVA,2113,65,8342,10520,0.2008555133079848,0.7929657794676807,0.006178707224334601
2004,ALABAMA,GREENE,3764,26,958,4748,0.7927548441449032,0.2017691659646167,0.005475989890480202
2004,ALABAMA,HALE,4631,33,3281,7945,0.5828823159219635,0.4129641283826306,0.004153555695405916
2004,ALABAMA,HENRY,2452,28,4881,7361,0.3331069148213558,0.6630892541774216,0.00380383100122266
2004,ALABAMA,HOUSTON,9144,183,26874,36201,0.25258970746664455,0.7423551835584652,0.005055108974890196
2004,ALABAMA,JACKSON,8635,152,11534,20321,0.42492987549825306,0.5675901776487378,0.007479946853009203
2004,ALABAMA,JEFFERSON,132286,2001,158680,292967,0.4515389105257589,0.5416309686756529,0.006830120798588237
2004,ALABAMA,LAMAR,1956,35,4894,6885,0.2840958605664488,0.7108206245461147,0.005083514887436456
2004,ALABAMA,LAUDERDALE,14628,318,22161,37107,0.3942113347885844,0.5972188535855768,0.00856981162583879
2004,ALABAMA,LAWRENCE,6155,116,7730,14001,0.43961145632454823,0.5521034211842011,0.008285122491250624
2004,ALABAMA,LEE,16227,411,27972,44610,0.3637525218560861,0.6270342972427707,0.009213180901143241
2004,ALABAMA,LIMESTONE,9126,245,19702,29073,0.3138994943762254,0.6776734427131703,0.008427062910604341
2004,ALABAMA,LOWNDES,4233,2,1786,6021,0.7030393622321873,0.2966284670320545,0.0003321707357581797
2004,ALABAMA,MACON,7800,37,1570,9407,0.8291697671946423,0.1668969916019985,0.003933241203359201
2004,ALABAMA,MADISON,52644,1245,77173,131062,0.4016724908821779,0.5888281881857441,0.009499320932077948
2004,ALABAMA,MARENGO,5037,30,5255,10322,0.4879868242588646,0.5091067622553769,0.002906413485758574
2004,ALABAMA,MARION,3808,84,8983,12875,0.29576699029126213,0.6977087378640777,0.006524271844660194
2004,ALABAMA,MARSHALL,8452,256,22783,31491,0.2683941443587057,0.7234765488552285,0.00812930678606586
2004,ALABAMA,MOBILE,63732,1025,92014,156771,0.40652926880609297,0.5869325321647498,0.006538199029157178
2004,ALABAMA,MONROE,3666,37,5831,9534,0.38451856513530525,0.6116005873715125,0.003880847493182295
2004,ALABAMA,MONTGOMERY,45160,393,44097,89650,0.5037367540435025,0.4918795315114334,0.004383714445064139
2004,ALABAMA,MORGAN,14131,399,32477,47007,0.3006148020507584,0.6908971004318506,0.008488097517391028
2004,ALABAMA,PERRY,3767,18,1738,5523,0.6820568531595148,0.3146840485243527,0.0032590983161325366
2004,ALABAMA,PICKENS,3915,47,5170,9132,0.42871222076215504,0.5661410424879545,0.005146736749890495
2004,ALABAMA,PIKE,4334,66,7483,11883,0.3647227131195826,0.6297231338887487,0.00555415299166877
2004,ALABAMA,RANDOLPH,2817,57,6127,9001,0.3129652260859904,0.6807021442061993,0.006332629707810243
2004,ALABAMA,RUSSELL,8375,97,8337,16809,0.49824498780415255,0.49598429412814565,0.005770718067701826
2004,ALABAMA,SHELBY,14850,621,63435,78906,0.18819861607482322,0.8039312599802296,0.007870123944947151
2004,ALABAMA,ST. CLAIR,5456,205,23500,29161,0.18709920784609582,0.8058708549089537,0.007029937244950448
2004,ALABAMA,SUMTER,4527,26,1880,6433,0.7037152184050988,0.29224312140525416,0.004041660189647132
2004,ALABAMA,TALLADEGA,11374,193,18331,29898,0.3804267844002943,0.6131179343099873,0.006455281289718376
2004,ALABAMA,TALLAPOOSA,5451,109,12392,17952,0.30364304812834225,0.6902852049910874,0.00607174688057041
2004,ALABAMA,TUSCALOOSA,26447,506,42877,69830,0.37873406845195473,0.6140197622798225,0.007246169268222827
2004,ALABAMA,WALKER,9016,184,19167,28367,0.3178341030070152,0.6756794867275355,0.00648641026544929
2004,ALABAMA,WASHINGTON,3145,42,5060,8247,0.38135079422820417,0.6135564447677944,0.005092761004001455
2004,ALABAMA,WILCOX,3838,10,1834,5682,0.6754663850756776,0.32277367124252027,0.0017599436818021823
2004,ALABAMA,WINSTON,2236,57,8130,10423,0.21452556845437973,0.780005756500048,0.005468675045572292
2004,ALASKA,DISTRICT 1,3662,452,6303,10417,0.35154075069597773,0.6050686378035903,0.04339061150043198
2004,ALASKA,DISTRICT 10,3670,335,6745,10750,0.3413953488372093,0.6274418604651163,0.031162790697674417
2004,ALASKA,DISTRICT 11,3364,381,9280,13025,0.2582725527831094,0.7124760076775432,0.029251439539347408
2004,ALASKA,DISTRICT 12,3387,350,8108,11845,0.2859434360489658,0.6845082313212326,0.029548332629801603
2004,ALASKA,DISTRICT 13,4819,491,10702,16012,0.3009617786660005,0.6683737197102173,0.030664501623782165
2004,ALASKA,DISTRICT 14,4403,428,10717,15548,0.28318754823771547,0.6892847954720864,0.027527656290198096
2004,ALASKA,DISTRICT 15,4766,576,10058,15400,0.30948051948051947,0.6531168831168831,0.0374025974025974
2004,ALASKA,DISTRICT 16,4791,462,10587,15840,0.30246212121212124,0.6683712121212121,0.029166666666666667
2004,ALASKA,DISTRICT 17,4646,373,10491,15510,0.29954867827208254,0.6764023210831721,0.024049000644745324
2004,ALASKA,DISTRICT 18,4193,270,8424,12887,0.3253666485605649,0.6536820051214403,0.02095134631799488
2004,ALASKA,DISTRICT 19,5061,383,8014,13458,0.3760588497547927,0.5954822410462178,0.028458909198989447
2004,ALASKA,DISTRICT 2,4961,498,5943,11402,0.4350991054201017,0.5212243466058586,0.043676547974039644
2004,ALASKA,DISTRICT 20,4465,383,6632,11480,0.38893728222996515,0.5777003484320558,0.03336236933797909
2004,ALASKA,DISTRICT 21,5488,365,8818,14671,0.37407129711676096,0.6010496898643582,0.024879013018880784
2004,ALASKA,DISTRICT 22,5426,402,7207,13035,0.41626390487149983,0.5528960490985807,0.03084004602991945
2004,ALASKA,DISTRICT 23,5991,418,6576,12985,0.4613785136696188,0.5064304967269927,0.03219098960338852
2004,ALASKA,DISTRICT 24,5226,403,7622,13251,0.3943853294091012,0.5752018715568636,0.030412799034035168
2004,ALASKA,DISTRICT 25,5435,451,6892,12778,0.42534042886210677,0.539364532790734,0.03529503834715918
2004,ALASKA,DISTRICT 26,6476,430,7776,14682,0.441084320937202,0.5296281160604822,0.02928756300231576
2004,ALASKA,DISTRICT 27,5212,400,8500,14112,0.3693310657596372,0.6023242630385488,0.02834467120181406
2004,ALASKA,DISTRICT 28,5141,363,9073,14577,0.3526788776840228,0.6224188790560472,0.024902243259930026
2004,ALASKA,DISTRICT 29,4546,341,7743,12630,0.3599366587490103,0.6130641330166271,0.02699920823436263
2004,ALASKA,DISTRICT 3,6513,445,4790,11748,0.5543922369765066,0.40772897514470546,0.03787878787878788
2004,ALASKA,DISTRICT 30,5181,359,8733,14273,0.36299306382680585,0.6118545505499895,0.025152385623204654
2004,ALASKA,DISTRICT 31,5315,350,9605,15270,0.348068107400131,0.629011132940406,0.022920759659463
2004,ALASKA,DISTRICT 32,6580,447,9783,16810,0.3914336704342653,0.5819750148720999,0.02659131469363474
2004,ALASKA,DISTRICT 33,3192,402,7344,10938,0.2918266593527153,0.6714207350521119,0.036752605595172794
2004,ALASKA,DISTRICT 34,3033,434,7886,11353,0.26715405619660004,0.6946181626001938,0.038227781203206204
2004,ALASKA,DISTRICT 35,5030,534,6007,11571,0.4347074583009247,0.5191426842969493,0.046149857402126
2004,ALASKA,DISTRICT 36,3245,351,5645,9241,0.3511524726761173,0.61086462504058,0.03798290228330267
2004,ALASKA,DISTRICT 37,1970,192,3046,5208,0.3782642089093702,0.5848694316436251,0.03686635944700461
2004,ALASKA,DISTRICT 38,2366,250,2459,5075,0.46620689655172415,0.4845320197044335,0.04926108374384237
2004,ALASKA,DISTRICT 39,2365,322,2881,5568,0.42474856321839083,0.5174209770114943,0.057830459770114945
2004,ALASKA,DISTRICT 4,4768,417,5802,10987,0.4339674160371348,0.5280786383908255,0.03795394557203968
2004,ALASKA,DISTRICT 40,2328,243,3217,5788,0.40221147201105734,0.5558051140290255,0.04198341395991707
2004,ALASKA,DISTRICT 5,4679,491,5439,10609,0.44104062588368365,0.512677914977849,0.04628145913846734
2004,ALASKA,DISTRICT 6,3728,405,6177,10310,0.3615906886517944,0.5991270611057226,0.039282250242483024
2004,ALASKA,DISTRICT 7,5008,520,7693,13221,0.3787913168444142,0.5818773163905907,0.03933136676499508
2004,ALASKA,DISTRICT 8,5758,569,6615,12942,0.444908051305826,0.5111265646731572,0.043965384021016844
2004,ALASKA,DISTRICT 9,4177,375,6934,11486,0.36366010795751347,0.6036914504614314,0.0326484415810552
2004,ALASKA,DISTRICT 99,0,0,0,0,,,
2004,ARIZONA,APACHE,15658,156,8384,24198,0.647078270931482,0.3464749152822547,0.006446813786263328
2004,ARIZONA,COCHISE,17514,413,26556,44483,0.39372344491153927,0.5969921093451431,0.009284445743317672
2004,ARIZONA,COCONINO,29243,498,22526,52267,0.559492605276752,0.4309793942640672,0.009528000459180746
2004,ARIZONA,GILA,8314,186,12343,20843,0.3988869164707576,0.5921892241999712,0.008923859329271219
2004,ARIZONA,GRAHAM,3185,68,7467,10720,0.2971082089552239,0.6965485074626866,0.006343283582089552
2004,ARIZONA,GREENLEE,1146,22,1899,3067,0.3736550374959244,0.6191718291490056,0.007173133355070101
2004,ARIZONA,LA PAZ,1849,48,3158,5055,0.36577645895153316,0.6247279920870425,0.009495548961424332
2004,ARIZONA,MARICOPA,504849,8447,679455,1192751,0.4232643695121614,0.5696536829564595,0.007081947531379139
2004,ARIZONA,MOHAVE,20503,510,36794,57807,0.3546802290380058,0.6364973100143582,0.008822460947636099
2004,ARIZONA,NAVAJO,14815,251,17277,32343,0.4580589308351112,0.5341805027362954,0.007760566428593513
2004,ARIZONA,PIMA,193128,2670,171109,366907,0.5263677171599342,0.46635523443270366,0.007277048407362084
2004,ARIZONA,PINAL,27252,364,37006,64622,0.4217139673795302,0.5726532759741264,0.00563275664634335
2004,ARIZONA,SANTA CRUZ,6909,91,4668,11668,0.5921323277339733,0.40006856359273224,0.007799108673294481
2004,ARIZONA,YAVAPAI,33127,794,53468,87389,0.3790751696437767,0.61183901864079,0.009085811715433292
2004,ARIZONA,YUMA,16032,249,22184,38465,0.41679448849603534,0.5767320941115299,0.006473417392434681
2004,ARKANSAS,ARKANSAS,3110,47,3789,6946,0.4477397063057875,0.5454938093866973,0.006766484307515116
2004,ARKANSAS,ASHLEY,3881,64,4567,8512,0.45594454887218044,0.5365366541353384,0.007518796992481203
2004,ARKANSAS,BAXTER,7129,273,11128,18530,0.3847274689692391,0.6005396654074474,0.014732865623313546
2004,ARKANSAS,BENTON,20756,794,46571,68121,0.304693119596013,0.6836511501592754,0.011655730244711617
2004,ARKANSAS,BOONE,4640,344,9793,14777,0.31400148880016243,0.6627190904784462,0.02327942072139135
2004,ARKANSAS,BRADLEY,2206,32,2011,4249,0.519180983760885,0.4732878324311603,0.007531183807954813
2004,ARKANSAS,CALHOUN,942,20,1341,2303,0.4090316977854972,0.5822839774207555,0.008684324793747287
2004,ARKANSAS,CARROLL,4161,136,6184,10481,0.39700410266195973,0.5900200362560825,0.012975861081957828
2004,ARKANSAS,CHICOT,2993,39,1725,4757,0.6291780533949969,0.3626235022072735,0.008198444397729661
2004,ARKANSAS,CLARK,4985,77,4127,9189,0.5424964631624769,0.4491239525519643,0.00837958428555882
2004,ARKANSAS,CLAY,3264,73,2759,6096,0.5354330708661418,0.4525918635170604,0.011975065616797901
2004,ARKANSAS,CLEBURNE,4702,132,7001,11835,0.3972961554710604,0.5915504858470638,0.011153358681875792
2004,ARKANSAS,CLEVELAND,1450,37,2009,3496,0.4147597254004577,0.5746567505720824,0.010583524027459955
2004,ARKANSAS,COLUMBIA,4108,72,5729,9909,0.41457261075789686,0.5781612675345645,0.007266121707538601
2004,ARKANSAS,CONWAY,4259,97,4293,8649,0.4924268701583998,0.4963579604578564,0.011215169383743786
2004,ARKANSAS,CRAIGHEAD,13665,318,15818,29801,0.4585416596758498,0.5307875574645146,0.010670782859635583
2004,ARKANSAS,CRAWFORD,6764,246,13391,20401,0.33155237488358413,0.6563893926768296,0.012058232439586295
2004,ARKANSAS,CRITTENDEN,8277,93,6930,15300,0.5409803921568628,0.45294117647058824,0.00607843137254902
2004,ARKANSAS,CROSS,3135,75,3864,7074,0.4431721798134012,0.546225614927905,0.010602205258693808
2004,ARKANSAS,DALLAS,1667,17,1699,3383,0.4927579071829737,0.5022169671888856,0.005025125628140704
2004,ARKANSAS,DESHA,2851,67,1729,4647,0.613514095115128,0.3720680008607704,0.01441790402410157
2004,ARKANSAS,DREW,2952,35,3262,6249,0.4723955832933269,0.5220035205632901,0.005600896143382941
2004,ARKANSAS,FAULKNER,14538,634,21514,36686,0.396281960420869,0.5864362427083901,0.01728179687074088
2004,ARKANSAS,FRANKLIN,3008,100,4181,7289,0.4126766360268898,0.5736040609137056,0.013719303059404582
2004,ARKANSAS,FULTON,2370,63,2522,4955,0.4783047426841574,0.5089808274470232,0.012714429868819375
2004,ARKANSAS,GARLAND,18040,380,21734,40154,0.44927030930915973,0.541266125417144,0.009463565273696269
2004,ARKANSAS,GRANT,2524,41,4205,6770,0.372821270310192,0.6211225997045791,0.006056129985228951
2004,ARKANSAS,GREENE,6561,154,7232,13947,0.4704237470423747,0.5185344518534452,0.011041801104180111
2004,ARKANSAS,HEMPSTEAD,3817,55,3580,7452,0.5122114868491681,0.48040794417606014,0.007380568974771873
2004,ARKANSAS,HOT SPRING,5903,203,5962,12068,0.48914484587338414,0.4940338084189592,0.016821345707656612
2004,ARKANSAS,HOWARD,2166,41,2736,4943,0.438195427877807,0.5535100141614404,0.00829455796075258
2004,ARKANSAS,INDEPENDENCE,5443,138,7430,13011,0.41833832910614094,0.5710552609330567,0.010606409960802398
2004,ARKANSAS,IZARD,2586,74,2833,5493,0.4707809939923539,0.5157473147642454,0.013471691243400691
2004,ARKANSAS,JACKSON,3515,80,2624,6219,0.5652034089081845,0.42193278662164335,0.012863804470172054
2004,ARKANSAS,JEFFERSON,19675,600,10218,30493,0.645230052799003,0.33509330010166266,0.019676647099334272
2004,ARKANSAS,JOHNSON,3622,111,4311,8044,0.45027349577324716,0.5359273993038289,0.013799104922923919
2004,ARKANSAS,LAFAYETTE,1567,20,1604,3191,0.4910686305233469,0.5026637417737386,0.006267627702914447
2004,ARKANSAS,LAWRENCE,3544,120,2951,6615,0.5357520786092215,0.44610733182161755,0.018140589569160998
2004,ARKANSAS,LEE,2548,40,1492,4080,0.6245098039215686,0.3656862745098039,0.00980392156862745
2004,ARKANSAS,LINCOLN,2149,39,1921,4109,0.5229982964224872,0.4675103431491847,0.00949136042832806
2004,ARKANSAS,LITTLE RIVER,2677,42,2575,5294,0.505666792595391,0.48639969777106157,0.007933509633547412
2004,ARKANSAS,LOGAN,3361,114,5076,8551,0.39305344404163256,0.5936147818968541,0.013331774061513273
2004,ARKANSAS,LONOKE,7454,178,14398,22030,0.3383567862006355,0.6535633227417158,0.00807989105764866
2004,ARKANSAS,MADISON,2421,90,3873,6384,0.3792293233082707,0.6066729323308271,0.014097744360902255
2004,ARKANSAS,MARION,2602,138,4127,6867,0.37891364496869084,0.600990243192078,0.020096111839231105
2004,ARKANSAS,MILLER,6139,91,8448,14678,0.418244992505791,0.5755552527592315,0.006199754734977517
2004,ARKANSAS,MISSISSIPPI,7593,439,6121,14153,0.5364940295343743,0.4324878117713559,0.031018158694269767
2004,ARKANSAS,MONROE,2049,32,1586,3667,0.5587673847832015,0.43250613580583586,0.00872647941096264
2004,ARKANSAS,MONTGOMERY,1524,67,2367,3958,0.38504295098534613,0.5980293077311774,0.016927741283476502
2004,ARKANSAS,NEVADA,1694,31,1752,3477,0.48720161058383665,0.5038826574633305,0.008915731952832903
2004,ARKANSAS,NEWTON,1506,93,2779,4378,0.3439926907263591,0.6347647327546825,0.021242576518958427
2004,ARKANSAS,OUACHITA,5188,117,5345,10650,0.48713615023474177,0.5018779342723004,0.010985915492957746
2004,ARKANSAS,PERRY,1921,75,2435,4431,0.4335364477544572,0.5495373504852178,0.016926201760324982
2004,ARKANSAS,PHILLIPS,5642,65,3161,8868,0.6362201172755977,0.3564501578709968,0.007329724853405503
2004,ARKANSAS,PIKE,1310,44,2013,3367,0.38907038907038904,0.5978615978615979,0.013068013068013067
2004,ARKANSAS,POINSETT,4069,99,3555,7723,0.5268677974880228,0.4603133497345591,0.012818852777418102
2004,ARKANSAS,POLK,2473,134,5192,7799,0.31709193486344406,0.6657263751763046,0.017181689960251316
2004,ARKANSAS,POPE,7100,188,13614,20902,0.33968041335757343,0.651325232035212,0.00899435460721462
2004,ARKANSAS,PRAIRIE,1562,32,2030,3624,0.4310154525386313,0.5601545253863135,0.008830022075055188
2004,ARKANSAS,PULASKI,82755,1386,67617,151758,0.5453089787688293,0.4455580595421658,0.009132961689004864
2004,ARKANSAS,RANDOLPH,3412,97,3158,6667,0.511774411279436,0.4736763161841908,0.01454927253637318
2004,ARKANSAS,SALINE,14153,359,24864,39376,0.35943214140593255,0.6314506298252742,0.009117228768793173
2004,ARKANSAS,SCOTT,1473,51,2514,4038,0.36478454680534916,0.6225854383358098,0.01263001485884101
2004,ARKANSAS,SEARCY,1370,57,2565,3992,0.34318637274549096,0.6425350701402806,0.014278557114228457
2004,ARKANSAS,SEBASTIAN,16479,429,27303,44211,0.3727352921218701,0.6175612404152813,0.009703467462848612
2004,ARKANSAS,SEVIER,2035,50,2516,4601,0.44229515322755925,0.5468376439904369,0.010867202782003912
2004,ARKANSAS,SHARP,3265,108,4097,7470,0.43708165997322623,0.5484605087014726,0.014457831325301205
2004,ARKANSAS,ST. FRANCIS,5684,89,3815,9588,0.5928243637880685,0.39789319983312477,0.009282436378806842
2004,ARKANSAS,STONE,2255,106,3188,5549,0.4063795278428546,0.5745179311587674,0.019102540998378086
2004,ARKANSAS,UNION,7071,259,10502,17832,0.3965343203230148,0.5889412292507851,0.01452445042620009
2004,ARKANSAS,VAN BUREN,3310,76,3988,7374,0.4488744236506645,0.5408190941144562,0.010306482234879306
2004,ARKANSAS,WASHINGTON,27597,780,35726,64103,0.4305102725301468,0.5573218102116906,0.012167917258162644
2004,ARKANSAS,WHITE,9129,295,17001,26425,0.34546830652790916,0.6433680227057711,0.011163670766319774
2004,ARKANSAS,WOODRUFF,1972,33,1021,3026,0.651685393258427,0.33740912095175146,0.010905485789821546
2004,ARKANSAS,YELL,2913,68,3678,6659,0.43745307103168646,0.5523351854632828,0.010211743505030785
2004,CALIFORNIA,ALAMEDA,422585,7246,130911,560742,0.7536175282037015,0.2334603079491103,0.01292216384718819
2004,CALIFORNIA,ALPINE,373,15,311,699,0.5336194563662375,0.4449213161659514,0.02145922746781116
2004,CALIFORNIA,AMADOR,6211,189,10479,16879,0.3679720362580722,0.6208306179276023,0.011197345814325493
2004,CALIFORNIA,BUTTE,42448,1625,51662,95735,0.44339060949496006,0.5396354520290385,0.01697393847600146
2004,CALIFORNIA,CALAVERAS,8286,419,13601,22306,0.3714695597597059,0.6097462566125706,0.018784183627723484
2004,CALIFORNIA,COLUSA,1947,77,4142,6166,0.3157638663639312,0.6717482971132014,0.012487836522867337
2004,CALIFORNIA,CONTRA COSTA,257254,4277,150608,412139,0.6241923234636858,0.36543010974452794,0.010377566791786266
2004,CALIFORNIA,DEL NORTE,3892,173,5356,9421,0.41311962636662775,0.568517142553869,0.018363231079503238
2004,CALIFORNIA,EL DORADO,32242,1158,52878,86278,0.37369897308699784,0.612879297155706,0.013421729757296183
2004,CALIFORNIA,FRESNO,103154,2018,141988,247160,0.4173571775368183,0.5744780708852565,0.00816475157792523
2004,CALIFORNIA,GLENN,2995,132,6308,9435,0.3174350821409645,0.6685744568097509,0.013990461049284579
2004,CALIFORNIA,HUMBOLDT,37988,1808,25714,65510,0.5798809342085178,0.3925202259197069,0.0275988398717753
2004,CALIFORNIA,IMPERIAL,13955,319,11628,25902,0.5387614855995676,0.44892286309937457,0.012315651301057834
2004,CALIFORNIA,INYO,3021,138,4559,7718,0.391422648354496,0.590697071780254,0.017880279865250065
2004,CALIFORNIA,KERN,68603,1838,140417,210858,0.32535165846209296,0.6659315748038964,0.008716766734010567
2004,CALIFORNIA,KINGS,10833,257,21003,32093,0.3375502446016265,0.654441778580999,0.008007976817374505
2004,CALIFORNIA,LAKE,9679,302,8185,18166,0.5328085434327865,0.4505669932841572,0.016624463283056258
2004,CALIFORNIA,LASSEN,3158,153,8126,11437,0.2761213604966337,0.7105010055084375,0.01337763399492874
2004,CALIFORNIA,LOS ANGELES,1907736,37686,1076225,3021647,0.6313563430804459,0.35617165075867563,0.012472006160878488
2004,CALIFORNIA,MADERA,13481,428,24871,38780,0.3476276431150077,0.6413357400722022,0.011036616812790098
2004,CALIFORNIA,MARIN,99070,1471,34378,134919,0.7342924273082367,0.25480473469266746,0.010902837999095754
2004,CALIFORNIA,MARIPOSA,3251,172,5215,8638,0.37636026858069,0.6037277147487844,0.019912016670525584
2004,CALIFORNIA,MENDOCINO,24385,839,12955,38179,0.6387019041881663,0.33932266429188823,0.02197543151994552
2004,CALIFORNIA,MERCED,24491,681,32773,57945,0.4226594184140133,0.5655880576408664,0.011752523945120373
2004,CALIFORNIA,MODOC,1149,72,3235,4456,0.25785457809694795,0.7259874326750448,0.01615798922800718
2004,CALIFORNIA,MONO,2628,81,2621,5330,0.4930581613508443,0.49174484052532835,0.015196998123827393
2004,CALIFORNIA,MONTEREY,75241,1465,47838,124544,0.6041318730729702,0.38410521582733814,0.011762911099691676
2004,CALIFORNIA,NAPA,33666,740,22059,56465,0.5962277517045957,0.390666784733906,0.013105463561498273
2004,CALIFORNIA,NEVADA,24220,729,28790,53739,0.45069688680474146,0.5357375462885428,0.013565566906715794
2004,CALIFORNIA,ORANGE,419239,12225,641832,1073296,0.39060892801240293,0.5980009242557505,0.011390147731846573
2004,CALIFORNIA,PLACER,55573,1403,95969,152945,0.3633528392559417,0.6274739285364019,0.009173232207656347
2004,CALIFORNIA,PLUMAS,4129,144,6905,11178,0.36938629450706745,0.6177312578278762,0.01288244766505636
2004,CALIFORNIA,RIVERSIDE,228806,5603,322473,556882,0.41086980724821415,0.5790688152965978,0.010061377455187993
2004,CALIFORNIA,SACRAMENTO,236657,4569,235539,476765,0.4963808165448387,0.4940358457521001,0.009583337703061256
2004,CALIFORNIA,SAN BENITO,9851,176,8698,18725,0.5260881174899866,0.46451268357810416,0.009399198931909212
2004,CALIFORNIA,SAN BERNARDINO,227789,5682,289306,522777,0.4357288097984418,0.5534023111192726,0.010868879082285563
2004,CALIFORNIA,SAN DIEGO,526437,11114,596033,1133584,0.46440052082598204,0.5257951770667194,0.00980430210729862
2004,CALIFORNIA,SAN FRANCISCO,296772,4802,54355,355929,0.8337955041595374,0.1527130410840364,0.01349145475642614
2004,CALIFORNIA,SAN JOAQUIN,87012,1515,100978,189505,0.4591541120287064,0.532851375953141,0.007994512018152555
2004,CALIFORNIA,SAN LUIS OBISPO,58742,1910,67995,128647,0.4566138347571261,0.5285393363234276,0.014846828919446237
2004,CALIFORNIA,SAN MATEO,197922,2840,83315,284077,0.696719551389236,0.29328315914347164,0.009997289467292319
2004,CALIFORNIA,SANTA BARBARA,90314,2005,76806,169125,0.5340073909830008,0.45413747228381374,0.011855136733185515
2004,CALIFORNIA,SANTA CLARA,386100,7420,209094,602614,0.6407086459989313,0.3469783310709675,0.012313022930101192
2004,CALIFORNIA,SANTA CRUZ,89102,2277,30354,121733,0.7319461444308446,0.24934898507389122,0.018704870495264227
2004,CALIFORNIA,SHASTA,24339,983,52249,77571,0.31376416444289745,0.6735635740160627,0.012672261541039821
2004,CALIFORNIA,SIERRA,646,50,1249,1945,0.33213367609254496,0.642159383033419,0.02570694087403599
2004,CALIFORNIA,SISKIYOU,7880,310,12673,20863,0.37770215213535924,0.6074390068542396,0.014858841010401188
2004,CALIFORNIA,SOLANO,85096,1349,62301,148746,0.5720893334946822,0.41884151506595135,0.009069151439366437
2004,CALIFORNIA,SONOMA,148261,3612,68204,220077,0.6736778491164456,0.30990971341848533,0.016412437465069044
2004,CALIFORNIA,STANISLAUS,58829,1278,85407,145514,0.40428412386437046,0.5869332160479404,0.008782660087689157
2004,CALIFORNIA,SUTTER,9602,289,20254,30145,0.3185271189251949,0.6718858848896998,0.009586996185105324
2004,CALIFORNIA,TEHAMA,7504,329,15572,23405,0.3206152531510361,0.6653279213843196,0.014056825464644308
2004,CALIFORNIA,TRINITY,2782,137,3560,6479,0.42938725111899984,0.5494675104182745,0.02114523846272573
2004,CALIFORNIA,TULARE,32494,846,65399,98739,0.3290898226637904,0.6623421343136957,0.0085680430225139
2004,CALIFORNIA,TUOLUMNE,10104,339,15745,26188,0.3858255689628838,0.6012295707957843,0.012944860241331908
2004,CALIFORNIA,VENTURA,148859,3736,160314,312909,0.4757261695892416,0.5123342569245372,0.011939573486221234
2004,CALIFORNIA,YOLO,42885,1119,28005,72009,0.5955505561804775,0.38890971961838106,0.015539724201141523
2004,CALIFORNIA,YUBA,5687,257,12076,18020,0.3155937846836848,0.6701442841287458,0.014261931187569367
2004,COLORADO,ADAMS,69122,1638,65912,136672,0.5057509950831187,0.4822641067665652,0.011984898150316085
2004,COLORADO,ALAMOSA,3017,73,3179,6269,0.48125697878449514,0.5070984208007657,0.011644600414739192
2004,COLORADO,ARAPAHOE,110262,2434,119475,232171,0.4749171946539404,0.5145991532103492,0.010483652135710318
2004,COLORADO,ARCHULETA,2141,97,3601,5839,0.36667237540674774,0.6167151909573557,0.016612433635896557
2004,COLORADO,BACA,483,23,1680,2186,0.22095150960658738,0.7685269899359561,0.010521500457456541
2004,COLORADO,BENT,785,32,1338,2155,0.3642691415313225,0.6208816705336427,0.014849187935034803
2004,COLORADO,BOULDER,105564,2107,51586,159257,0.6628531241954828,0.3239166881204594,0.013230187684057844
2004,COLORADO,BROOMFIELD,10935,293,12007,23235,0.47062621045836023,0.5167635033354853,0.012610286206154508
2004,COLORADO,CHAFFEE,3766,128,4875,8769,0.42946744212566995,0.555935682517961,0.014596875356369027
2004,COLORADO,CHEYENNE,198,13,923,1134,0.1746031746031746,0.8139329805996472,0.01146384479717813
2004,COLORADO,CLEAR CREEK,2989,102,2522,5613,0.5325138072332086,0.4493140922857652,0.018172100481026188
2004,COLORADO,CONEJOS,1894,42,1864,3800,0.49842105263157893,0.4905263157894737,0.011052631578947368
2004,COLORADO,COSTILLA,1170,23,566,1759,0.6651506537805572,0.32177373507674817,0.013075611142694713
2004,COLORADO,CROWLEY,478,9,1006,1493,0.3201607501674481,0.6738111185532485,0.006028131279303416
2004,COLORADO,CUSTER,739,32,1657,2428,0.3043657331136738,0.6824546952224053,0.013179571663920923
2004,COLORADO,DELTA,4224,213,9722,14159,0.2983261529769051,0.6866304117522424,0.015043435270852461
2004,COLORADO,DENVER,166135,2634,69903,238672,0.6960808138365623,0.2928831199302809,0.011036066233156802
2004,COLORADO,DOLORES,333,28,785,1146,0.2905759162303665,0.6849912739965096,0.02443280977312391
2004,COLORADO,DOUGLAS,39661,888,80651,121200,0.32723597359735973,0.665437293729373,0.007326732673267326
2004,COLORADO,EAGLE,9744,234,8533,18511,0.526389714223975,0.4609691534763114,0.012641132299713684
2004,COLORADO,EL PASO,77648,2777,161361,241786,0.32114349052467883,0.6673711463856468,0.01148536308967434
2004,COLORADO,ELBERT,2834,138,8389,11361,0.24944987237038993,0.7384033095678197,0.012146818061790335
2004,COLORADO,FREMONT,5933,277,12313,18523,0.3203044863143119,0.6647411326458997,0.014954381039788371
2004,COLORADO,GARFIELD,9228,296,11123,20647,0.446941444277619,0.538722332542258,0.014336223180123021
2004,COLORADO,GILPIN,1807,60,1329,3196,0.5653942428035044,0.4158322903629537,0.01877346683354193
2004,COLORADO,GRAND,3243,106,4260,7609,0.42620580891050075,0.5598633197529241,0.013930871336575109
2004,COLORADO,GUNNISON,4782,159,3479,8420,0.5679334916864608,0.4131828978622328,0.018883610451306414
2004,COLORADO,HINSDALE,236,11,355,602,0.3920265780730897,0.5897009966777409,0.018272425249169437
2004,COLORADO,HUERFANO,1663,39,1700,3402,0.48883009994121107,0.4997060552616108,0.01146384479717813
2004,COLORADO,JACKSON,210,14,710,934,0.22483940042826553,0.7601713062098501,0.014989293361884369
2004,COLORADO,JEFFERSON,126558,4091,140644,271293,0.4664993199234776,0.5184210429314431,0.015079637145079306
2004,COLORADO,KIOWA,172,8,712,892,0.19282511210762332,0.7982062780269058,0.008968609865470852
2004,COLORADO,KIT CARSON,729,52,2721,3502,0.20816676185037122,0.7769845802398629,0.014848657909765849
2004,COLORADO,LA PLATA,13409,377,11704,25490,0.5260494311494703,0.4591604550804237,0.014790113770105924
2004,COLORADO,LAKE,1623,65,1261,2949,0.5503560528992879,0.4276025771447948,0.02204136995591726
2004,COLORADO,LARIMER,68266,2285,75884,146435,0.46618636254993684,0.5182094444634138,0.015604192986649367
2004,COLORADO,LAS ANIMAS,3300,91,3196,6587,0.5009867921663883,0.4851981175041749,0.01381509032943677
2004,COLORADO,LINCOLN,503,15,1819,2337,0.21523320496362858,0.7783483097988875,0.006418485237483954
2004,COLORADO,LOGAN,2491,107,6168,8766,0.284166096281086,0.70362765229295,0.012206251425963951
2004,COLORADO,MESA,19564,782,41539,61885,0.31613476609840835,0.6712288923002343,0.012636341601357357
2004,COLORADO,MINERAL,227,9,383,619,0.3667205169628433,0.6187399030694669,0.014539579967689823
2004,COLORADO,MOFFAT,1355,123,4247,5725,0.2366812227074236,0.7418340611353712,0.02148471615720524
2004,COLORADO,MONTEZUMA,3867,160,6988,11015,0.3510667271901952,0.6344076259645938,0.014525646845211076
2004,COLORADO,MONTROSE,4776,225,11218,16219,0.2944694494111844,0.6916579320549973,0.01387261853381836
2004,COLORADO,MORGAN,3039,110,6787,9936,0.30585748792270534,0.6830716586151369,0.01107085346215781
2004,COLORADO,OTERO,3164,69,4947,8180,0.3867970660146699,0.6047677261613692,0.00843520782396088
2004,COLORADO,OURAY,1278,39,1402,2719,0.47002574475910264,0.515630746598014,0.014343508642883413
2004,COLORADO,PARK,3445,129,4781,8355,0.412327947336924,0.5722321962896469,0.015439856373429085
2004,COLORADO,PHILLIPS,582,26,1717,2325,0.2503225806451613,0.738494623655914,0.011182795698924731
2004,COLORADO,PITKIN,6335,136,2784,9255,0.684494867639114,0.3008103727714749,0.01469475958941113
2004,COLORADO,PROWERS,1308,45,3392,4745,0.2756585879873551,0.7148577449947313,0.009483667017913594
2004,COLORADO,PUEBLO,35369,696,31117,67182,0.5264654222857313,0.4631746598791343,0.010359917835134411
2004,COLORADO,RIO BLANCO,566,34,2403,3003,0.18847818847818848,0.8001998001998002,0.011322011322011322
2004,COLORADO,RIO GRANDE,2006,69,3448,5523,0.3632084012312149,0.6242983885569436,0.012493210211841391
2004,COLORADO,ROUTT,6392,170,5199,11761,0.5434911997279143,0.44205424708783264,0.01445455318425304
2004,COLORADO,SAGUACHE,1594,46,1163,2803,0.5686764181234392,0.4149125936496611,0.01641098822689975
2004,COLORADO,SAN JUAN,253,17,216,486,0.5205761316872428,0.4444444444444444,0.03497942386831276
2004,COLORADO,SAN MIGUEL,2876,64,1079,4019,0.7156008957452102,0.2684747449614332,0.015924359293356557
2004,COLORADO,SEDGWICK,374,15,971,1360,0.275,0.7139705882352941,0.011029411764705883
2004,COLORADO,SUMMIT,8144,221,5370,13735,0.5929377502730251,0.3909719694211867,0.016090280305788133
2004,COLORADO,TELLER,3556,190,8094,11840,0.30033783783783785,0.6836148648648649,0.016047297297297296
2004,COLORADO,WASHINGTON,455,25,2050,2530,0.17984189723320157,0.8102766798418972,0.009881422924901186
2004,COLORADO,WELD,31868,1193,55591,88652,0.3594729955330957,0.6270698912602084,0.013457113206695844
2004,COLORADO,YUMA,1064,39,3456,4559,0.23338451414783945,0.7580609782847115,0.008554507567449002
2004,CONNECTICUT,FAIRFIELD,205902,5460,189605,400967,0.5135135809181304,0.4728693383744797,0.013617080707389885
2004,CONNECTICUT,HARTFORD,229902,6987,154919,391808,0.5867720924534466,0.3953951935641947,0.017832713982358705
2004,CONNECTICUT,LITCHFIELD,44647,1861,50160,96668,0.46185914677038936,0.5188893946290396,0.019251458600571026
2004,CONNECTICUT,MIDDLESEX,47292,1440,35252,83984,0.5631072585254334,0.4197466184035054,0.017146123071061156
2004,CONNECTICUT,NEW HAVEN,199060,6942,160390,366392,0.5432978886001878,0.43775519116137906,0.018946920238433154
2004,CONNECTICUT,NEW LONDON,66062,2367,49931,118360,0.5581446434606286,0.4218570462994255,0.019998310239945926
2004,CONNECTICUT,STATEWIDE WRITEIN,0,0,0,0,,,
2004,CONNECTICUT,TOLLAND,39146,1338,31245,71729,0.5457485814663525,0.43559787533633537,0.018653543197312106
2004,CONNECTICUT,WINDHAM,25477,1060,22324,48861,0.521417899756452,0.45688790651030475,0.021694193733243283
2004,DELAWARE,KENT,23872,527,31578,55977,0.42646086785644105,0.5641245511549386,0.009414580988620327
2004,DELAWARE,NEW CASTLE,146171,2203,93070,241444,0.6054033233379169,0.38547240768045593,0.00912426898162721
2004,DELAWARE,SUSSEX,30098,648,47003,77749,0.38711751919638837,0.6045479684626169,0.00833451234099474
2004,DISTRICT OF COLUMBIA,DISTRICT OF COLUMBIA,202970,3360,21256,227586,0.8918386895503239,0.09339766066454,0.014763649785136168
2004,FLORIDA,ALACHUA,62504,1062,47762,111328,0.5614400689853406,0.4290205518827249,0.009539379131934464
2004,FLORIDA,BAKER,2180,37,7738,9955,0.21898543445504773,0.7772978402812657,0.0037167252636865896
2004,FLORIDA,BAY,21068,552,53404,75024,0.2808168052889742,0.7118255491576029,0.007357645553422905
2004,FLORIDA,BRADFORD,3244,54,7557,10855,0.2988484569322893,0.6961768770152004,0.004974666052510364
2004,FLORIDA,BREVARD,110309,2085,153068,265462,0.4155359335799474,0.5766098349292931,0.007854231490759506
2004,FLORIDA,BROWARD,453873,8325,244674,706872,0.6420865446643805,0.3461362170237327,0.011777238311886734
2004,FLORIDA,CALHOUN,2116,65,3782,5963,0.35485493878920005,0.6342445077980882,0.010900553412711723
2004,FLORIDA,CHARLOTTE,34256,1102,44428,79786,0.42934850725691226,0.5568395457849749,0.013811946958112952
2004,FLORIDA,CITRUS,29277,690,39500,69467,0.4214519124188464,0.5686153137460953,0.009932773835058374
2004,FLORIDA,CLAY,18971,446,62078,81495,0.23278728756365422,0.7617399840481011,0.005472728388244677
2004,FLORIDA,COLLIER,43892,1160,83631,128683,0.3410862351670384,0.649899365106502,0.009014399726459595
2004,FLORIDA,COLUMBIA,8031,202,16758,24991,0.32135568804769715,0.6705614021047577,0.008082909847545117
2004,FLORIDA,DESOTO,3913,73,5524,9510,0.4114616193480547,0.5808622502628812,0.007676130389064143
2004,FLORIDA,DIXIE,1960,48,4434,6442,0.3042533374728345,0.6882955603849736,0.007451102142191866
2004,FLORIDA,DUVAL,158610,2261,220190,381061,0.41623257168799743,0.5778339950821522,0.0059334332298503385
2004,FLORIDA,ESCAMBIA,48329,1383,93566,143278,0.3373092868409665,0.6530381496112453,0.009652563547788215
2004,FLORIDA,FLAGLER,18578,269,19633,38480,0.4827962577962578,0.5102130977130978,0.006990644490644491
2004,FLORIDA,FRANKLIN,2401,58,3472,5931,0.40482212105884335,0.5853987523183274,0.009779126622829202
2004,FLORIDA,GADSDEN,14629,102,6253,20984,0.6971502096835684,0.2979889439573008,0.004860846359130766
2004,FLORIDA,GILCHRIST,2017,62,4936,7015,0.28752672843905913,0.7036350677120456,0.008838203848895224
2004,FLORIDA,GLADES,1718,27,2443,4188,0.4102196752626552,0.5833333333333334,0.0064469914040114614
2004,FLORIDA,GULF,2407,65,4805,7277,0.3307681736979525,0.6602995740002748,0.00893225230177271
2004,FLORIDA,HAMILTON,2260,27,2792,5079,0.4449694821815318,0.5497145107304587,0.005316007088009451
2004,FLORIDA,HARDEE,2149,51,5049,7249,0.2964546834046075,0.6965098634294385,0.007035453165953925
2004,FLORIDA,HENDRY,3960,58,5757,9775,0.4051150895140665,0.5889514066496163,0.005933503836317136
2004,FLORIDA,HERNANDO,37187,725,42635,80547,0.46168075781841655,0.5293182862179845,0.009000955963598893
2004,FLORIDA,HIGHLANDS,15347,271,25878,41496,0.3698428764218238,0.6236263736263736,0.0065307499518025836
2004,FLORIDA,HILLSBOROUGH,214132,3514,245576,463222,0.46226647266321547,0.5301475318529776,0.007585995483806901
2004,FLORIDA,HOLMES,1810,78,6412,8300,0.21807228915662652,0.7725301204819277,0.009397590361445784
2004,FLORIDA,INDIAN RIVER,23956,520,36938,61414,0.3900739245123262,0.601458950727847,0.00846712475982675
2004,FLORIDA,JACKSON,7555,130,12122,19807,0.3814308072903519,0.6120058565153733,0.006563336194274751
2004,FLORIDA,JEFFERSON,4135,45,3298,7478,0.5529553356512437,0.44102701257020593,0.006017651778550415
2004,FLORIDA,LAFAYETTE,845,20,2460,3325,0.25413533834586466,0.7398496240601504,0.006015037593984963
2004,FLORIDA,LAKE,48221,1340,74389,123950,0.389035901573215,0.6001532876159742,0.010810810810810811
2004,FLORIDA,LEE,93860,2631,144176,240667,0.38999945983454315,0.5990684223429054,0.010932117822551492
2004,FLORIDA,LEON,83873,891,51615,136379,0.6149993767368876,0.3784673593441806,0.0065332639189318005
2004,FLORIDA,LEVY,6074,168,10410,16652,0.3647609896709104,0.6251501321162624,0.010088878212827288
2004,FLORIDA,LIBERTY,1070,24,1927,3021,0.35418735518040384,0.6378682555445216,0.007944389275074478
2004,FLORIDA,MADISON,4050,63,4191,8304,0.4877167630057804,0.5046965317919075,0.007586705202312138
2004,FLORIDA,MANATEE,61262,1041,81318,143621,0.42655321993301815,0.5661985364257316,0.007248243641250235
2004,FLORIDA,MARION,57271,1123,81283,139677,0.4100245566557128,0.5819354653951617,0.008039977949125482
2004,FLORIDA,MARTIN,30208,883,41362,72453,0.41693235614812363,0.5708804328323189,0.012187211019557507
2004,FLORIDA,MIAMI-DADE,409732,3899,361095,774726,0.528873433962459,0.4660938189759993,0.005032747061541758
2004,FLORIDA,MONROE,19654,414,19467,39535,0.4971291260908056,0.4923991400025294,0.01047173390666498
2004,FLORIDA,NASSAU,8573,387,23783,32743,0.26182695537977585,0.72635372446019,0.011819320160034206
2004,FLORIDA,OKALOOSA,19368,695,69693,89756,0.21578501715762735,0.7764717679040956,0.007743214938277107
2004,FLORIDA,OKEECHOBEE,5153,59,6978,12190,0.42272354388843314,0.5724364232977851,0.004840032813781789
2004,FLORIDA,ORANGE,193354,2151,192539,388044,0.4982785457319273,0.4961782684437847,0.005543185824287968
2004,FLORIDA,OSCEOLA,38633,454,43117,82204,0.46996496520850567,0.5245121891878741,0.005522845603620262
2004,FLORIDA,PALM BEACH,328687,3247,212688,544622,0.6035139968638799,0.39052406990536553,0.005961933230754541
2004,FLORIDA,PASCO,84749,2937,103230,190916,0.44390726811791575,0.5407090029122755,0.015383728969808712
2004,FLORIDA,PINELLAS,225460,4211,225686,455357,0.49512799847152894,0.49562431235272547,0.009247689175745625
2004,FLORIDA,POLK,86009,1262,123559,210830,0.4079542759569321,0.5860598586538918,0.005985865389176113
2004,FLORIDA,PUTNAM,12412,250,18311,30973,0.4007361250121073,0.5911923288025054,0.008071546185387272
2004,FLORIDA,SANTA ROSA,14659,589,52059,67307,0.21779309730042937,0.7734559555469713,0.008750947152599284
2004,FLORIDA,SARASOTA,88442,2518,104692,195652,0.45203729069981397,0.5350929200825957,0.012869789217590416
2004,FLORIDA,SEMINOLE,76971,1052,108172,186195,0.41338918875372593,0.5809608206450227,0.0056499906012513765
2004,FLORIDA,ST. JOHNS,26399,695,59196,86290,0.30593348012515936,0.6860122841580716,0.008054235716769035
2004,FLORIDA,ST. LUCIE,51835,636,47592,100063,0.5180236451035848,0.47562035917372053,0.006355995722694702
2004,FLORIDA,SUMTER,11584,458,19800,31842,0.3637962439545255,0.6218202374222724,0.01438351862320206
2004,FLORIDA,SUWANNEE,4522,127,11153,15802,0.2861663080622706,0.7057967345905581,0.008036957347171244
2004,FLORIDA,TAYLOR,3049,65,5467,8581,0.35531989278638854,0.6371052324903858,0.007574874723225732
2004,FLORIDA,UNION,1251,28,3396,4675,0.2675935828877005,0.7264171122994653,0.005989304812834224
2004,FLORIDA,VOLUSIA,115519,1496,111924,228939,0.5045841905485741,0.48888131773092397,0.006534491720501968
2004,FLORIDA,WAKULLA,4896,90,6777,11763,0.4162203519510329,0.5761285386381025,0.0076511094108645756
2004,FLORIDA,WALTON,6213,208,17555,23976,0.2591341341341341,0.7321905238571905,0.008675342008675343
2004,FLORIDA,WASHINGTON,2912,85,7369,10366,0.280918387034536,0.7108817287285356,0.00819988423692842
2004,GEORGIA,APPLING,1848,27,4494,6369,0.29015544041450775,0.7056052755534621,0.004239284032030146
2004,GEORGIA,ATKINSON,799,5,1666,2470,0.32348178137651823,0.674493927125506,0.0020242914979757085
2004,GEORGIA,BACON,930,7,2853,3790,0.24538258575197888,0.7527704485488127,0.0018469656992084432
2004,GEORGIA,BAKER,936,7,821,1764,0.5306122448979592,0.46541950113378683,0.003968253968253968
2004,GEORGIA,BALDWIN,6775,63,7709,14547,0.4657317659998625,0.5299374441465594,0.004330789853578057
2004,GEORGIA,BANKS,1149,31,4410,5590,0.20554561717352415,0.7889087656529516,0.00554561717352415
2004,GEORGIA,BARROW,4095,112,13520,17727,0.23100355390082924,0.7626784001805156,0.0063180459186551585
2004,GEORGIA,BARTOW,7741,180,22311,30232,0.2560531886742525,0.7379928552527124,0.005953956073035195
2004,GEORGIA,BEN HILL,2180,25,3331,5536,0.39378612716763006,0.6016979768786127,0.004515895953757226
2004,GEORGIA,BERRIEN,1638,37,3917,5592,0.2929184549356223,0.7004649499284692,0.006616595135908441
2004,GEORGIA,BIBB,29322,258,28107,57687,0.5082947631182069,0.4872328254199386,0.00447241146185449
2004,GEORGIA,BLECKLEY,1281,19,3167,4467,0.2867696440564137,0.7089769420192523,0.004253413924334005
2004,GEORGIA,BRANTLEY,1258,27,4333,5618,0.22392310430758278,0.7712709149163404,0.004805980776076896
2004,GEORGIA,BROOKS,2193,8,2912,5113,0.4289067083903775,0.5695286524545277,0.0015646391550948563
2004,GEORGIA,BRYAN,2590,30,7363,9983,0.2594410497846339,0.737553841530602,0.003005108684764099
2004,GEORGIA,BULLOCH,6840,79,12252,19171,0.35678889990089196,0.6390902926294925,0.004120807469615565
2004,GEORGIA,BURKE,4213,34,4232,8479,0.4968746314423871,0.49911546172897747,0.0040099068286354525
2004,GEORGIA,BUTTS,2572,43,5119,7734,0.3325575381432635,0.6618825963279028,0.005559865528833721
2004,GEORGIA,CALHOUN,1119,10,890,2019,0.5542347696879644,0.4408122833085686,0.004952947003467063
2004,GEORGIA,CAMDEN,4637,50,9488,14175,0.3271252204585538,0.6693474426807761,0.003527336860670194
2004,GEORGIA,CANDLER,1096,7,2048,3151,0.34782608695652173,0.6499523960647413,0.002221516978736909
2004,GEORGIA,CARROLL,10224,217,24837,35278,0.289812347638755,0.7040365100062361,0.006151142355008787
2004,GEORGIA,CATOOSA,5807,91,16406,22304,0.2603568866571019,0.7355631276901005,0.004079985652797704
2004,GEORGIA,CHARLTON,1064,12,2311,3387,0.31414230882787125,0.6823147328018896,0.00354295837023915
2004,GEORGIA,CHATHAM,45630,401,45484,91515,0.49860678577282413,0.49701141889307765,0.004381795334098235
2004,GEORGIA,CHATTAHOOCHEE,773,10,905,1688,0.45793838862559244,0.5361374407582938,0.005924170616113744
2004,GEORGIA,CHATTOOGA,2809,46,4992,7847,0.3579711991844017,0.6361666879062062,0.005862112909392124
2004,GEORGIA,CHEROKEE,14824,525,58238,73587,0.2014486254365581,0.7914169622351774,0.007134412328264503
2004,GEORGIA,CLARKE,21718,465,15052,37235,0.5832684302403652,0.40424331945749964,0.012488250302135087
2004,GEORGIA,CLAY,798,2,509,1309,0.6096256684491979,0.38884644766997706,0.0015278838808250573
2004,GEORGIA,CLAYTON,56113,327,23106,79546,0.7054157342921077,0.29047343675357656,0.004110828954315741
2004,GEORGIA,CLINCH,750,14,1501,2265,0.33112582781456956,0.6626931567328919,0.006181015452538631
2004,GEORGIA,COBB,103955,2051,173467,279473,0.3719679539705088,0.6206932333355994,0.007338812693891718
2004,GEORGIA,COFFEE,3979,42,8306,12327,0.3227873773018577,0.6738054676725886,0.0034071550255536627
2004,GEORGIA,COLQUITT,3378,56,8296,11730,0.2879795396419437,0.7072463768115942,0.004774083546462063
2004,GEORGIA,COLUMBIA,11442,153,35549,47144,0.2427032071949771,0.754051416935347,0.003245375869675887
2004,GEORGIA,COOK,1733,18,3065,4816,0.3598421926910299,0.6364202657807309,0.003737541528239203
2004,GEORGIA,COWETA,10647,216,31682,42545,0.2502526736396756,0.7446703490421906,0.005076977318133741
2004,GEORGIA,CRAWFORD,1552,20,2830,4402,0.35256701499318494,0.6428895956383462,0.004543389368468878
2004,GEORGIA,CRISP,2357,28,3865,6250,0.37712,0.6184,0.00448
2004,GEORGIA,DADE,1823,39,4368,6230,0.2926163723916533,0.701123595505618,0.006260032102728732
2004,GEORGIA,DAWSON,1407,57,6649,8113,0.1734253666954271,0.8195488721804511,0.00702576112412178
2004,GEORGIA,DECATUR,3577,26,5348,8951,0.3996201541727181,0.5974751424421852,0.002904703385096637
2004,GEORGIA,DEKALB,200787,1782,73570,276139,0.7271229344641648,0.266423793813985,0.006453271721850228
2004,GEORGIA,DODGE,2384,27,4584,6995,0.34081486776268766,0.655325232308792,0.0038598999285203717
2004,GEORGIA,DOOLY,1973,18,1853,3844,0.513267429760666,0.4820499479708637,0.004682622268470343
2004,GEORGIA,DOUGHERTY,19805,131,13711,33647,0.5886111689006449,0.40749546764941896,0.0038933634499361013
2004,GEORGIA,DOUGLAS,15997,222,25846,42065,0.38029240461191016,0.614430048734102,0.005277546653987876
2004,GEORGIA,EARLY,1701,17,2495,4213,0.40375029670068835,0.5922145739378115,0.004035129361500119
2004,GEORGIA,ECHOLS,231,3,757,991,0.2330978809283552,0.763874873864783,0.0030272452068617556
2004,GEORGIA,EFFINGHAM,3613,51,12503,16167,0.2234799282489021,0.7733654976186058,0.0031545741324921135
2004,GEORGIA,ELBERT,2984,46,4626,7656,0.3897596656217346,0.60423197492163,0.0060083594566353185
2004,GEORGIA,EMANUEL,2774,28,4666,7468,0.37145152651312263,0.6247991430101768,0.003749330476700589
2004,GEORGIA,EVANS,1213,10,2291,3514,0.3451906659077974,0.6519635742743313,0.0028457598178713715
2004,GEORGIA,FANNIN,2727,61,6862,9650,0.2825906735751295,0.7110880829015545,0.006321243523316062
2004,GEORGIA,FAYETTE,14887,295,37346,52528,0.2834107523606457,0.7109731952482485,0.005616052391105696
2004,GEORGIA,FLOYD,10038,187,21400,31625,0.31740711462450594,0.6766798418972332,0.00591304347826087
2004,GEORGIA,FORSYTH,9201,358,47267,56826,0.16191532045190582,0.8317847464188928,0.006299933129201422
2004,GEORGIA,FRANKLIN,2245,39,5218,7502,0.2992535323913623,0.6955478539056251,0.00519861370301253
2004,GEORGIA,FULTON,199436,2216,134372,336024,0.5935171297288289,0.3998881032307216,0.0065947670404494915
2004,GEORGIA,GILMER,2510,74,7414,9998,0.2510502100420084,0.7415483096619324,0.007401480296059212
2004,GEORGIA,GLASCOCK,250,3,1016,1269,0.19700551615445233,0.8006304176516943,0.002364066193853428
2004,GEORGIA,GLYNN,8962,122,18608,27692,0.3236313736819298,0.6719630218113535,0.004405604506716741
2004,GEORGIA,GORDON,4028,76,11671,15775,0.2553407290015848,0.7398415213946117,0.004817749603803487
2004,GEORGIA,GRADY,3092,31,5068,8191,0.3774874862654133,0.6187278720546942,0.003784641679892565
2004,GEORGIA,GREENE,2774,29,4069,6872,0.40366705471478465,0.5921129220023282,0.004220023282887078
2004,GEORGIA,GWINNETT,81708,1764,160445,243917,0.33498280152674886,0.6577852302217557,0.007231968251495385
2004,GEORGIA,HABERSHAM,2750,61,10434,13245,0.20762551906379767,0.7877689694224236,0.004605511513778785
2004,GEORGIA,HALL,10514,299,38883,49696,0.21156632324533162,0.7824170959433355,0.006016580811332904
2004,GEORGIA,HANCOCK,2715,13,822,3550,0.7647887323943662,0.2315492957746479,0.0036619718309859155
2004,GEORGIA,HARALSON,2434,56,7703,10193,0.23879132738153636,0.7557147061709016,0.005493966447562052
2004,GEORGIA,HARRIS,3400,53,8878,12331,0.27572784040223824,0.7199740491444327,0.004298110453329008
2004,GEORGIA,HART,3479,42,5500,9021,0.38565569227358387,0.6096885046003769,0.004655803126039242
2004,GEORGIA,HEARD,1148,19,2788,3955,0.2902654867256637,0.7049304677623262,0.004804045512010114
2004,GEORGIA,HENRY,21096,298,42759,64153,0.3288388695774165,0.6665159852228267,0.0046451451997568316
2004,GEORGIA,HOUSTON,15054,237,29862,45153,0.3333997741013886,0.6613514052222443,0.005248820676367019
2004,GEORGIA,IRWIN,1051,16,2347,3414,0.30785002929115407,0.6874633860574106,0.0046865846514352666
2004,GEORGIA,JACKSON,3468,91,12611,16170,0.21447124304267162,0.7799010513296227,0.005627705627705628
2004,GEORGIA,JASPER,1558,25,3157,4740,0.32869198312236286,0.6660337552742616,0.005274261603375527
2004,GEORGIA,JEFF DAVIS,1277,18,3549,4844,0.26362510322047894,0.7326589595375722,0.0037159372419488025
2004,GEORGIA,JEFFERSON,3447,22,3066,6535,0.5274674827850038,0.4691660290742158,0.0033664881407804133
2004,GEORGIA,JENKINS,1494,11,1898,3403,0.43902439024390244,0.5577431677931237,0.0032324419629738465
2004,GEORGIA,JOHNSON,1263,11,2279,3553,0.355474247115114,0.6414297776526878,0.0030959752321981426
2004,GEORGIA,JONES,3855,51,6939,10845,0.355463347164592,0.6398340248962655,0.004702627939142462
2004,GEORGIA,LAMAR,2432,35,4027,6494,0.3744995380351093,0.6201108715737604,0.0053895903911302745
2004,GEORGIA,LANIER,931,12,1641,2584,0.3602941176470588,0.635061919504644,0.0046439628482972135
2004,GEORGIA,LAURENS,6281,73,10883,17237,0.36439055520102104,0.6313743690897488,0.004235075709230145
2004,GEORGIA,LEE,2182,30,8201,10413,0.20954576010755785,0.787573225775473,0.002881014116969173
2004,GEORGIA,LIBERTY,6619,50,6131,12800,0.517109375,0.478984375,0.00390625
2004,GEORGIA,LINCOLN,1337,11,2309,3657,0.36560021875854526,0.6313918512441892,0.0030079299972655183
2004,GEORGIA,LONG,1033,9,1994,3036,0.34025032938076416,0.6567852437417655,0.0029644268774703555
2004,GEORGIA,LOWNDES,12516,125,18981,31622,0.39580039213206,0.600246663715135,0.003952944152805009
2004,GEORGIA,LUMPKIN,2091,74,6690,8855,0.23613777526821006,0.7555053642010163,0.008356860530773575
2004,GEORGIA,MACON,2906,20,1851,4777,0.6083315888633033,0.38748168306468495,0.004186728072011723
2004,GEORGIA,MADISON,2527,52,7254,9833,0.25699176243262484,0.7377199227092444,0.005288314858130784
2004,GEORGIA,MARION,1275,7,1670,2952,0.43191056910569103,0.5657181571815718,0.0023712737127371273
2004,GEORGIA,MCDUFFIE,2899,28,4846,7773,0.3729576739997427,0.6234401132124019,0.003602212787855397
2004,GEORGIA,MCINTOSH,2523,18,2837,5378,0.469133506879881,0.5275195239866122,0.00334696913350688
2004,GEORGIA,MERIWETHER,3709,36,4402,8147,0.4552596047624893,0.5403215907696084,0.004418804467902295
2004,GEORGIA,MILLER,736,11,1694,2441,0.30151577222449816,0.6939778779188857,0.004506349856616141
2004,GEORGIA,MITCHELL,3360,22,3885,7267,0.4623641117379937,0.5346085041970552,0.003027384064951149
2004,GEORGIA,MONROE,3216,45,6522,9783,0.3287335173259736,0.6666666666666666,0.004599816007359705
2004,GEORGIA,MONTGOMERY,1007,11,2150,3168,0.3178661616161616,0.6786616161616161,0.003472222222222222
2004,GEORGIA,MORGAN,2304,36,4902,7242,0.31814415907207955,0.6768848384424192,0.004971002485501243
2004,GEORGIA,MURRAY,2899,45,7745,10689,0.27121339695013563,0.7245766676022078,0.004209935447656469
2004,GEORGIA,MUSCOGEE,32867,231,30850,63948,0.5139644711327954,0.4824232188653281,0.0036123100018765246
2004,GEORGIA,NEWTON,10939,132,18095,29166,0.3750600013714599,0.6204141808955633,0.004525817732976754
2004,GEORGIA,OCONEE,3789,105,10276,14170,0.2673959068454481,0.7251940719830628,0.007410021171489062
2004,GEORGIA,OGLETHORPE,1899,41,3688,5628,0.3374200426439232,0.6552949538024165,0.00728500355366027
2004,GEORGIA,PAULDING,9420,204,30843,40467,0.23278226703239677,0.7621765883312328,0.005041144636370376
2004,GEORGIA,PEACH,3961,30,4554,8545,0.46354593329432414,0.5329432416617905,0.003510825043885313
2004,GEORGIA,PICKENS,2444,68,8115,10627,0.2299802390138327,0.7636209654653242,0.006398795520843136
2004,GEORGIA,PIERCE,1234,9,4680,5923,0.208340368056728,0.790140131690022,0.0015195002532500423
2004,GEORGIA,PIKE,1506,42,5193,6741,0.22340898976412996,0.7703604806408545,0.006230529595015576
2004,GEORGIA,POLK,3868,60,8467,12395,0.3120613150463897,0.6830980233965308,0.004840661557079467
2004,GEORGIA,PULASKI,1294,15,2202,3511,0.36855596696097975,0.6271717459413273,0.004272287097692965
2004,GEORGIA,PUTNAM,2880,39,5188,8107,0.35524855063525346,0.6399407919082275,0.004810657456519057
2004,GEORGIA,QUITMAN,543,13,409,965,0.5626943005181347,0.42383419689119173,0.013471502590673576
2004,GEORGIA,RABUN,1918,57,4650,6625,0.28950943396226414,0.7018867924528301,0.00860377358490566
2004,GEORGIA,RANDOLPH,1612,17,1418,3047,0.5290449622579586,0.46537577945520187,0.005579258286839514
2004,GEORGIA,RICHMOND,39262,256,29764,69282,0.5666984209462775,0.4296065356080945,0.003695043445628013
2004,GEORGIA,ROCKDALE,12136,164,18856,31156,0.38952368725125175,0.6052124791372449,0.0052638336115034025
2004,GEORGIA,SCHLEY,464,3,1063,1530,0.3032679738562091,0.6947712418300653,0.00196078431372549
2004,GEORGIA,SCREVEN,2534,29,3360,5923,0.427823737970623,0.5672800945466824,0.00489616748269458
2004,GEORGIA,SEMINOLE,1278,19,1977,3274,0.39034819792302994,0.6038485033598046,0.005803298717165547
2004,GEORGIA,SPALDING,7460,86,13461,21007,0.3551197219974294,0.6407864045318227,0.004093873470747846
2004,GEORGIA,STEPHENS,2714,42,6904,9660,0.28095238095238095,0.7146997929606625,0.004347826086956522
2004,GEORGIA,STEWART,1220,14,797,2031,0.6006893156080748,0.39241752831117677,0.006893156080748399
2004,GEORGIA,SUMTER,5562,37,5688,11287,0.4927793036236378,0.5039425888189953,0.0032781075573668824
2004,GEORGIA,TALBOT,1830,10,1103,2943,0.6218144750254841,0.3747876316683656,0.0033978933061501867
2004,GEORGIA,TALIAFERRO,612,4,335,951,0.6435331230283912,0.352260778128286,0.004206098843322818
2004,GEORGIA,TATTNALL,1787,19,4657,6463,0.2764969828253133,0.7205632059415132,0.002939811233173449
2004,GEORGIA,TAYLOR,1458,11,1912,3381,0.43123336291038156,0.5655131617864537,0.003253475303164744
2004,GEORGIA,TELFAIR,1590,14,2171,3775,0.42119205298013246,0.5750993377483443,0.003708609271523179
2004,GEORGIA,TERRELL,1951,14,1859,3824,0.5101987447698745,0.4861401673640167,0.0036610878661087866
2004,GEORGIA,THOMAS,5997,49,9659,15705,0.3818529130850048,0.6150270614453995,0.0031200254695956703
2004,GEORGIA,TIFT,3864,37,8619,12520,0.30862619808306707,0.6884185303514377,0.0029552715654952077
2004,GEORGIA,TOOMBS,2567,50,6196,8813,0.2912742539430387,0.703052309088846,0.005673436968115285
2004,GEORGIA,TOWNS,1430,24,3823,5277,0.2709873033920788,0.7244646579495926,0.0045480386583285955
2004,GEORGIA,TREUTLEN,1052,13,1691,2756,0.38171262699564584,0.6135703918722787,0.0047169811320754715
2004,GEORGIA,TROUP,7630,99,14183,21912,0.3482110259218693,0.6472709017889741,0.004518072289156626
2004,GEORGIA,TURNER,1135,10,1815,2960,0.38344594594594594,0.6131756756756757,0.0033783783783783786
2004,GEORGIA,TWIGGS,2220,33,2112,4365,0.5085910652920962,0.4838487972508591,0.007560137457044674
2004,GEORGIA,UNION,2327,51,6847,9225,0.25224932249322496,0.7422222222222222,0.0055284552845528455
2004,GEORGIA,UPSON,3424,28,6634,10086,0.3394804679754115,0.6577434067023598,0.002776125322228832
2004,GEORGIA,WALKER,5986,127,15340,21453,0.27902857409220155,0.7150515079476064,0.005919917960192048
2004,GEORGIA,WALTON,5887,143,21594,27624,0.21311178685201274,0.7817115551694179,0.00517665797856936
2004,GEORGIA,WARE,3449,42,7790,11281,0.3057353071536211,0.6905416186508289,0.00372307419555004
2004,GEORGIA,WARREN,1360,8,1121,2489,0.5464041783848935,0.45038167938931295,0.0032141422257934912
2004,GEORGIA,WASHINGTON,3733,33,4081,7847,0.47572320632088694,0.52007136485281,0.004205428826303046
2004,GEORGIA,WAYNE,2683,40,6819,9542,0.2811779501152798,0.7146300565919095,0.004191993292810731
2004,GEORGIA,WEBSTER,515,4,485,1004,0.5129482071713147,0.48306772908366535,0.00398406374501992
2004,GEORGIA,WHEELER,847,10,1192,2049,0.41337237676915567,0.5817471937530503,0.004880429477794046
2004,GEORGIA,WHITE,2016,64,7403,9483,0.21259095223030686,0.7806601286512707,0.00674891911842244
2004,GEORGIA,WHITFIELD,6933,126,19297,26356,0.2630520564577326,0.732167248444377,0.004780695097890424
2004,GEORGIA,WILCOX,902,6,1705,2613,0.3451970914657482,0.6525066972828167,0.002296211251435132
2004,GEORGIA,WILKES,2028,25,2490,4543,0.44640105657054807,0.5480959718247854,0.00550297160466652
2004,GEORGIA,WILKINSON,2235,18,2261,4514,0.4951262738147984,0.500886132033673,0.003987594151528578
2004,GEORGIA,WORTH,2219,24,5105,7348,0.30198693522046816,0.6947468698965705,0.00326619488296135
2004,HAWAII,HAWAII,35116,554,22032,57702,0.6085750927177568,0.38182385359259646,0.009601053689646807
2004,HAWAII,HONOLULU,152500,1890,144157,298547,0.5108073435673445,0.4828619949287717,0.006330661503883811
2004,HAWAII,KAUAI,14916,220,9740,24876,0.5996140858658948,0.3915420485608619,0.008843865573243287
2004,HAWAII,MAUI,28803,440,18187,47430,0.6072738772928526,0.383449293695973,0.009276829011174362
2004,IDAHO,ADA,58523,1838,94641,155002,0.37756287015651413,0.6105792183326667,0.011857911510819216
2004,IDAHO,ADAMS,555,40,1468,2063,0.2690256907416384,0.7115850702859913,0.019389238972370333
2004,IDAHO,BANNOCK,12903,461,21479,34843,0.37031828487788077,0.6164509370605287,0.013230778061590563
2004,IDAHO,BEAR LAKE,494,40,2506,3040,0.1625,0.8243421052631579,0.013157894736842105
2004,IDAHO,BENEWAH,1148,76,2823,4047,0.28366691376328146,0.6975537435137139,0.018779342723004695
2004,IDAHO,BINGHAM,3605,225,12734,16564,0.21764066650567496,0.7687756580536103,0.013583675440714803
2004,IDAHO,BLAINE,5992,120,4034,10146,0.5905775675142914,0.3975951113739405,0.011827321111768185
2004,IDAHO,BOISE,970,56,2501,3527,0.2750212645307627,0.7091012191664304,0.01587751630280692
2004,IDAHO,BONNER,6649,335,10697,17681,0.3760533906453255,0.604999717210565,0.018946892144109495
2004,IDAHO,BONNEVILLE,8356,467,30048,38871,0.21496745645854234,0.7730184456278459,0.01201409791361169
2004,IDAHO,BOUNDARY,1268,98,3012,4378,0.2896299680219278,0.6879853814527181,0.022384650525354044
2004,IDAHO,BUTTE,321,8,1077,1406,0.2283072546230441,0.7660028449502134,0.005689900426742532
2004,IDAHO,CAMAS,139,6,450,595,0.23361344537815126,0.7563025210084033,0.010084033613445379
2004,IDAHO,CANYON,13415,678,41599,55692,0.24087840264310853,0.746947496947497,0.012174100409394527
2004,IDAHO,CARIBOU,491,37,2753,3281,0.14964949710454128,0.8390734532154831,0.011277049679975617
2004,IDAHO,CASSIA,1153,106,6562,7821,0.14742360311980565,0.8390231428206112,0.013553254059583174
2004,IDAHO,CLARK,46,5,302,353,0.13031161473087818,0.8555240793201133,0.014164305949008499
2004,IDAHO,CLEARWATER,1117,78,2839,4034,0.27689638076351014,0.7037679722359941,0.019335647000495785
2004,IDAHO,CUSTER,559,37,1762,2358,0.23706530958439356,0.7472434266327396,0.015691263782866838
2004,IDAHO,ELMORE,1959,89,6011,8059,0.2430822682714977,0.7458741779377094,0.011043553790792903
2004,IDAHO,FRANKLIN,456,71,4527,5054,0.09022556390977443,0.8957261574990106,0.01404827859121488
2004,IDAHO,FREMONT,741,63,4965,5769,0.12844513780551223,0.8606344253770151,0.0109204368174727
2004,IDAHO,GEM,1628,90,5416,7134,0.22820297168488926,0.7591813849172975,0.012615643397813289
2004,IDAHO,GOODING,1278,74,3973,5325,0.24,0.7461032863849765,0.013896713615023475
2004,IDAHO,IDAHO,1689,259,6017,7965,0.2120527306967985,0.7554300062774639,0.032517263025737604
2004,IDAHO,JEFFERSON,1084,119,7703,8906,0.12171569728273074,0.8649225241410285,0.013361778576240737
2004,IDAHO,JEROME,1344,59,5177,6580,0.20425531914893616,0.7867781155015198,0.008966565349544073
2004,IDAHO,KOOTENAI,17584,839,36173,54596,0.32207487728038686,0.6625576965345447,0.015367426185068504
2004,IDAHO,LATAH,8430,431,8686,17547,0.4804240041032655,0.4950133926027241,0.02456260329401037
2004,IDAHO,LEMHI,915,59,3079,4053,0.22575869726128794,0.7596841845546509,0.014557118184061189
2004,IDAHO,LEWIS,440,21,1359,1820,0.24175824175824176,0.7467032967032967,0.011538461538461539
2004,IDAHO,LINCOLN,466,21,1388,1875,0.24853333333333333,0.7402666666666666,0.0112
2004,IDAHO,MADISON,826,118,10693,11637,0.07098049325427516,0.9188794362808284,0.01014007046489645
2004,IDAHO,MINIDOKA,1331,72,5797,7200,0.18486111111111111,0.8051388888888888,0.01
2004,IDAHO,NEZ PERCE,6476,215,11009,17700,0.3658757062146893,0.6219774011299435,0.012146892655367232
2004,IDAHO,ONEIDA,304,40,1789,2133,0.14252226910454757,0.8387248007501172,0.01875293014533521
2004,IDAHO,OWYHEE,685,46,2859,3590,0.19080779944289694,0.7963788300835655,0.012813370473537604
2004,IDAHO,PAYETTE,1848,76,6256,8180,0.22591687041564792,0.7647921760391198,0.009290953545232274
2004,IDAHO,POWER,829,24,2105,2958,0.28025693035835025,0.7116294793779581,0.008113590263691683
2004,IDAHO,SHOSHONE,2331,84,2922,5337,0.43676222596964587,0.5474985947161327,0.015739179314221474
2004,IDAHO,TETON,1416,39,2235,3690,0.383739837398374,0.6056910569105691,0.01056910569105691
2004,IDAHO,TWIN FALLS,6458,305,19672,26435,0.24429733308114243,0.7441649328541706,0.011537734064686968
2004,IDAHO,VALLEY,1843,66,2863,4772,0.38621123218776193,0.5999580888516345,0.013830678960603521
2004,IDAHO,WASHINGTON,1033,52,3274,4359,0.23698095893553567,0.751089699472356,0.011929341592108282
2004,ILLINOIS,ADAMS,10511,132,20834,31477,0.3339263589287416,0.6618801029322998,0.004193538138958604
2004,ILLINOIS,ALEXANDER,2016,26,1831,3873,0.5205267234701781,0.47276013426284536,0.006713142266976504
2004,ILLINOIS,BOND,3228,73,4068,7369,0.4380512959696024,0.5520423395304654,0.009906364499932149
2004,ILLINOIS,BOONE,8286,123,11132,19541,0.42403152346348705,0.56967401872985,0.006294457806662914
2004,ILLINOIS,BROWN,895,11,1679,2585,0.34622823984526113,0.6495164410058027,0.00425531914893617
2004,ILLINOIS,BUREAU,7961,119,9822,17902,0.44469891632219866,0.5486537817003687,0.006647301977432689
2004,ILLINOIS,CALHOUN,1367,22,1317,2706,0.5051736881005173,0.4866962305986696,0.008130081300813009
2004,ILLINOIS,CARROLL,3537,64,4534,8135,0.4347879532882606,0.5573448063921328,0.007867240319606637
2004,ILLINOIS,CASS,2492,45,3163,5700,0.43719298245614036,0.5549122807017544,0.007894736842105263
2004,ILLINOIS,CHAMPAIGN,41524,1014,39896,82434,0.5037241914743916,0.48397505883494674,0.01230074969066162
2004,ILLINOIS,CHRISTIAN,6112,111,9044,15267,0.40034060391694504,0.5923888124713435,0.0072705836117115345
2004,ILLINOIS,CLARK,2877,48,5082,8007,0.3593106032221806,0.6346946421880855,0.005994754589733983
2004,ILLINOIS,CLAY,2101,37,4416,6554,0.3205675923100397,0.6737870003051571,0.0056454073848031736
2004,ILLINOIS,CLINTON,6797,115,10219,17131,0.39676609655011386,0.5965209269744907,0.0067129764753954815
2004,ILLINOIS,COLES,9566,199,13015,22780,0.4199297629499561,0.5713345039508341,0.008735733099209834
2004,ILLINOIS,COOK,1439724,12305,597405,2049434,0.7024983483244642,0.29149755493467955,0.006004096740856256
2004,ILLINOIS,CRAWFORD,3194,55,6083,9332,0.3422631804543506,0.651843120445778,0.00589369909987141
2004,ILLINOIS,CUMBERLAND,1862,57,3497,5416,0.34379615952732645,0.6456794682422452,0.010524372230428361
2004,ILLINOIS,DE WITT,2836,42,4920,7798,0.3636829956399077,0.6309310079507566,0.005385996409335727
2004,ILLINOIS,DEKALB,19263,410,21095,40768,0.47250294348508637,0.5174401491365777,0.01005690737833595
2004,ILLINOIS,DOUGLAS,2767,71,5702,8540,0.32400468384074943,0.6676814988290398,0.008313817330210773
2004,ILLINOIS,DUPAGE,180097,3447,218902,402446,0.44750600080507696,0.5439288749298042,0.008565124265118799
2004,ILLINOIS,EDGAR,3093,78,5258,8429,0.36694744335033813,0.6237987898920394,0.009253766757622494
2004,ILLINOIS,EDWARDS,930,22,2412,3364,0.27645659928656363,0.7170035671819263,0.006539833531510107
2004,ILLINOIS,EFFINGHAM,4388,116,11774,16278,0.26956628578449443,0.7233075316377934,0.00712618257771225
2004,ILLINOIS,FAYETTE,3571,98,5880,9549,0.3739658602995078,0.6157712849513038,0.010262854749188397
2004,ILLINOIS,FORD,1912,56,4511,6479,0.2951072696403766,0.6962494212069764,0.008643309152647013
2004,ILLINOIS,FRANKLIN,8816,148,10388,19352,0.4555601488218272,0.5367920628358825,0.007647788342290202
2004,ILLINOIS,FULTON,9080,137,7818,17035,0.5330202524214852,0.4589374816554153,0.008042265923099501
2004,ILLINOIS,GALLATIN,1573,33,1619,3225,0.4877519379844961,0.5020155038759689,0.010232558139534883
2004,ILLINOIS,GREENE,2457,52,3559,6068,0.40491100856954515,0.5865194462755439,0.008569545154911009
2004,ILLINOIS,GRUNDY,8463,170,11198,19831,0.42675608895164135,0.564671473954919,0.008572437093439564
2004,ILLINOIS,HAMILTON,1814,47,2653,4514,0.40186087727071335,0.5877270713336287,0.010412051395657953
2004,ILLINOIS,HANCOCK,3975,87,5837,9899,0.40155571269825235,0.5896555207596726,0.008788766542074958
2004,ILLINOIS,HARDIN,923,13,1501,2437,0.3787443578169881,0.6159212146081248,0.005334427574887156
2004,ILLINOIS,HENDERSON,2269,27,1857,4153,0.5463520346737298,0.44714664098242235,0.006501324343847821
2004,ILLINOIS,HENRY,11877,152,13212,25241,0.4705439562616378,0.5234340953211045,0.0060219484172576365
2004,ILLINOIS,IROQUOIS,3832,89,9914,13835,0.27697867726779907,0.7165883628478497,0.0064329598843512826
2004,ILLINOIS,JACKSON,14300,336,11190,25826,0.5537055680322156,0.433284287152482,0.013010144815302408
2004,ILLINOIS,JASPER,1781,26,3529,5336,0.3337706146926537,0.6613568215892054,0.004872563718140929
2004,ILLINOIS,JEFFERSON,6713,75,10160,16948,0.39609393438753837,0.5994807646919991,0.004425300920462592
2004,ILLINOIS,JERSEY,4597,105,5435,10137,0.4534872250172635,0.5361546808720529,0.010358094110683634
2004,ILLINOIS,JO DAVIESS,5311,99,6174,11584,0.4584772099447514,0.5329765193370166,0.008546270718232045
2004,ILLINOIS,JOHNSON,1813,55,3997,5865,0.30912190963341857,0.6815004262574595,0.00937766410912191
2004,ILLINOIS,KANE,75922,1434,94359,171715,0.4421395917654253,0.5495093614419241,0.008351046792650613
2004,ILLINOIS,KANKAKEE,20003,294,24739,45036,0.44415578648192555,0.5493161026734168,0.006528110844657607
2004,ILLINOIS,KENDALL,12374,254,19774,32402,0.38189000678970436,0.6102709709277205,0.00783902228257515
2004,ILLINOIS,KNOX,13403,194,11111,24708,0.5424558847336894,0.449692407317468,0.00785170794884248
2004,ILLINOIS,LAKE,134352,1862,139081,275295,0.48802920503459923,0.5052071414301023,0.006763653535298498
2004,ILLINOIS,LASALLE,24263,365,26101,50729,0.4782865816396933,0.5145183228528061,0.007195095507500641
2004,ILLINOIS,LAWRENCE,2518,49,4162,6729,0.37420121860603356,0.6185168672908308,0.007281914103135681
2004,ILLINOIS,LEE,6416,153,9307,15876,0.40413202317964225,0.5862307886117409,0.00963718820861678
2004,ILLINOIS,LIVINGSTON,5632,91,10316,16039,0.3511440862896689,0.6431822432820001,0.005673670428330943
2004,ILLINOIS,LOGAN,4273,82,9112,13467,0.3172941263830103,0.6766169154228856,0.006088958194104106
2004,ILLINOIS,MACON,23341,287,28118,51746,0.451068681637228,0.5433849959417153,0.0055463224210567
2004,ILLINOIS,MACOUPIN,11193,179,11413,22785,0.4912442396313364,0.5008997147245995,0.007856045644064077
2004,ILLINOIS,MADISON,63399,895,59384,123678,0.5126133993111144,0.4801500671097527,0.00723653357913291
2004,ILLINOIS,MARION,7694,117,9413,17224,0.4467022758941013,0.5465048769159313,0.006792847189967487
2004,ILLINOIS,MARSHALL,2806,44,3734,6584,0.4261846901579587,0.5671324422843257,0.006682867557715674
2004,ILLINOIS,MASON,3215,61,3907,7183,0.4475845746902408,0.5439231518863984,0.008492273423360713
2004,ILLINOIS,MASSAC,2805,41,4578,7424,0.3778286637931034,0.6166487068965517,0.005522629310344827
2004,ILLINOIS,MCDONOUGH,7119,154,7656,14929,0.4768571237189363,0.5128273829459441,0.010315493335119566
2004,ILLINOIS,MCHENRY,50330,1206,76412,127948,0.39336292868978023,0.5972113671178917,0.009425704192328133
2004,ILLINOIS,MCLEAN,29877,467,41276,71620,0.41716001117006424,0.576319463836917,0.0065205249930187096
2004,ILLINOIS,MENARD,2137,29,4408,6574,0.32506845147550956,0.6705202312138728,0.004411317310617584
2004,ILLINOIS,MERCER,4512,57,4405,8974,0.5027858257187431,0.4908624916425228,0.006351682638734121
2004,ILLINOIS,MONROE,6788,114,9468,16370,0.4146609651802077,0.5783750763591936,0.006963958460598656
2004,ILLINOIS,MONTGOMERY,5979,100,6851,12930,0.46241299303944317,0.5298530549110596,0.007733952049497293
2004,ILLINOIS,MORGAN,5650,138,9392,15180,0.37220026350461133,0.6187088274044796,0.00909090909090909
2004,ILLINOIS,MOULTRIE,2388,50,4028,6466,0.36931642437364676,0.6229508196721312,0.007732755954222085
2004,ILLINOIS,OGLE,9018,155,14918,24091,0.37433066290315886,0.6192353991117014,0.006433937985139679
2004,ILLINOIS,PEORIA,41121,599,41051,82771,0.49680443633639804,0.49595872950671127,0.0072368341568906985
2004,ILLINOIS,PERRY,4770,66,5589,10425,0.45755395683453237,0.5361151079136691,0.006330935251798561
2004,ILLINOIS,PIATT,3124,70,5392,8586,0.36384812485441415,0.6279990682506406,0.00815280689494526
2004,ILLINOIS,PIKE,2849,99,5032,7980,0.3570175438596491,0.6305764411027569,0.012406015037593985
2004,ILLINOIS,POPE,918,18,1500,2436,0.3768472906403941,0.6157635467980296,0.007389162561576354
2004,ILLINOIS,PULASKI,1372,16,1720,3108,0.44144144144144143,0.5534105534105535,0.005148005148005148
2004,ILLINOIS,PUTNAM,1704,25,1623,3352,0.5083532219570406,0.48418854415274465,0.007458233890214797
2004,ILLINOIS,RANDOLPH,6771,109,8076,14956,0.4527280021396095,0.5399839529285906,0.007288044931799947
2004,ILLINOIS,RICHLAND,2529,67,5153,7749,0.32636469221835074,0.6649890308426893,0.008646276938959866
2004,ILLINOIS,ROCK ISLAND,39880,429,29663,69972,0.5699422626193335,0.4239267135425599,0.006131023838106671
2004,ILLINOIS,SALINE,4697,60,7057,11814,0.39757914338919925,0.5973421364482817,0.005078720162519045
2004,ILLINOIS,SANGAMON,38630,841,55904,95375,0.40503276539973787,0.5861494102228048,0.008817824377457406
2004,ILLINOIS,SCHUYLER,1594,34,2403,4031,0.39543537583726124,0.596129992557678,0.008434631605060779
2004,ILLINOIS,SCOTT,927,13,1696,2636,0.3516691957511381,0.6433990895295902,0.004931714719271623
2004,ILLINOIS,SHELBY,3744,80,6753,10577,0.3539756074501276,0.6384608111941004,0.007563581355771958
2004,ILLINOIS,ST. CLAIR,62410,576,50203,113189,0.5513786675383651,0.4435324987410437,0.005088833720591224
2004,ILLINOIS,STARK,1189,31,1841,3061,0.38843515191114014,0.601437438745508,0.010127409343351846
2004,ILLINOIS,STEPHENSON,8913,195,12212,21320,0.4180581613508443,0.5727954971857411,0.009146341463414634
2004,ILLINOIS,TAZEWELL,25814,466,36058,62338,0.41409734030607337,0.578427283518881,0.007475376175045718
2004,ILLINOIS,UNION,3735,51,5333,9119,0.4095843842526593,0.5848228972475052,0.005592718499835508
2004,ILLINOIS,VERMILION,14726,257,18731,33714,0.4367918372189595,0.5555852168238714,0.007622945957169129
2004,ILLINOIS,WABASH,1752,42,4212,6006,0.2917082917082917,0.7012987012987013,0.006993006993006993
2004,ILLINOIS,WARREN,3938,45,4474,8457,0.4656497575972567,0.5290292065744354,0.005321035828307911
2004,ILLINOIS,WASHINGTON,2986,46,5072,8104,0.36846001974333664,0.6258637709772952,0.005676209279368213
2004,ILLINOIS,WAYNE,2139,46,6102,8287,0.2581151200675757,0.7363340171352721,0.005550862797152166
2004,ILLINOIS,WHITE,3071,50,5180,8301,0.3699554270569811,0.6240212022647874,0.006023370678231539
2004,ILLINOIS,WHITESIDE,13723,191,12959,26873,0.5106612585122614,0.48223123581289773,0.0071075056748409185
2004,ILLINOIS,WILL,115625,1686,129098,246409,0.46924016574069943,0.5239175517128027,0.006842282546497895
2004,ILLINOIS,WILLIAMSON,11685,189,18086,29960,0.3900200267022697,0.6036715620827771,0.006308411214953271
2004,ILLINOIS,WINNEBAGO,59740,903,60782,121425,0.49199094091002676,0.5005723697755816,0.007436689314391599
2004,ILLINOIS,WOODFORD,6005,99,12698,18802,0.3193809169237315,0.6753536857781087,0.00526539729815977
2004,INDIANA,ADAMS,3512,94,9734,13340,0.26326836581709145,0.7296851574212894,0.007046476761619191
2004,INDIANA,ALLEN,46710,886,82013,129609,0.3603916394694813,0.6327724154958375,0.006835945034681234
2004,INDIANA,BARTHOLOMEW,9191,231,19093,28515,0.322321585130633,0.6695774153954059,0.008100999473961073
2004,INDIANA,BENTON,1135,60,2797,3992,0.2843186372745491,0.7006513026052105,0.01503006012024048
2004,INDIANA,BLACKFORD,1903,30,3447,5380,0.3537174721189591,0.6407063197026023,0.0055762081784386614
2004,INDIANA,BOONE,5636,207,17055,22898,0.24613503362739103,0.7448248755349812,0.00904009083762774
2004,INDIANA,BROWN,2730,88,4512,7330,0.37244201909959074,0.6155525238744884,0.012005457025920874
2004,INDIANA,CARROLL,2689,81,5868,8638,0.31129891178513547,0.6793239175735124,0.009377170641352165
2004,INDIANA,CASS,4315,136,9480,13931,0.30974086569521214,0.6804967339028067,0.009762400401981192
2004,INDIANA,CLARK,17648,194,24495,42337,0.4168457850107471,0.5785719347143161,0.004582280274936817
2004,INDIANA,CLAY,3333,89,7361,10783,0.30909765371417974,0.6826486135583789,0.008253732727441343
2004,INDIANA,CLINTON,3335,71,8471,11877,0.2807948135050939,0.7132272459375263,0.00597794055737981
2004,INDIANA,CRAWFORD,1932,33,2609,4574,0.4223874070835155,0.570397901180586,0.007214691735898557
2004,INDIANA,DAVIESS,2573,90,7936,10599,0.24275875082554957,0.7487498820643457,0.008491367110104727
2004,INDIANA,DEARBORN,6596,142,14231,20969,0.31455958796318373,0.6786685106585912,0.0067719013782249985
2004,INDIANA,DECATUR,2621,79,7499,10199,0.2569859790175507,0.7352681635454457,0.007745857437003628
2004,INDIANA,DEKALB,4810,125,10468,15403,0.312276829189119,0.6796078685970266,0.008115302213854444
2004,INDIANA,DELAWARE,20436,439,27064,47939,0.426291745760237,0.564550783287094,0.009157470952669017
2004,INDIANA,DUBOIS,5210,130,11726,17066,0.3052853627094808,0.6870971522325091,0.007617485058010079
2004,INDIANA,ELKHART,17966,447,42967,61380,0.2927012056044314,0.7000162919517758,0.007282502443792766
2004,INDIANA,FAYETTE,3626,81,5761,9468,0.38297422898183353,0.6084706379383186,0.008555133079847909
2004,INDIANA,FLOYD,13857,156,19877,33890,0.4088816760106226,0.5865151962230747,0.004603127766302744
2004,INDIANA,FOUNTAIN,2477,67,5260,7804,0.3174013326499231,0.6740133264992312,0.00858534085084572
2004,INDIANA,FRANKLIN,2925,90,6977,9992,0.2927341873498799,0.6982586068855084,0.009007205764611689
2004,INDIANA,FULTON,2607,69,6027,8703,0.29955187866253014,0.692519820751465,0.007928300586004825
2004,INDIANA,GIBSON,5378,103,9133,14614,0.3680032845216915,0.6249486793485699,0.007048036129738607
2004,INDIANA,GRANT,8509,182,18769,27460,0.3098689002184996,0.6835032774945375,0.006627822286962855
2004,INDIANA,GREENE,4606,137,8609,13352,0.3449670461354104,0.6447723187537447,0.010260635110844817
2004,INDIANA,HAMILTON,26388,631,77887,104906,0.25153947343335936,0.7424456179818123,0.006014908584828322
2004,INDIANA,HANCOCK,6912,184,20771,27867,0.2480353105824093,0.7453618975849571,0.006602791832633581
2004,INDIANA,HARRISON,6171,124,11015,17310,0.35649913344887346,0.6363373772385904,0.007163489312536107
2004,INDIANA,HENDRICKS,13548,324,38430,52302,0.2590340713548239,0.7347711368590111,0.006194791786164965
2004,INDIANA,HENRY,7176,191,13137,20504,0.3499804916113929,0.6407042528287163,0.009315255559890753
2004,INDIANA,HOWARD,12998,309,23714,37021,0.35109802544501767,0.640555360471084,0.008346614083898328
2004,INDIANA,HUNTINGTON,3877,133,11617,15627,0.24809624368080885,0.7433928457157484,0.00851091060344276
2004,INDIANA,JACKSON,5092,134,11083,16309,0.3122202464896683,0.6795634312342879,0.008216322276043903
2004,INDIANA,JASPER,3678,110,8056,11844,0.3105369807497467,0.6801756163458291,0.009287402904424182
2004,INDIANA,JAY,2740,65,5427,8232,0.3328474246841594,0.6592565597667639,0.007896015549076773
2004,INDIANA,JEFFERSON,5117,91,7763,12971,0.3944954128440367,0.5984889368591473,0.007015650296815974
2004,INDIANA,JENNINGS,3538,115,6864,10517,0.33640772083293713,0.6526576019777504,0.010934677189312542
2004,INDIANA,JOHNSON,13109,381,37765,51255,0.2557604136181836,0.7368061652521706,0.007433421129645889
2004,INDIANA,KNOX,5649,107,9990,15746,0.3587577797535882,0.6344468436428299,0.006795376603581862
2004,INDIANA,KOSCIUSKO,5977,247,22136,28360,0.2107545839210155,0.7805359661495064,0.008709449929478138
2004,INDIANA,LAGRANGE,2523,50,6430,9003,0.28023992002665776,0.7142063756525603,0.005553704320781961
2004,INDIANA,LAKE,114743,1376,71903,188022,0.6102636925466168,0.3824180149131485,0.0073182925402346536
2004,INDIANA,LAPORTE,21114,576,20916,42606,0.4955640050697085,0.4909167722855936,0.01351922264469793
2004,INDIANA,LAWRENCE,5346,145,12207,17698,0.302068030285908,0.6897389535540739,0.008193016160018081
2004,INDIANA,MADISON,21882,447,32526,54855,0.3989062072737216,0.5929450369155045,0.008148755810773858
2004,INDIANA,MARION,162249,2517,156072,320838,0.5057038131393413,0.4864511061657285,0.007845080694930152
2004,INDIANA,MARSHALL,5593,147,12074,17814,0.3139665431682946,0.6777815201526889,0.008251936679016504
2004,INDIANA,MARTIN,1522,60,3414,4996,0.30464371497197756,0.6833466773418735,0.01200960768614892
2004,INDIANA,MIAMI,3886,142,9600,13628,0.2851482242442031,0.7044320516583504,0.010419724097446435
2004,INDIANA,MONROE,26965,668,22834,50467,0.5343095488140766,0.45245407890304556,0.01323637228287792
2004,INDIANA,MONTGOMERY,3536,111,10901,14548,0.24305746494363487,0.749312620291449,0.00762991476491614
2004,INDIANA,MORGAN,6650,182,19197,26029,0.25548426754773523,0.7375235314456952,0.0069922010065695955
2004,INDIANA,NEWTON,2032,59,3757,5848,0.34746922024623805,0.6424418604651163,0.01008891928864569
2004,INDIANA,NOBLE,4703,117,10859,15679,0.2999553542955546,0.6925824351042796,0.007462210600165827
2004,INDIANA,OHIO,1139,23,1796,2958,0.3850574712643678,0.6071670047329276,0.00777552400270453
2004,INDIANA,ORANGE,2885,84,5683,8652,0.3334489135460009,0.6568423485899214,0.009708737864077669
2004,INDIANA,OWEN,2536,68,5000,7604,0.3335086796422935,0.6575486586007364,0.008942661756970016
2004,INDIANA,PARKE,2362,59,4550,6971,0.3388323052646679,0.6527040596757997,0.008463635059532348
2004,INDIANA,PERRY,4131,47,4137,8315,0.4968129885748647,0.4975345760673482,0.0056524353577871314
2004,INDIANA,PIKE,2418,49,3745,6212,0.3892466194462331,0.6028654217643271,0.007887958789439794
2004,INDIANA,PORTER,29388,691,34794,64873,0.45300818522343655,0.536340233995653,0.010651580780910394
2004,INDIANA,POSEY,4085,68,7833,11986,0.3408142833305523,0.6535124311696979,0.005673285499749708
2004,INDIANA,PULASKI,1750,67,3797,5614,0.3117206982543641,0.676344852155326,0.01193444959030994
2004,INDIANA,PUTNAM,4103,125,8908,13136,0.3123477466504263,0.678136419001218,0.009515834348355665
2004,INDIANA,RANDOLPH,3812,108,7172,11092,0.3436711143166246,0.6465921384781824,0.009736747205192933
2004,INDIANA,RIPLEY,3510,100,8224,11834,0.2966030082812236,0.6949467635626162,0.008450228156160216
2004,INDIANA,RUSH,2000,58,5363,7421,0.2695054574855141,0.722678884247406,0.007815658267079908
2004,INDIANA,SCOTT,3822,62,4793,8677,0.44047481848565173,0.5523798547885214,0.007145326725826899
2004,INDIANA,SHELBY,4519,111,11397,16027,0.28196168964871776,0.7111124976601985,0.006925812691083796
2004,INDIANA,SPENCER,3920,70,5934,9924,0.39500201531640466,0.5979443772672309,0.007053607416364369
2004,INDIANA,ST. JOSEPH,52637,728,55254,108619,0.4846021414301365,0.5086955320892294,0.006702326480634143
2004,INDIANA,STARKE,3987,104,4846,8937,0.446122860020141,0.5422401253216963,0.011637014658162694
2004,INDIANA,STEUBEN,4345,127,8433,12905,0.3366912049593181,0.6534676481983728,0.009841146842309183
2004,INDIANA,SULLIVAN,3341,54,4999,8394,0.39802239695020253,0.5955444365022635,0.006433166547533953
2004,INDIANA,SWITZERLAND,1479,31,2161,3671,0.4028874965949333,0.5886679378915827,0.008444565513484064
2004,INDIANA,TIPPECANOE,20818,645,30897,52360,0.3975935828877005,0.5900878533231474,0.012318563789152024
2004,INDIANA,TIPTON,2203,61,5628,7892,0.2791434363912823,0.7131272174353775,0.007729346173340091
2004,INDIANA,UNION,1045,33,2266,3344,0.3125,0.6776315789473685,0.009868421052631578
2004,INDIANA,VANDERBURGH,28767,424,41463,70654,0.4071531689642483,0.5868457553712458,0.006001075664505902
2004,INDIANA,VERMILLION,3424,57,3536,7017,0.48795781673079663,0.5039190537266638,0.008123129542539546
2004,INDIANA,VIGO,18426,330,20988,39744,0.4636171497584541,0.5280797101449275,0.008303140096618358
2004,INDIANA,WABASH,3920,75,9607,13602,0.28819291280694015,0.706293192177621,0.005513895015438906
2004,INDIANA,WARREN,1356,39,2565,3960,0.3424242424242424,0.6477272727272727,0.009848484848484848
2004,INDIANA,WARRICK,8980,115,16930,26025,0.3450528338136407,0.6505283381364073,0.004418828049951969
2004,INDIANA,WASHINGTON,3879,86,6915,10880,0.35652573529411763,0.6355698529411765,0.007904411764705882
2004,INDIANA,WAYNE,10775,296,16586,27657,0.38959395451422785,0.5997035108652421,0.010702534620530064
2004,INDIANA,WELLS,3112,74,9168,12354,0.25190221790513195,0.7421078193297718,0.005989962765096325
2004,INDIANA,WHITE,3277,115,6974,10366,0.3161296546401698,0.6727763843333976,0.011093961026432567
2004,INDIANA,WHITLEY,3880,89,9512,13481,0.28781247681922706,0.7055856390475485,0.006601884133224538
2004,IOWA,ADAIR,1844,32,2402,4278,0.4310425432445068,0.5614773258532024,0.0074801309022907905
2004,IOWA,ADAMS,977,31,1317,2325,0.42021505376344087,0.5664516129032258,0.013333333333333334
2004,IOWA,ALLAMAKEE,3449,83,3530,7062,0.4883885584820164,0.49985839705465873,0.011753044463324838
2004,IOWA,APPANOOSE,3063,47,3340,6450,0.47488372093023257,0.517829457364341,0.007286821705426357
2004,IOWA,AUDUBON,1608,26,1958,3592,0.44766146993318484,0.5451002227171492,0.007238307349665924
2004,IOWA,BENTON,6747,96,6658,13501,0.49974075994370787,0.49314865565513666,0.00711058440115547
2004,IOWA,BLACK HAWK,35392,469,28046,63907,0.5538047475237454,0.43885646329823025,0.007338789178024317
2004,IOWA,BOONE,7027,112,6870,14009,0.5016061103576273,0.49039902919551714,0.007994860446855594
2004,IOWA,BREMER,6025,89,6665,12779,0.47147664136473905,0.5215588074184209,0.006964551216840129
2004,IOWA,BUCHANAN,5608,70,4797,10475,0.5353699284009547,0.4579474940334129,0.006682577565632458
2004,IOWA,BUENA VISTA,3520,83,4887,8490,0.41460541813898705,0.5756183745583039,0.00977620730270907
2004,IOWA,BUTLER,3001,57,4417,7475,0.4014715719063545,0.5909030100334448,0.007625418060200669
2004,IOWA,CALHOUN,2243,44,3255,5542,0.40472753518585347,0.587333092746301,0.007939372067845544
2004,IOWA,CARROLL,4689,73,5762,10524,0.44555302166476624,0.5475104522995059,0.00693652603572786
2004,IOWA,CASS,2679,68,4796,7543,0.35516372795969775,0.635821291263423,0.009014980776879226
2004,IOWA,CEDAR,4747,78,4869,9694,0.489684340829379,0.5022694450175367,0.008046214153084381
2004,IOWA,CERRO GORDO,13372,184,10960,24516,0.5454397128405939,0.44705498449991843,0.007505302659487682
2004,IOWA,CHEROKEE,2988,50,3758,6796,0.4396703943496174,0.5529723366686286,0.0073572689817539725
2004,IOWA,CHICKASAW,3708,58,3040,6806,0.5448133999412283,0.4466647076109315,0.008521892447840141
2004,IOWA,CLARKE,2323,43,2200,4566,0.508760402978537,0.4818221638195357,0.009417433201927288
2004,IOWA,CLAY,3547,143,4898,8588,0.4130181648812296,0.5703306939916162,0.016651141127154167
2004,IOWA,CLAYTON,4736,120,4312,9168,0.5165794066317626,0.47033158813263526,0.013089005235602094
2004,IOWA,CLINTON,13813,205,10666,24684,0.5595932587911198,0.43210176632636527,0.00830497488251499
2004,IOWA,CRAWFORD,3220,67,3955,7242,0.44462855564761117,0.5461198563932615,0.009251587959127313
2004,IOWA,DALLAS,10917,193,15183,26293,0.41520556802190695,0.5774540752291485,0.007340356748944586
2004,IOWA,DAVIS,1731,39,2148,3918,0.44180704441041346,0.5482388973966309,0.009954058192955589
2004,IOWA,DECATUR,1859,64,2088,4011,0.46347544253303413,0.5205684367988033,0.015956120668162554
2004,IOWA,DELAWARE,4227,65,4908,9200,0.45945652173913043,0.5334782608695652,0.007065217391304348
2004,IOWA,DES MOINES,12456,197,8221,20874,0.5967231963207819,0.39383922583117753,0.009437577848040625
2004,IOWA,DICKINSON,4140,76,5337,9553,0.43337171569140587,0.5586726682717471,0.007955616036847064
2004,IOWA,DUBUQUE,26561,382,20100,47043,0.5646111004825373,0.4272686690899815,0.00812023042748124
2004,IOWA,EMMET,2405,54,2697,5156,0.4664468580294802,0.5230799069045772,0.01047323506594259
2004,IOWA,FAYETTE,5185,79,5128,10392,0.498941493456505,0.49345650500384913,0.0076020015396458815
2004,IOWA,FLOYD,4349,73,3745,8167,0.5325088771886862,0.4585527121341986,0.00893841067711522
2004,IOWA,FRANKLIN,2340,53,3128,5521,0.42383626154682125,0.5665640282557508,0.009599710197428002
2004,IOWA,FREMONT,1510,39,2362,3911,0.38609051393505495,0.6039376118639734,0.009971874200971618
2004,IOWA,GREENE,2459,36,2618,5113,0.48093096029728144,0.5120281635047917,0.0070408761979268535
2004,IOWA,GRUNDY,2386,34,4429,6849,0.3483720251131552,0.6466637465323405,0.004964228354504307
2004,IOWA,GUTHRIE,2614,55,3325,5994,0.43610276943610277,0.5547213880547214,0.009175842509175842
2004,IOWA,HAMILTON,3895,73,4367,8335,0.4673065386922616,0.5239352129574085,0.008758248350329933
2004,IOWA,HANCOCK,2484,53,3368,5905,0.4206604572396274,0.5703640982218459,0.008975444538526672
2004,IOWA,HARDIN,4015,59,4875,8949,0.4486534808358476,0.5447536037546095,0.006592915409542966
2004,IOWA,HARRISON,2906,94,4680,7680,0.37838541666666664,0.609375,0.012239583333333333
2004,IOWA,HENRY,4127,110,5220,9457,0.4363963201861055,0.5519720841704557,0.011631595643438722
2004,IOWA,HOWARD,2614,55,2028,4697,0.5565254417713434,0.4317649563551203,0.0117096018735363
2004,IOWA,HUMBOLDT,2146,42,3162,5350,0.4011214953271028,0.5910280373831776,0.007850467289719627
2004,IOWA,IDA,1415,17,2342,3774,0.3749337572866985,0.620561738208797,0.0045045045045045045
2004,IOWA,IOWA,3841,69,4544,8454,0.45434114028862077,0.5374970428199669,0.008161816891412349
2004,IOWA,JACKSON,5656,113,4242,10011,0.5649785236240136,0.4237338927180102,0.011287583657976226
2004,IOWA,JASPER,10430,170,9462,20062,0.5198883461270063,0.4716379224404347,0.008473731432559067
2004,IOWA,JEFFERSON,4490,143,3648,8281,0.5422050476995532,0.4405265064605724,0.01726844583987441
2004,IOWA,JOHNSON,41847,811,22715,65373,0.6401266577945023,0.3474676089517079,0.012405733253789792
2004,IOWA,JONES,5054,90,4834,9978,0.5065143315293646,0.4844658248145921,0.009019843656043296
2004,IOWA,KEOKUK,2294,67,3119,5480,0.41861313868613137,0.5691605839416058,0.012226277372262773
2004,IOWA,KOSSUTH,4132,84,5042,9258,0.4463166990710737,0.5446100669691079,0.009073233959818535
2004,IOWA,LEE,10152,234,7472,17858,0.5684847127337888,0.41841191622802104,0.013103371038190167
2004,IOWA,LINN,60442,856,49442,110740,0.5458009752573596,0.4464692071518873,0.007729817590753116
2004,IOWA,LOUISA,2297,47,2572,4916,0.4672497965825875,0.5231895850284785,0.009560618388934093
2004,IOWA,LUCAS,1987,41,2543,4571,0.43469700284401663,0.5563334062568366,0.008969590899146795
2004,IOWA,LYON,1303,47,4751,6101,0.2135715456482544,0.7787247992132438,0.007703655138501885
2004,IOWA,MADISON,3380,86,4538,8004,0.4222888555722139,0.5669665167416292,0.01074462768615692
2004,IOWA,MAHASKA,3790,80,6858,10728,0.35328113348247575,0.639261744966443,0.007457121551081283
2004,IOWA,MARION,6574,132,9990,16696,0.39374700527072354,0.5983469094393867,0.007906085289889795
2004,IOWA,MARSHALL,9443,164,9557,19164,0.492746816948445,0.49869547067418074,0.008557712377374243
2004,IOWA,MILLS,2308,76,4556,6940,0.3325648414985591,0.6564841498559078,0.01095100864553314
2004,IOWA,MITCHELL,2785,49,2646,5480,0.5082116788321168,0.4828467153284672,0.008941605839416058
2004,IOWA,MONONA,2397,46,2575,5018,0.47768035073734555,0.5131526504583499,0.009166998804304504
2004,IOWA,MONROE,1855,41,2067,3963,0.46807973757254606,0.5215745647236941,0.010345697703759779
2004,IOWA,MONTGOMERY,1899,56,3601,5556,0.341792656587473,0.6481281497480201,0.010079193664506839
2004,IOWA,MUSCATINE,9542,155,9020,18717,0.5098039215686274,0.4819148367793984,0.008281241651974141
2004,IOWA,O'BRIEN,2330,73,5328,7731,0.3013840382874143,0.689173457508731,0.009442504203854611
2004,IOWA,OSCEOLA,934,37,2295,3266,0.2859767299448867,0.7026944274341702,0.01132884262094305
2004,IOWA,PAGE,2211,59,5243,7513,0.29428989751098095,0.6978570477838414,0.007853054705177692
2004,IOWA,PALO ALTO,2482,35,2674,5191,0.4781352340589482,0.5151223271046041,0.006742438836447698
2004,IOWA,PLYMOUTH,4278,134,7810,12222,0.35002454590083454,0.6390116183930616,0.010963835706103747
2004,IOWA,POCAHONTAS,1822,50,2441,4313,0.42244377463482496,0.5659633665661952,0.011592858798979828
2004,IOWA,POLK,105218,1572,95828,202618,0.5192924616766527,0.4729490963290527,0.007758441994294683
2004,IOWA,POTTAWATTAMIE,16906,356,24558,41820,0.40425633668101385,0.5872309899569584,0.008512673362027738
2004,IOWA,POWESHIEK,5043,83,4965,10091,0.49975225448419386,0.4920225943910415,0.008225151124764641
2004,IOWA,RINGGOLD,1286,26,1466,2778,0.462922966162707,0.5277177825773938,0.009359251259899209
2004,IOWA,SAC,2215,31,3128,5374,0.4121697059918124,0.582061778935616,0.0057685150725716415
2004,IOWA,SCOTT,42122,642,39958,82722,0.5091994874398588,0.48303957834675176,0.007760934213389425
2004,IOWA,SHELBY,2355,59,4256,6670,0.3530734632683658,0.6380809595202399,0.008845577211394303
2004,IOWA,SIOUX,2259,82,14229,16570,0.13633071816535908,0.8587205793602897,0.004948702474351237
2004,IOWA,STORY,23296,537,20819,44652,0.5217235510167517,0.4662501119770671,0.012026337006181134
2004,IOWA,TAMA,4487,58,4456,9001,0.4985001666481502,0.49505610487723584,0.006443728474613932
2004,IOWA,TAYLOR,1252,30,1908,3190,0.3924764890282132,0.5981191222570533,0.009404388714733543
2004,IOWA,UNION,2747,66,3165,5978,0.4595182335229174,0.5294412847106056,0.011040481766477083
2004,IOWA,VAN BUREN,1568,57,2211,3836,0.40875912408759124,0.5763816475495308,0.014859228362877997
2004,IOWA,WAPELLO,9125,179,7403,16707,0.5461782486382953,0.44310767941581375,0.010714071945890944
2004,IOWA,WARREN,10730,163,12160,23053,0.465449182319004,0.5274801544267558,0.007070663254240229
2004,IOWA,WASHINGTON,4595,116,5977,10688,0.42992140718562877,0.5592252994011976,0.010853293413173653
2004,IOWA,WAYNE,1379,21,1733,3133,0.44015320778806255,0.5531439514842005,0.006702840727736993
2004,IOWA,WEBSTER,9561,111,8959,18631,0.5131769631259728,0.480865224625624,0.005957812248403199
2004,IOWA,WINNEBAGO,2707,70,3175,5952,0.45480510752688175,0.5334341397849462,0.011760752688172043
2004,IOWA,WINNESHIEK,5354,106,5324,10784,0.49647626112759646,0.49369436201780414,0.009829376854599406
2004,IOWA,WOODBURY,21455,289,22451,44195,0.48546215635252854,0.5079986423803597,0.006539201267111664
2004,IOWA,WORTH,2286,42,1795,4123,0.554450642735872,0.43536260004850835,0.010186757215619695
2004,IOWA,WRIGHT,2930,42,3631,6603,0.44373769498712706,0.5499015598970165,0.006360745115856429
2004,KANSAS,ALLEN,1922,84,3867,5873,0.32726034394687553,0.658436914694364,0.014302741358760428
2004,KANSAS,ANDERSON,1295,68,2500,3863,0.3352316852187419,0.6471654154801968,0.01760289930106135
2004,KANSAS,ATCHISON,3120,118,3880,7118,0.43832537229558866,0.54509693734195,0.016577690362461366
2004,KANSAS,BARBER,588,33,1782,2403,0.24469413233458176,0.7415730337078652,0.01373283395755306
2004,KANSAS,BARTON,2874,166,8666,11706,0.24551512045105076,0.7403041175465573,0.014180762002391935
2004,KANSAS,BOURBON,2216,98,4372,6686,0.3314388274005384,0.6539036793299432,0.014657493269518396
2004,KANSAS,BROWN,1268,58,3092,4418,0.2870076957899502,0.6998641919420552,0.013128112267994568
2004,KANSAS,BUTLER,7495,347,18438,26280,0.2851978691019787,0.7015981735159817,0.013203957382039574
2004,KANSAS,CHASE,418,28,1055,1501,0.27848101265822783,0.7028647568287808,0.018654230512991338
2004,KANSAS,CHAUTAUQUA,404,27,1529,1960,0.20612244897959184,0.7801020408163265,0.013775510204081633
2004,KANSAS,CHEROKEE,3726,104,6083,9913,0.37587006960556846,0.6136386563098961,0.010491274084535459
2004,KANSAS,CHEYENNE,320,19,1353,1692,0.18912529550827423,0.799645390070922,0.011229314420803783
2004,KANSAS,CLARK,257,20,1014,1291,0.19907048799380325,0.7854376452362509,0.015491866769945779
2004,KANSAS,CLAY,793,43,3174,4010,0.19775561097256858,0.7915211970074812,0.010723192019950124
2004,KANSAS,CLOUD,1210,72,3221,4503,0.2687097490561848,0.7153009105041084,0.015989340439706862
2004,KANSAS,COFFEY,1093,56,3259,4408,0.24795825771324864,0.7393375680580763,0.012704174228675136
2004,KANSAS,COMANCHE,200,11,770,981,0.2038735983690112,0.7849133537206932,0.011213047910295617
2004,KANSAS,COWLEY,4818,222,9407,14447,0.3334948432200457,0.6511386447013221,0.015366512078632242
2004,KANSAS,CRAWFORD,7617,284,8626,16527,0.46088219277545833,0.5219338052883161,0.01718400193622557
2004,KANSAS,DECATUR,355,30,1355,1740,0.20402298850574713,0.7787356321839081,0.017241379310344827
2004,KANSAS,DICKINSON,2364,132,6295,8791,0.26891138664543285,0.7160732567398476,0.0150153566147196
2004,KANSAS,DONIPHAN,1065,47,2491,3603,0.29558701082431305,0.691368304190952,0.013044684984734944
2004,KANSAS,DOUGLAS,28634,933,20544,50111,0.5714114665442717,0.40996986689549203,0.018618666560236277
2004,KANSAS,EDWARDS,386,26,1084,1496,0.2580213903743315,0.7245989304812834,0.017379679144385027
2004,KANSAS,ELK,369,27,1119,1515,0.24356435643564356,0.7386138613861386,0.01782178217821782
2004,KANSAS,ELLIS,4033,263,7891,12187,0.33092639698038895,0.6474932304915073,0.021580372528103717
2004,KANSAS,ELLSWORTH,801,42,2259,3102,0.25822050290135395,0.7282398452611218,0.013539651837524178
2004,KANSAS,FINNEY,2351,103,7479,9933,0.2366857948253297,0.7529447296889157,0.010369475485754556
2004,KANSAS,FORD,2286,98,6632,9016,0.2535492457852706,0.735581188997338,0.010869565217391304
2004,KANSAS,FRANKLIN,3921,164,7391,11476,0.34166957127919134,0.6440397350993378,0.014290693621470896
2004,KANSAS,GEARY,2531,94,4703,7328,0.34538755458515286,0.6417849344978166,0.012827510917030568
2004,KANSAS,GOVE,247,24,1196,1467,0.1683708248125426,0.8152692569870484,0.016359918200409
2004,KANSAS,GRAHAM,334,24,1082,1440,0.23194444444444445,0.7513888888888889,0.016666666666666666
2004,KANSAS,GRANT,561,28,2169,2758,0.2034082668600435,0.7864394488759971,0.01015228426395939
2004,KANSAS,GRAY,408,21,1816,2245,0.18173719376391984,0.8089086859688196,0.009354120267260579
2004,KANSAS,GREELEY,138,13,584,735,0.18775510204081633,0.7945578231292517,0.017687074829931974
2004,KANSAS,GREENWOOD,911,51,2282,3244,0.280826140567201,0.7034525277435265,0.015721331689272502
2004,KANSAS,HAMILTON,229,13,888,1130,0.20265486725663717,0.7858407079646018,0.011504424778761062
2004,KANSAS,HARPER,727,49,2154,2930,0.24812286689419796,0.7351535836177474,0.016723549488054608
2004,KANSAS,HARVEY,5331,245,9534,15110,0.3528127068166777,0.6309728656518862,0.016214427531436135
2004,KANSAS,HASKELL,227,16,1356,1599,0.14196372732958099,0.8480300187617261,0.010006253908692933
2004,KANSAS,HODGEMAN,223,7,953,1183,0.18850380388841928,0.8055790363482671,0.005917159763313609
2004,KANSAS,JACKSON,2064,94,3730,5888,0.35054347826086957,0.6334918478260869,0.01596467391304348
2004,KANSAS,JEFFERSON,3253,132,5408,8793,0.3699533720004549,0.6150346866825884,0.01501194131695667
2004,KANSAS,JEWELL,385,35,1495,1915,0.2010443864229765,0.7806788511749347,0.018276762402088774
2004,KANSAS,JOHNSON,97866,2718,158103,258687,0.3783181992137216,0.6111748947569843,0.01050690602929409
2004,KANSAS,KEARNY,272,6,1177,1455,0.18694158075601375,0.8089347079037801,0.004123711340206186
2004,KANSAS,KINGMAN,904,59,2801,3764,0.24017003188097769,0.7441551540913921,0.01567481402763018
2004,KANSAS,KIOWA,256,34,1275,1565,0.1635782747603834,0.8146964856230032,0.021725239616613417
2004,KANSAS,LABETTE,3615,124,5400,9139,0.3955575008206587,0.5908742750848014,0.013568224094539885
2004,KANSAS,LANE,181,10,823,1014,0.17850098619329388,0.8116370808678501,0.009861932938856016
2004,KANSAS,LEAVENWORTH,11039,343,15949,27331,0.4039003329552523,0.5835498152281292,0.012549851816618492
2004,KANSAS,LINCOLN,391,41,1368,1800,0.21722222222222223,0.76,0.02277777777777778
2004,KANSAS,LINN,1631,62,3048,4741,0.34402024889263866,0.6429023412782113,0.013077409829149969
2004,KANSAS,LOGAN,248,20,1255,1523,0.16283650689428758,0.8240315167432699,0.013131976362442548
2004,KANSAS,LYON,5234,255,7951,13440,0.3894345238095238,0.5915922619047619,0.018973214285714284
2004,KANSAS,MARION,1536,107,4516,6159,0.24939113492450074,0.7332359149212534,0.01737295015424582
2004,KANSAS,MARSHALL,1789,58,3261,5108,0.3502349256068912,0.6384103367267032,0.011354737666405637
2004,KANSAS,MCPHERSON,3589,183,9595,13367,0.2684970449614723,0.7178125233784693,0.013690431660058353
2004,KANSAS,MEADE,356,17,1748,2121,0.16784535596416786,0.8241395568128241,0.008015087223008015
2004,KANSAS,MIAMI,4838,165,9013,14016,0.3451769406392694,0.643050799086758,0.011772260273972603
2004,KANSAS,MITCHELL,693,47,2609,3349,0.20692744102717228,0.7790385189608838,0.014034040011943864
2004,KANSAS,MONTGOMERY,4338,180,9598,14116,0.30731085293284216,0.679937659393596,0.012751487673561915
2004,KANSAS,MORRIS,931,44,1961,2936,0.3170980926430518,0.6679155313351499,0.014986376021798364
2004,KANSAS,MORTON,276,13,1287,1576,0.1751269035532995,0.8166243654822335,0.008248730964467006
2004,KANSAS,NEMAHA,1355,81,4027,5463,0.24803221673073403,0.7371407651473549,0.014827018121911038
2004,KANSAS,NEOSHO,2424,102,4705,7231,0.3352233439358318,0.6506707232747891,0.014105932789379062
2004,KANSAS,NESS,382,29,1407,1818,0.21012101210121012,0.7739273927392739,0.01595159515951595
2004,KANSAS,NORTON,473,34,2092,2599,0.1819930742593305,0.8049249711427472,0.013081954597922277
2004,KANSAS,OSAGE,2537,126,4800,7463,0.3399437223636607,0.6431729867345571,0.016883290901782127
2004,KANSAS,OSBORNE,454,34,1587,2075,0.21879518072289156,0.7648192771084338,0.0163855421686747
2004,KANSAS,OTTAWA,595,43,2333,2971,0.2002692696061932,0.7852574890609223,0.014473241332884551
2004,KANSAS,PAWNEE,773,43,2172,2988,0.25870147255689424,0.7269076305220884,0.014390896921017403
2004,KANSAS,PHILLIPS,557,34,2256,2847,0.19564453811029153,0.7924130663856691,0.01194239550403934
2004,KANSAS,POTTAWATOMIE,2176,321,6326,8823,0.2466281310211946,0.7169896860478295,0.03638218293097586
2004,KANSAS,PRATT,1200,63,3121,4384,0.2737226277372263,0.7119069343065694,0.01437043795620438
2004,KANSAS,RAWLINS,289,17,1414,1720,0.1680232558139535,0.8220930232558139,0.009883720930232558
2004,KANSAS,RENO,9114,462,17748,27324,0.33355292050944224,0.6495388669301713,0.016908212560386472
2004,KANSAS,REPUBLIC,607,44,2238,2889,0.21010730356524748,0.77466251298027,0.01523018345448252
2004,KANSAS,RICE,1130,64,3182,4376,0.25822669104204754,0.7271480804387569,0.014625228519195612
2004,KANSAS,RILEY,7908,331,12672,20911,0.3781741667065181,0.6059968437664387,0.01582898952704318
2004,KANSAS,ROOKS,534,55,2121,2710,0.1970479704797048,0.7826568265682656,0.02029520295202952
2004,KANSAS,RUSH,517,46,1226,1789,0.2889882615986585,0.6852990497484628,0.025712688652878703
2004,KANSAS,RUSSELL,810,44,2671,3525,0.2297872340425532,0.7577304964539007,0.0124822695035461
2004,KANSAS,SALINE,7524,406,15111,23041,0.32654832689553404,0.6558309101167484,0.017620762987717548
2004,KANSAS,SCOTT,347,28,1924,2299,0.1509351892127012,0.8368856024358416,0.012179208351457155
2004,KANSAS,SEDGWICK,64839,2459,110381,177679,0.36492213486118225,0.6212383005307324,0.013839564608085367
2004,KANSAS,SEWARD,1122,45,4272,5439,0.20628792057363485,0.785438499724214,0.00827357970215113
2004,KANSAS,SHAWNEE,36264,1125,44188,81577,0.4445370631427976,0.5416722850803535,0.013790651776848867
2004,KANSAS,SHERIDAN,239,23,1144,1406,0.16998577524893316,0.813655761024182,0.016358463726884778
2004,KANSAS,SHERMAN,632,42,2088,2762,0.22881969587255613,0.7559739319333816,0.015206372194062274
2004,KANSAS,SMITH,540,27,1803,2370,0.22784810126582278,0.760759493670886,0.01139240506329114
2004,KANSAS,STAFFORD,506,31,1649,2186,0.23147301006404392,0.7543458371454712,0.014181152790484904
2004,KANSAS,STANTON,165,5,796,966,0.17080745341614906,0.8240165631469979,0.005175983436853002
2004,KANSAS,STEVENS,310,19,1936,2265,0.1368653421633554,0.8547461368653422,0.008388520971302429
2004,KANSAS,SUMNER,3217,179,7092,10488,0.30673150266971777,0.6762013729977117,0.017067124332570557
2004,KANSAS,THOMAS,816,47,3007,3870,0.21085271317829457,0.7770025839793282,0.01214470284237726
2004,KANSAS,TREGO,434,27,1225,1686,0.25741399762752076,0.7265717674970344,0.01601423487544484
2004,KANSAS,WABAUNSEE,1001,72,2531,3604,0.27774694783573806,0.7022752497225305,0.01997780244173141
2004,KANSAS,WALLACE,112,22,742,876,0.1278538812785388,0.8470319634703196,0.02511415525114155
2004,KANSAS,WASHINGTON,643,49,2498,3190,0.20156739811912225,0.7830721003134796,0.015360501567398118
2004,KANSAS,WICHITA,183,10,869,1062,0.17231638418079095,0.8182674199623352,0.009416195856873822
2004,KANSAS,WILSON,1060,75,3263,4398,0.24101864483856297,0.7419281491587085,0.017053206002728513
2004,KANSAS,WOODSON,530,29,1204,1763,0.30062393647192287,0.6829268292682927,0.016449234259784458
2004,KANSAS,WYANDOTTE,34923,559,17919,53401,0.6539765172936837,0.3355555139416865,0.010467968764629876
2004,KENTUCKY,ADAIR,1764,55,5628,7447,0.23687390895662683,0.7557405666711428,0.007385524372230428
2004,KENTUCKY,ALLEN,1923,38,5202,7163,0.26846293452464054,0.7262320256875611,0.005305039787798408
2004,KENTUCKY,ANDERSON,3141,87,6363,9591,0.3274945261182359,0.663434469815452,0.009071004066312168
2004,KENTUCKY,BALLARD,1759,29,2389,4177,0.4211156332295906,0.5719415848695236,0.006942781900885803
2004,KENTUCKY,BARREN,5216,102,10822,16140,0.3231722428748451,0.6705080545229244,0.006319702602230483
2004,KENTUCKY,BATH,2608,42,2269,4919,0.5301890628176459,0.4612726163854442,0.008538320796909941
2004,KENTUCKY,BELL,4210,70,6722,11002,0.3826576986002545,0.6109798218505726,0.006362479549172878
2004,KENTUCKY,BOONE,12391,362,32329,45082,0.2748547091965751,0.7171154784614702,0.00802981234195466
2004,KENTUCKY,BOURBON,3198,66,4953,8217,0.389193136181088,0.6027747353048558,0.008032128514056224
2004,KENTUCKY,BOYD,10132,144,11501,21777,0.4652615144418423,0.5281260045001607,0.006612481057996969
2004,KENTUCKY,BOYLE,4646,80,7764,12490,0.3719775820656525,0.621617293835068,0.006405124099279423
2004,KENTUCKY,BRACKEN,1213,34,2363,3610,0.33601108033240995,0.6545706371191136,0.009418282548476454
2004,KENTUCKY,BREATHITT,3327,75,2542,5944,0.5597240915208613,0.4276581426648721,0.012617765814266487
2004,KENTUCKY,BRECKINRIDGE,2884,56,5580,8520,0.33849765258215964,0.6549295774647887,0.006572769953051643
2004,KENTUCKY,BULLITT,9043,151,19433,28627,0.3158905927970098,0.6788346665735145,0.0052747406294756695
2004,KENTUCKY,BUTLER,1436,33,4109,5578,0.25743994263176767,0.7366439584080315,0.0059160989602007885
2004,KENTUCKY,CALDWELL,2245,38,4066,6349,0.35359899196723893,0.6404158135139392,0.0059851945188218614
2004,KENTUCKY,CALLOWAY,5728,124,9293,15145,0.37821063057114557,0.6136018487949818,0.008187520633872566
2004,KENTUCKY,CAMPBELL,14253,382,25540,40175,0.35477286869943997,0.635718730553827,0.009508400746733044
2004,KENTUCKY,CARLISLE,1102,9,1734,2845,0.3873462214411248,0.6094903339191564,0.003163444639718805
2004,KENTUCKY,CARROLL,1688,34,2175,3897,0.4331537079804978,0.5581216320246344,0.008724659994867847
2004,KENTUCKY,CARTER,5577,118,5422,11117,0.5016641180174507,0.4877215076009715,0.010614374381577764
2004,KENTUCKY,CASEY,1174,38,5109,6321,0.18573010599588674,0.8082581869957285,0.006011707008384749
2004,KENTUCKY,CHRISTIAN,6970,110,13935,21015,0.33166785629312395,0.6630977872947894,0.005234356412086605
2004,KENTUCKY,CLARK,5661,116,9540,15317,0.36958934517203107,0.6228373702422145,0.007573284585754391
2004,KENTUCKY,CLAY,1901,60,5726,7687,0.2473006374398335,0.7448939768440224,0.007805385716144139
2004,KENTUCKY,CLINTON,952,31,3369,4352,0.21875,0.7741268382352942,0.007123161764705882
2004,KENTUCKY,CRITTENDEN,1438,26,2726,4190,0.3431980906921241,0.6505966587112172,0.006205250596658711
2004,KENTUCKY,CUMBERLAND,848,35,2356,3239,0.2618092003704847,0.7273849953689411,0.010805804260574252
2004,KENTUCKY,DAVIESS,15788,323,25372,41483,0.3805896391292819,0.6116240387628668,0.007786322107851409
2004,KENTUCKY,EDMONSON,1856,30,3595,5481,0.3386243386243386,0.6559022076263455,0.005473453749315818
2004,KENTUCKY,ELLIOTT,2064,22,871,2957,0.6980047345282381,0.294555292526209,0.0074399729455529254
2004,KENTUCKY,ESTILL,1907,35,3633,5575,0.3420627802690583,0.6516591928251121,0.006278026905829596
2004,KENTUCKY,FAYETTE,57994,1176,66406,125576,0.46182391539784673,0.5288112378161433,0.009364846786010066
2004,KENTUCKY,FLEMING,2406,48,3749,6203,0.38787683379010157,0.6043849750120909,0.007738191197807513
2004,KENTUCKY,FLOYD,11132,141,6612,17885,0.6224210232038021,0.3696952753704221,0.00788370142577579
2004,KENTUCKY,FRANKLIN,11620,232,12281,24133,0.4814983632370613,0.5088882443127668,0.009613392450171964
2004,KENTUCKY,FULTON,1340,23,1527,2890,0.46366782006920415,0.5283737024221453,0.00795847750865052
2004,KENTUCKY,GALLATIN,1188,16,1869,3073,0.38659290595509277,0.6082004555808656,0.005206638464041653
2004,KENTUCKY,GARRARD,1841,33,4784,6658,0.27650946230099127,0.7185340943226194,0.0049564433763893065
2004,KENTUCKY,GRANT,2818,55,5951,8824,0.31935630099728013,0.6744106980961015,0.006233000906618314
2004,KENTUCKY,GRAVES,6206,120,9903,16229,0.3824018731899686,0.6102039558814468,0.007394170928584632
2004,KENTUCKY,GRAYSON,2905,68,7170,10143,0.2864044168391994,0.7068914522330672,0.006704130927733412
2004,KENTUCKY,GREEN,1312,28,3866,5206,0.2520169035728006,0.742604686899731,0.005378409527468306
2004,KENTUCKY,GREENUP,7630,109,8696,16435,0.46425311834499544,0.5291146942500761,0.006632187404928506
2004,KENTUCKY,HANCOCK,1709,34,2286,4029,0.424174733184413,0.5673864482501861,0.008438818565400843
2004,KENTUCKY,HARDIN,11507,307,24627,36441,0.31577069784034467,0.6758047254466123,0.008424576713043001
2004,KENTUCKY,HARLAN,4332,79,6659,11070,0.3913279132791328,0.601535682023487,0.007136404697380307
2004,KENTUCKY,HARRISON,2807,69,4855,7731,0.36308368904410815,0.6279912042426594,0.00892510671323244
2004,KENTUCKY,HART,2470,45,4269,6784,0.36409198113207547,0.6292747641509434,0.006633254716981132
2004,KENTUCKY,HENDERSON,8101,133,10467,18701,0.43318539115555316,0.5597026896957382,0.007111919148708625
2004,KENTUCKY,HENRY,2366,39,4094,6499,0.3640560086167103,0.629943068164333,0.0060009232189567625
2004,KENTUCKY,HICKMAN,926,21,1395,2342,0.39538855678906915,0.5956447480785654,0.008966695132365499
2004,KENTUCKY,HOPKINS,6420,109,12314,18843,0.34071007801305525,0.6535052804755082,0.0057846415114366076
2004,KENTUCKY,JACKSON,769,40,4369,5178,0.1485129393588258,0.8437620702974121,0.00772499034376207
2004,KENTUCKY,JEFFERSON,170158,2626,164566,337350,0.504396027864236,0.4878197717504076,0.007784200385356455
2004,KENTUCKY,JESSAMINE,5476,132,12972,18580,0.29472551130247576,0.6981700753498385,0.007104413347685684
2004,KENTUCKY,JOHNSON,3288,76,5940,9304,0.35339638865004297,0.6384350816852966,0.00816852966466036
2004,KENTUCKY,KENTON,22834,625,43664,67123,0.34018145792053395,0.6505072776842513,0.009311264395214755
2004,KENTUCKY,KNOTT,4685,61,2648,7394,0.633621855558561,0.35812821206383555,0.008249932377603462
2004,KENTUCKY,KNOX,3822,98,8108,12028,0.3177585633521782,0.674093781177253,0.008147655470568673
2004,KENTUCKY,LARUE,1823,34,4111,5968,0.3054624664879357,0.6888404825737265,0.005697050938337802
2004,KENTUCKY,LAUREL,5297,148,16819,22264,0.23791771469637082,0.7554347826086957,0.006647502694933525
2004,KENTUCKY,LAWRENCE,2705,53,3755,6513,0.41532319975433746,0.57653922923384,0.00813757101182251
2004,KENTUCKY,LEE,878,24,2018,2920,0.30068493150684933,0.6910958904109589,0.00821917808219178
2004,KENTUCKY,LESLIE,1266,37,3661,4964,0.2550362610797744,0.7375100725221595,0.007453666398066076
2004,KENTUCKY,LETCHER,4192,72,4801,9065,0.4624379481522339,0.529619415333701,0.007942636514065085
2004,KENTUCKY,LEWIS,1667,39,3778,5484,0.3039752005835157,0.6889132020423049,0.007111597374179431
2004,KENTUCKY,LINCOLN,2796,71,5996,8863,0.3154688028884125,0.6765203655647072,0.008010831546880289
2004,KENTUCKY,LIVINGSTON,2007,24,2675,4706,0.426476838079048,0.5684232894177645,0.005099872503187421
2004,KENTUCKY,LOGAN,3768,61,6815,10644,0.35400225479143177,0.6402668169860954,0.005730928222472754
2004,KENTUCKY,LYON,1769,24,2132,3925,0.45070063694267515,0.5431847133757962,0.006114649681528662
2004,KENTUCKY,MADISON,11525,260,18922,30707,0.3753215879115511,0.6162112873286222,0.00846712475982675
2004,KENTUCKY,MAGOFFIN,2843,39,2836,5718,0.4972018188177684,0.4959776145505421,0.006820566631689402
2004,KENTUCKY,MARION,3399,50,3905,7354,0.4621974435681262,0.5310035354908893,0.006799020940984498
2004,KENTUCKY,MARSHALL,6383,89,9049,15521,0.4112492751755686,0.5830165582114555,0.005734166612975968
2004,KENTUCKY,MARTIN,1504,39,2996,4539,0.331350517735184,0.6600572813395021,0.008592200925313946
2004,KENTUCKY,MASON,2644,54,4381,7079,0.37349908179121344,0.618872722135895,0.007628196072891651
2004,KENTUCKY,MCCRACKEN,11361,218,18218,29797,0.3812799946303319,0.6114038326005974,0.007316172769070712
2004,KENTUCKY,MCCREARY,1530,42,4121,5693,0.26875109783945195,0.7238714210433866,0.007377481117161426
2004,KENTUCKY,MCLEAN,1823,28,2584,4435,0.41104847801578354,0.5826381059751973,0.006313416009019166
2004,KENTUCKY,MEADE,3724,75,7152,10951,0.340060268468633,0.6530910419139805,0.00684868961738654
2004,KENTUCKY,MENIFEE,1284,29,1215,2528,0.5079113924050633,0.48061708860759494,0.011471518987341773
2004,KENTUCKY,MERCER,3224,59,6745,10028,0.32149980055843635,0.6726166733147187,0.005883526126844834
2004,KENTUCKY,METCALFE,1472,40,2645,4157,0.3541015155159971,0.6362761606928073,0.009622323791195573
2004,KENTUCKY,MONROE,1158,28,4657,5843,0.1981858634263221,0.7970220776998117,0.004792058873866164
2004,KENTUCKY,MONTGOMERY,4506,77,5647,10230,0.4404692082111437,0.5520039100684262,0.007526881720430108
2004,KENTUCKY,MORGAN,2532,58,2682,5272,0.4802731411229135,0.5087253414264037,0.011001517450682853
2004,KENTUCKY,MUHLENBERG,6636,94,6749,13479,0.49232138882706433,0.5007048000593516,0.006973811113584093
2004,KENTUCKY,NELSON,6524,159,10161,16844,0.3873189266207552,0.6032415103300879,0.00943956304915697
2004,KENTUCKY,NICHOLAS,1332,27,1700,3059,0.435436417129781,0.5557371690094802,0.008826413860738803
2004,KENTUCKY,OHIO,3627,90,6311,10028,0.36168727562824093,0.6293378540087754,0.008974870362983646
2004,KENTUCKY,OLDHAM,8080,251,18801,27132,0.29780333185905944,0.6929455992923486,0.009251068848592068
2004,KENTUCKY,OWEN,1615,42,3084,4741,0.340645433452858,0.6504956760177177,0.008858890529424172
2004,KENTUCKY,OWSLEY,430,11,1558,1999,0.21510755377688845,0.7793896948474237,0.005502751375687844
2004,KENTUCKY,PENDLETON,1940,40,4045,6025,0.3219917012448133,0.6713692946058091,0.006639004149377593
2004,KENTUCKY,PERRY,5400,68,6187,11655,0.46332046332046334,0.5308451308451309,0.005834405834405834
2004,KENTUCKY,PIKE,14002,157,12611,26770,0.523048188270452,0.4710870377288009,0.005864774000747105
2004,KENTUCKY,POWELL,2249,24,2687,4960,0.4534274193548387,0.541733870967742,0.004838709677419355
2004,KENTUCKY,PULASKI,5829,152,19535,25516,0.22844489731932904,0.7655980561216491,0.00595704655902179
2004,KENTUCKY,ROBERTSON,413,7,670,1090,0.37889908256880733,0.6146788990825688,0.006422018348623854
2004,KENTUCKY,ROCKCASTLE,1320,42,4804,6166,0.21407719753486865,0.7791112552708401,0.006811547194291274
2004,KENTUCKY,ROWAN,4556,87,4063,8706,0.5233172524695612,0.46668963932919827,0.009993108201240523
2004,KENTUCKY,RUSSELL,1772,40,6009,7821,0.2265694923922772,0.7683160721135405,0.005114435494182329
2004,KENTUCKY,SCOTT,6325,125,10600,17050,0.3709677419354839,0.6217008797653959,0.007331378299120235
2004,KENTUCKY,SHELBY,5277,127,10909,16313,0.32348433764482315,0.6687304603690308,0.007785201986146018
2004,KENTUCKY,SIMPSON,2730,40,4273,7043,0.3876189123952861,0.6067016896209002,0.0056793979838137155
2004,KENTUCKY,SPENCER,1970,36,4816,6822,0.2887716212254471,0.7059513339196717,0.005277044854881266
2004,KENTUCKY,TAYLOR,2979,69,7247,10295,0.28936376881981546,0.7039339485186984,0.006702282661486159
2004,KENTUCKY,TODD,1491,21,3242,4754,0.3136306268405553,0.6819520403870425,0.004417332772402188
2004,KENTUCKY,TRIGG,2046,42,4023,6111,0.33480608738340695,0.658321060382916,0.006872852233676976
2004,KENTUCKY,TRIMBLE,1428,30,2332,3790,0.37678100263852243,0.6153034300791557,0.0079155672823219
2004,KENTUCKY,UNION,2398,45,3534,5977,0.40120461770118787,0.5912665216663878,0.0075288606324242936
2004,KENTUCKY,WARREN,14326,285,25100,39711,0.36075646546296997,0.6320666817758304,0.007176852761199668
2004,KENTUCKY,WASHINGTON,1724,33,3479,5236,0.3292589763177998,0.6644385026737968,0.0063025210084033615
2004,KENTUCKY,WAYNE,2616,42,5027,7685,0.34040338321405333,0.654131424853611,0.005465191932335719
2004,KENTUCKY,WEBSTER,2304,36,3207,5547,0.4153596538669551,0.5781503515413737,0.006489994591671174
2004,KENTUCKY,WHITLEY,3985,85,9559,13629,0.2923912245946144,0.7013720742534302,0.006236701151955389
2004,KENTUCKY,WOLFE,1744,26,1385,3155,0.5527733755942947,0.43898573692551507,0.008240887480190175
2004,KENTUCKY,WOODFORD,4480,85,6937,11502,0.38949747869935664,0.6031125021735351,0.007390019127108329
2004,LOUISIANA,ACADIA,8937,210,16083,25230,0.35422116527942926,0.6374554102259216,0.008323424494649227
2004,LOUISIANA,ALLEN,3791,193,5140,9124,0.4154975887768523,0.5633494081543183,0.02115300306882946
2004,LOUISIANA,ASCENSION,13955,484,24661,39100,0.35690537084398977,0.6307161125319694,0.01237851662404092
2004,LOUISIANA,ASSUMPTION,5585,184,4966,10735,0.52026082906381,0.4625989753143922,0.017140195621797857
2004,LOUISIANA,AVOYELLES,6976,247,8302,15525,0.44933977455716584,0.5347504025764895,0.015909822866344604
2004,LOUISIANA,BEAUREGARD,3666,145,9470,13281,0.2760334312175288,0.7130487162111286,0.010917852571342519
2004,LOUISIANA,BIENVILLE,3399,146,3612,7157,0.4749196590750314,0.5046807321503424,0.02039960877462624
2004,LOUISIANA,BOSSIER,12317,348,30040,42705,0.2884205596534364,0.7034305116496897,0.008148928696873902
2004,LOUISIANA,CADDO,51739,564,54292,106595,0.4853792391763216,0.509329705896149,0.005291054927529434
2004,LOUISIANA,CALCASIEU,32864,759,46075,79698,0.41235664633993324,0.5781199026324374,0.0095234510276293
2004,LOUISIANA,CALDWELL,1384,60,3308,4752,0.29124579124579125,0.6961279461279462,0.012626262626262626
2004,LOUISIANA,CAMERON,1367,83,3190,4640,0.2946120689655172,0.6875,0.01788793103448276
2004,LOUISIANA,CATAHOULA,1673,62,3219,4954,0.3377069035123133,0.6497779572062979,0.012515139281388777
2004,LOUISIANA,CLAIBORNE,2854,72,3704,6630,0.43046757164404226,0.5586726998491705,0.01085972850678733
2004,LOUISIANA,CONCORDIA,3446,107,5427,8980,0.38374164810690425,0.6043429844097995,0.011915367483296213
2004,LOUISIANA,DE SOTO,5026,99,6211,11336,0.4433662667607622,0.5479004940014114,0.008733239237826394
2004,LOUISIANA,EAST BATON ROUGE,82298,1401,99943,183642,0.44814367083782575,0.5442273553980026,0.007628973764171595
2004,LOUISIANA,EAST CARROLL,1980,58,1357,3395,0.5832106038291606,0.3997054491899853,0.017083946980854196
2004,LOUISIANA,EAST FELICIANA,4091,89,5021,9201,0.4446255841756331,0.5457015541788935,0.009672861645473319
2004,LOUISIANA,EVANGELINE,5757,273,7949,13979,0.4118320337649331,0.5686386722941555,0.019529293940911366
2004,LOUISIANA,FRANKLIN,2828,134,6141,9103,0.3106668131385258,0.6746127650225201,0.014720421838954192
2004,LOUISIANA,GRANT,1977,103,5911,7991,0.24740332874483795,0.7397071705668877,0.012889500688274309
2004,LOUISIANA,IBERIA,12426,427,19420,32273,0.3850277321600099,0.6017413937347008,0.013230874105289251
2004,LOUISIANA,IBERVILLE,8259,235,6333,14827,0.5570243474742025,0.4271261887097862,0.01584946381601133
2004,LOUISIANA,JACKSON,2525,84,5038,7647,0.33019484765267426,0.658820452465019,0.010984699882306787
2004,LOUISIANA,JEFFERSON,72136,1645,117882,191663,0.376368939231881,0.6150482878802899,0.008582772887829158
2004,LOUISIANA,JEFFERSON DAVIS,4745,207,8055,13007,0.36480356730991004,0.6192819251172446,0.01591450757284539
2004,LOUISIANA,LA SALLE,1155,68,5015,6238,0.18515549855722988,0.8039435716575826,0.010900929785187561
2004,LOUISIANA,LAFAYETTE,31210,981,57732,89923,0.3470747194822237,0.6420159469768579,0.010909333540918342
2004,LOUISIANA,LAFOURCHE,14417,713,22734,37864,0.380757447707585,0.6004120008451299,0.01883055144728502
2004,LOUISIANA,LINCOLN,7242,185,10791,18218,0.39751893731474364,0.5923262707212646,0.010154791963991657
2004,LOUISIANA,LIVINGSTON,9895,382,33976,44253,0.2236006598422706,0.767767157028902,0.008632183128827424
2004,LOUISIANA,MADISON,2334,48,2291,4673,0.49946501176974106,0.49026321420928737,0.010271774020971538
2004,LOUISIANA,MOREHOUSE,5336,164,7471,12971,0.4113792305913191,0.5759771798627707,0.012643589545910107
2004,LOUISIANA,NATCHITOCHES,7398,307,9261,16966,0.43604856772368267,0.5458564187197925,0.018095013556524816
2004,LOUISIANA,ORLEANS,152610,1646,42847,197103,0.7742652318838373,0.21738380440683297,0.00835096370932964
2004,LOUISIANA,OUACHITA,22016,678,41750,64444,0.34162994227546395,0.6478492955123828,0.010520762212153187
2004,LOUISIANA,PLAQUEMINES,4181,106,7866,12153,0.34403028058915497,0.6472475931868674,0.008722126223977618
2004,LOUISIANA,POINTE COUPEE,5712,130,5429,11271,0.5067873303167421,0.48167864430840207,0.011534025374855825
2004,LOUISIANA,RAPIDES,18904,673,34492,54069,0.34962732804379587,0.6379256135678485,0.012447058388355619
2004,LOUISIANA,RED RIVER,2140,70,2507,4717,0.45367818528725884,0.5314818740725037,0.014839940640237439
2004,LOUISIANA,RICHLAND,3082,112,5471,8665,0.3556837853433353,0.6313906520484709,0.012925562608193884
2004,LOUISIANA,SABINE,2743,122,6711,9576,0.2864452798663325,0.7008145363408521,0.012740183792815371
2004,LOUISIANA,ST. BERNARD,9956,285,19597,29838,0.33366847643943964,0.6567799450365306,0.00955157852402976
2004,LOUISIANA,ST. CHARLES,8856,234,14747,23837,0.3715232621554726,0.6186600662835088,0.009816671561018585
2004,LOUISIANA,ST. HELENA,3173,100,2235,5508,0.5760711692084242,0.4057734204793028,0.01815541031227306
2004,LOUISIANA,ST. JAMES,6407,156,4545,11108,0.5767915016204537,0.409164566078502,0.014043932301044292
2004,LOUISIANA,ST. JOHN THE BAPTIST,10305,273,9039,19617,0.5253096803792628,0.4607738186267013,0.013916500994035786
2004,LOUISIANA,ST. LANDRY,18166,279,18315,36760,0.4941784548422198,0.49823177366702937,0.007589771490750816
2004,LOUISIANA,ST. MARTIN,10321,408,12095,22824,0.4521994391868209,0.5299246407290571,0.017875920084121977
2004,LOUISIANA,ST. MARY,9547,270,12877,22694,0.42068388120207983,0.5674187009782321,0.011897417819688023
2004,LOUISIANA,ST. TAMMANY,24665,788,75139,100592,0.2451984253220932,0.7469679497375536,0.00783362494035311
2004,LOUISIANA,TANGIPAHOA,15345,609,26181,42135,0.364186543253827,0.6213599145603418,0.014453542185831256
2004,LOUISIANA,TENSAS,1469,41,1453,2963,0.49578130273371585,0.4903813702328721,0.013837327033412082
2004,LOUISIANA,TERREBONNE,13684,532,26358,40574,0.33726031448710997,0.6496278404889831,0.013111845023906936
2004,LOUISIANA,UNION,3089,172,7457,10718,0.2882067549916029,0.695745474902034,0.016047770106363126
2004,LOUISIANA,VERMILION,9085,398,15069,24552,0.37003095470837405,0.6137585532746823,0.01621049201694363
2004,LOUISIANA,VERNON,4035,162,11032,15229,0.264955020027579,0.7244073806553286,0.01063759931709239
2004,LOUISIANA,WASHINGTON,6554,281,11006,17841,0.36735608990527435,0.6168936718793789,0.015750238215346674
2004,LOUISIANA,WEBSTER,6833,546,11070,18449,0.3703723779066616,0.600032522087918,0.029595100005420347
2004,LOUISIANA,WEST BATON ROUGE,4932,81,5822,10835,0.4551915089986156,0.5373327180433779,0.007475772958006461
2004,LOUISIANA,WEST CARROLL,1231,62,3740,5033,0.24458573415457976,0.7430955692429962,0.012318696602424002
2004,LOUISIANA,WEST FELICIANA,2214,72,2932,5218,0.4243004982752012,0.5619011115369873,0.013798390187811422
2004,LOUISIANA,WINN,2056,85,4366,6507,0.31596741970185954,0.6709697249116336,0.013062855386506839
2004,MAINE,ANDROSCOGGIN,30345,1044,24453,55842,0.5434081873858386,0.43789620715590416,0.018695605458257224
2004,MAINE,AROOSTOOK,18988,569,17152,36709,0.517257348334196,0.46724236563240623,0.015500286033397804
2004,MAINE,CUMBERLAND,76911,2323,56251,135485,0.5676716979739455,0.41518249252684797,0.017145809499206553
2004,MAINE,FRANKLIN,9410,411,7315,17136,0.5491363211951448,0.42687908496732024,0.023984593837535016
2004,MAINE,HANCOCK,17299,645,13810,31754,0.5447817597782957,0.4349058386345027,0.02031240158720161
2004,MAINE,KENNEBEC,33167,1301,28363,62831,0.5278763667616304,0.4514172940109182,0.020706339227451416
2004,MAINE,KNOX,11430,952,9074,21456,0.5327181208053692,0.4229120059656972,0.04436987322893363
2004,MAINE,LINCOLN,10548,384,9676,20608,0.5118400621118012,0.46952639751552794,0.018633540372670808
2004,MAINE,MAINE UOCAVA,0,0,0,0,,,
2004,MAINE,OXFORD,16825,735,14354,31914,0.5271980948799899,0.449771260261954,0.023030644858056025
2004,MAINE,PENOBSCOT,37775,1300,37339,76414,0.4943465857041903,0.4886408249797158,0.01701258931609391
2004,MAINE,PISCATAQUIS,4378,232,5261,9871,0.4435214264005673,0.5329753824333907,0.02350319116604194
2004,MAINE,SAGADAHOC,10341,451,9064,19856,0.5207997582594682,0.4564867042707494,0.022713537469782434
2004,MAINE,SOMERSET,13530,597,12926,27053,0.5001293756699812,0.47780283147894875,0.02206779285107012
2004,MAINE,WALDO,11259,438,10044,21741,0.5178694632261626,0.46198426935283565,0.020146267421001795
2004,MAINE,WASHINGTON,7998,291,8207,16496,0.48484481086323955,0.49751454898157127,0.01764064015518914
2004,MAINE,YORK,53949,1687,45708,101344,0.5323354120618882,0.45101831386169877,0.01664627407641301
2004,MARYLAND,ALLEGANY,10576,299,18980,29855,0.3542455200133981,0.6357394071344833,0.010015072852118573
2004,MARYLAND,ANNE ARUNDEL,103324,3112,133231,239667,0.43111483850509247,0.5559004785806974,0.012984682914210134
2004,MARYLAND,BALTIMORE,182474,4954,166051,353479,0.5162230288079348,0.4697619943476133,0.014014976844451863
2004,MARYLAND,BALTIMORE CITY,175022,2311,36230,213563,0.8195333461320548,0.16964549102606724,0.01082116284187804
2004,MARYLAND,CALVERT,15967,367,23017,39351,0.4057584305354375,0.5849152499301161,0.009326319534446393
2004,MARYLAND,CAROLINE,3810,150,7396,11356,0.3355054596688975,0.6512856639661853,0.013208876364917225
2004,MARYLAND,CARROLL,22974,1100,55275,79349,0.2895310589925519,0.6966061324024247,0.013862808605023378
2004,MARYLAND,CECIL,14680,438,22556,37674,0.38965865052821574,0.5987152943674683,0.011626055104315974
2004,MARYLAND,CHARLES,29354,445,28442,58241,0.5040092031386824,0.48835013135076666,0.0076406655105509865
2004,MARYLAND,DORCHESTER,5411,127,7801,13339,0.4056525976460004,0.5848264487592774,0.009520953594722242
2004,MARYLAND,FREDERICK,39503,1157,59934,100594,0.3926973775771915,0.5958009424021313,0.011501680020677177
2004,MARYLAND,GARRETT,3291,108,9085,12484,0.2636174303107978,0.7277314963152836,0.008651073373918615
2004,MARYLAND,HARFORD,39685,1478,71565,112728,0.35204208359946065,0.6348467106663828,0.013111205734156554
2004,MARYLAND,HOWARD,72257,1829,59724,133810,0.5399970106867947,0.4463343546820118,0.013668634631193484
2004,MARYLAND,KENT,4278,107,4900,9285,0.4607431340872375,0.5277329025309639,0.0115239633817986
2004,MARYLAND,MONTGOMERY,273936,4955,136334,415225,0.6597290625564453,0.32833764826298995,0.011933289180564754
2004,MARYLAND,PRINCE GEORGE'S,260532,2410,55532,318474,0.8180636409879614,0.17436902227497378,0.007567336737064878
2004,MARYLAND,QUEEN ANNE'S,7070,235,14489,21794,0.3244012113425713,0.6648160044048821,0.010782784252546572
2004,MARYLAND,SOMERSET,4034,76,4884,8994,0.4485212363798088,0.543028685790527,0.008450077829664221
2004,MARYLAND,ST. MARY'S,13776,415,23725,37916,0.3633294651334529,0.625725287477582,0.01094524738896508
2004,MARYLAND,TALBOT,7367,209,11288,18864,0.3905322307039864,0.5983884648006785,0.01107930449533503
2004,MARYLAND,WASHINGTON,20387,600,36917,57904,0.35208275766786407,0.6375552638850511,0.01036197844708483
2004,MARYLAND,WICOMICO,15137,368,21998,37503,0.40362104364984136,0.5865664080206917,0.009812548329466975
2004,MARYLAND,WORCESTER,9648,232,15349,25229,0.3824170597328471,0.608387173490824,0.009195766776328829
2004,MASSACHUSETTS,BARNSTABLE,72156,1465,58527,132148,0.5460241547355995,0.44288979023519087,0.011086055029209674
2004,MASSACHUSETTS,BERKSHIRE,47743,742,16806,65291,0.7312340138763382,0.25740147953010367,0.01136450659355807
2004,MASSACHUSETTS,BRISTOL,147854,2500,82524,232878,0.6348989599704566,0.3543658052714297,0.01073523475811369
2004,MASSACHUSETTS,DUKES,7265,130,2602,9997,0.7267180154046213,0.2602780834250275,0.013003901170351105
2004,MASSACHUSETTS,ESSEX,194068,4051,135114,333233,0.5823792961681467,0.4054640446774479,0.012156659154405476
2004,MASSACHUSETTS,FRANKLIN,25550,773,11058,37381,0.6835023140097911,0.29581873144110643,0.020678954549102485
2004,MASSACHUSETTS,HAMPDEN,113710,2004,70925,186639,0.6092510139895735,0.3800116803026163,0.010737305707810264
2004,MASSACHUSETTS,HAMPSHIRE,51680,1427,21315,74422,0.6944183171642794,0.28640724516943916,0.019174437666281477
2004,MASSACHUSETTS,MIDDLESEX,440862,10283,237815,688960,0.639894914073386,0.3451796911286577,0.01492539479795634
2004,MASSACHUSETTS,NANTUCKET,3608,76,2040,5724,0.6303284416491963,0.35639412997903563,0.013277428371767994
2004,MASSACHUSETTS,NORFOLK,199392,3982,127763,331137,0.6021435236775111,0.3858312420538931,0.012025234268595777
2004,MASSACHUSETTS,PLYMOUTH,125178,2516,105603,233297,0.5365606930221992,0.45265477052855374,0.010784536449247097
2004,MASSACHUSETTS,SUFFOLK,182592,3130,54923,240645,0.758760830268653,0.22823245860084357,0.013006711130503439
2004,MASSACHUSETTS,WORCESTER,192142,4400,144094,340636,0.5640683897180568,0.42301459622588333,0.012917014056059842
2004,MICHIGAN,ALCONA,2871,68,3592,6531,0.4395957740009187,0.5499923442045629,0.01041188179451845
2004,MICHIGAN,ALGER,2395,52,2318,4765,0.5026232948583421,0.4864637985309549,0.010912906610703044
2004,MICHIGAN,ALLEGAN,19355,530,34022,53907,0.3590442799636411,0.6311239727679151,0.009831747268443802
2004,MICHIGAN,ALPENA,7407,139,7665,15211,0.48695023338373544,0.5039116428900138,0.00913812372625074
2004,MICHIGAN,ANTRIM,5072,168,8379,13619,0.37242088259049855,0.6152434099419928,0.012335707467508627
2004,MICHIGAN,ARENAC,4076,69,4071,8216,0.4961051606621227,0.4954965920155794,0.008398247322297955
2004,MICHIGAN,BARAGA,1660,47,1977,3684,0.4505971769815418,0.5366449511400652,0.012757871878393051
2004,MICHIGAN,BARRY,11312,322,18638,30272,0.3736786469344609,0.6156844608879493,0.010636892177589853
2004,MICHIGAN,BAY,31049,562,25448,57059,0.5441560490019103,0.4459944969242363,0.00984945407385338
2004,MICHIGAN,BENZIE,4383,111,5284,9778,0.4482511761096339,0.5403968091634281,0.011352014726938024
2004,MICHIGAN,BERRIEN,32846,749,41076,74671,0.43987625718150286,0.5500930749554713,0.010030667863025807
2004,MICHIGAN,BRANCH,7004,179,10784,17967,0.38982579172928145,0.6002114988590194,0.009962709411699227
2004,MICHIGAN,CALHOUN,29891,683,32093,62667,0.4769815054175244,0.5121196163850192,0.010898878197456396
2004,MICHIGAN,CASS,9537,196,12964,22697,0.4201876900030841,0.5711768075076001,0.008635502489315768
2004,MICHIGAN,CHARLEVOIX,5729,196,8214,14139,0.4051913148030271,0.5809463186929769,0.013862366503996039
2004,MICHIGAN,CHEBOYGAN,5941,148,7798,13887,0.4278101821847771,0.5615323684021026,0.010657449413120185
2004,MICHIGAN,CHIPPEWA,7203,163,9122,16488,0.436863173216885,0.5532508491023775,0.009885977680737505
2004,MICHIGAN,CLARE,6984,154,7088,14226,0.490932096161957,0.4982426542949529,0.010825249543090117
2004,MICHIGAN,CLINTON,15483,335,21989,37807,0.4095273362075806,0.5816118708175735,0.008860792974845927
2004,MICHIGAN,CRAWFORD,3126,92,4017,7235,0.43206634416033174,0.5552176917760885,0.01271596406357982
2004,MICHIGAN,DELTA,9381,177,9680,19238,0.48762865162698826,0.5031708077762761,0.009200540596735628
2004,MICHIGAN,DICKINSON,5650,165,7734,13549,0.4170049450143922,0.5708170344674883,0.012178020518119418
2004,MICHIGAN,EATON,25411,563,29781,55755,0.455761815083849,0.5341404358353511,0.010097749080799929
2004,MICHIGAN,EMMET,6846,194,10332,17372,0.3940824314989638,0.5947501726916877,0.011167395809348377
2004,MICHIGAN,GENESEE,128334,1571,83870,213775,0.6003227692667524,0.3923283826453046,0.0073488480879429306
2004,MICHIGAN,GLADWIN,6343,114,6770,13227,0.47954940651697286,0.5118318590761322,0.008618734406894988
2004,MICHIGAN,GOGEBIC,4421,96,3935,8452,0.5230714623757691,0.46557027922385236,0.011358258400378608
2004,MICHIGAN,GRAND TRAVERSE,18256,489,27446,46191,0.3952285077179537,0.594185014396744,0.010586477885302332
2004,MICHIGAN,GRATIOT,7377,168,9834,17379,0.4244778180562748,0.5658553426549283,0.009666839288796823
2004,MICHIGAN,HILLSDALE,7123,289,12804,20216,0.35234467748318166,0.6333597150771666,0.014295607439651761
2004,MICHIGAN,HOUGHTON,6731,231,8889,15851,0.4246419784240742,0.5607848085294304,0.01457321304649549
2004,MICHIGAN,HURON,7629,166,9671,17466,0.43679148059086226,0.5537043398603,0.009504179548837742
2004,MICHIGAN,INGHAM,76877,1442,54734,133053,0.5777923083282601,0.41136990522573713,0.010837786446002721
2004,MICHIGAN,IONIA,10647,350,16621,27618,0.38550945035846185,0.6018176551524368,0.01267289448910131
2004,MICHIGAN,IOSCO,6557,148,7301,14006,0.46815650435527634,0.5212765957446809,0.010566899900042838
2004,MICHIGAN,IRON,3215,72,3224,6511,0.4937797573337429,0.49516203348180005,0.011058209184457072
2004,MICHIGAN,ISABELLA,12334,302,11754,24390,0.5056990569905699,0.4819188191881919,0.012382123821238213
2004,MICHIGAN,JACKSON,31025,741,40029,71795,0.432133156905077,0.5575457900968034,0.010321052998119647
2004,MICHIGAN,KALAMAZOO,61462,1174,57147,119783,0.5131112094370653,0.4770877336516868,0.00980105691124784
2004,MICHIGAN,KALKASKA,3189,107,5084,8380,0.38054892601431983,0.6066825775656325,0.012768496420047733
2004,MICHIGAN,KENT,116909,2781,171201,290891,0.4018996806363896,0.5885400373335716,0.009560282030038744
2004,MICHIGAN,KEWEENAW,630,28,781,1439,0.43780403057678946,0.5427380125086866,0.019457956914523976
2004,MICHIGAN,LAKE,2675,68,2503,5246,0.5099123141441098,0.47712542889820814,0.012962256957682043
2004,MICHIGAN,LAPEER,18086,505,25556,44147,0.4096767617278637,0.5788841823906494,0.01143905588148685
2004,MICHIGAN,LEELANAU,6048,136,7733,13917,0.4345764173313214,0.5556513616440325,0.009772221024646116
2004,MICHIGAN,LENAWEE,20787,550,25675,47012,0.44216370288436996,0.5461371564706884,0.011699140644941717
2004,MICHIGAN,LIVINGSTON,33991,891,58860,93742,0.36260160867060653,0.6278935802521816,0.009504811077211923
2004,MICHIGAN,LUCE,1045,35,1749,2829,0.36938847649346057,0.6182396606574762,0.012371862849063274
2004,MICHIGAN,MACKINAC,2819,74,3706,6599,0.4271859372632217,0.561600242460979,0.011213820275799364
2004,MICHIGAN,MACOMB,196160,4084,202166,402410,0.4874630352128426,0.5023881116274447,0.01014885315971273
2004,MICHIGAN,MANISTEE,6272,173,6295,12740,0.49230769230769234,0.49411302982731553,0.013579277864992152
2004,MICHIGAN,MARQUETTE,17412,386,14690,32488,0.5359517360256094,0.4521669539522285,0.011881310022162028
2004,MICHIGAN,MASON,6333,154,8124,14611,0.43344055848333446,0.5560194374101705,0.010540004106495107
2004,MICHIGAN,MECOSTA,7730,141,9710,17581,0.4396791991354303,0.5523007792503271,0.008020021614242649
2004,MICHIGAN,MENOMINEE,5326,151,5942,11419,0.46641562308433315,0.5203608021718189,0.013223574743847973
2004,MICHIGAN,MIDLAND,18355,551,24369,43275,0.42414789139225884,0.5631195840554593,0.012732524552281918
2004,MICHIGAN,MISSAUKEE,2319,47,5055,7421,0.3124915779544536,0.6811750437946369,0.006333378250909581
2004,MICHIGAN,MONROE,36089,573,37470,74132,0.48682080612960665,0.5054497383046458,0.007729455565747586
2004,MICHIGAN,MONTCALM,11471,295,14968,26734,0.4290790753347797,0.5598862871250093,0.011034637540210968
2004,MICHIGAN,MONTMORENCY,2196,67,3300,5563,0.39475103361495595,0.5932051051590869,0.012043861225957218
2004,MICHIGAN,MUSKEGON,44282,729,35302,80313,0.5513677735858454,0.43955524012301866,0.00907698629113593
2004,MICHIGAN,NEWAYGO,9057,208,13608,22873,0.39596904647400866,0.5949372622742972,0.009093691251694137
2004,MICHIGAN,OAKLAND,319387,5957,316633,641977,0.4975053623416415,0.49321548902842316,0.009279148629935341
2004,MICHIGAN,OCEANA,5441,179,6677,12297,0.4424656420265105,0.5429779621045784,0.014556395868911116
2004,MICHIGAN,OGEMAW,5215,127,5454,10796,0.48304927751018895,0.5051871063356799,0.01176361615413116
2004,MICHIGAN,ONTONAGON,1863,67,2262,4192,0.4444179389312977,0.5395992366412213,0.015982824427480915
2004,MICHIGAN,OSCEOLA,4467,122,6599,11188,0.39926707186271004,0.589828387558098,0.010904540579191992
2004,MICHIGAN,OSCODA,1792,47,2570,4409,0.4064413699251531,0.5828986164663189,0.01066001360852801
2004,MICHIGAN,OTSEGO,4674,163,7470,12307,0.3797838628422849,0.6069716421548712,0.01324449500284391
2004,MICHIGAN,OTTAWA,35552,1043,92048,128643,0.27636171420131683,0.7155305768677658,0.008107708930917345
2004,MICHIGAN,PRESQUE ISLE,3432,102,3982,7516,0.4566258648217137,0.5298030867482704,0.013571048430015966
2004,MICHIGAN,ROSCOMMON,6810,185,7364,14359,0.47426701023748175,0.512849084198064,0.012883905564454349
2004,MICHIGAN,SAGINAW,54887,800,47165,102852,0.5336502936257924,0.4585715396880955,0.007778166686112083
2004,MICHIGAN,SANILAC,7883,248,12632,20763,0.3796657515773251,0.6083899243847228,0.011944324037952127
2004,MICHIGAN,SCHOOLCRAFT,2137,37,2267,4441,0.48119792839450576,0.510470614726413,0.008331456879081288
2004,MICHIGAN,SHIAWASSEE,16881,363,19407,36651,0.46058770565605306,0.5295080625358107,0.009904231808136203
2004,MICHIGAN,ST. CLAIR,36174,829,42740,79743,0.4536322937436515,0.535971809437819,0.010395896818529525
2004,MICHIGAN,ST. JOSEPH,9648,251,15340,25239,0.38226554142398667,0.6077895320733785,0.009944926502634812
2004,MICHIGAN,TUSCOLA,12631,318,15389,28338,0.44572658620933026,0.5430517326557979,0.011221681134871904
2004,MICHIGAN,VAN BUREN,16151,389,17634,34174,0.47261075671563174,0.516006320594604,0.011382922689764149
2004,MICHIGAN,WASHTENAW,109953,1856,61455,173264,0.6345980699972297,0.3546899529042386,0.01071197709853172
2004,MICHIGAN,WAYNE,600047,6931,257750,864728,0.693914155665134,0.29807060717358524,0.008015237161280773
2004,MICHIGAN,WEXFORD,6034,160,8966,15160,0.39802110817941955,0.5914248021108179,0.010554089709762533
2004,MINNESOTA,AITKIN,4539,145,4768,9452,0.4802158273381295,0.5044435040203131,0.015340668641557342
2004,MINNESOTA,ANOKA,80226,1987,91853,174066,0.4608941436007032,0.5276906460767755,0.011415210322521343
2004,MINNESOTA,BECKER,6756,250,9795,16801,0.4021189214927683,0.583001011844533,0.014880066662698649
2004,MINNESOTA,BELTRAMI,10592,302,10237,21131,0.5012540816809427,0.48445411954001233,0.014291798779045005
2004,MINNESOTA,BENTON,8059,282,10043,18384,0.4383703220191471,0.5462902523933856,0.015339425587467363
2004,MINNESOTA,BIG STONE,1536,48,1483,3067,0.5008151287903488,0.4835343984349527,0.0156504727746984
2004,MINNESOTA,BLUE EARTH,16865,517,15737,33119,0.5092243123282708,0.4751653129623479,0.015610374709381323
2004,MINNESOTA,BROWN,5158,225,8395,13778,0.37436492959790973,0.6093046886340543,0.016330381768036
2004,MINNESOTA,CARLTON,11462,230,6642,18334,0.6251772662812262,0.362277735355078,0.012544998363695865
2004,MINNESOTA,CARVER,16456,445,28510,45411,0.3623791592345467,0.6278214529519279,0.009799387813525358
2004,MINNESOTA,CASS,6835,200,8875,15910,0.4296040226272784,0.5578252671275927,0.01257071024512885
2004,MINNESOTA,CHIPPEWA,3424,93,3089,6606,0.5183166818044203,0.4676052073872237,0.01407811080835604
2004,MINNESOTA,CHISAGO,12219,336,15705,28260,0.4323779193205945,0.5557324840764332,0.0118895966029724
2004,MINNESOTA,CLAY,12989,383,14365,27737,0.4682914518513177,0.5179002776075279,0.013808270541154414
2004,MINNESOTA,CLEARWATER,1871,52,2438,4361,0.4290300389818849,0.5590460903462509,0.011923870671864251
2004,MINNESOTA,COOK,1733,81,1489,3303,0.5246745382985165,0.45080230093854073,0.02452316076294278
2004,MINNESOTA,COTTONWOOD,2726,86,3557,6369,0.42801067671533993,0.5584864185900456,0.013502904694614539
2004,MINNESOTA,CROW WING,14005,434,19106,33545,0.4174988820986734,0.5695632732150843,0.01293784468624236
2004,MINNESOTA,DAKOTA,104635,2252,108959,215846,0.48476691715389675,0.5047997183176894,0.010433364528413777
2004,MINNESOTA,DODGE,4117,158,5593,9868,0.417207134171058,0.5667815160113499,0.016011349817592217
2004,MINNESOTA,DOUGLAS,8219,297,11793,20309,0.40469742478704024,0.5806785169136836,0.014624058299276183
2004,MINNESOTA,FARIBAULT,3767,120,4794,8681,0.4339361824674577,0.5522405252851054,0.013823292247436931
2004,MINNESOTA,FILLMORE,5825,179,5694,11698,0.49794836724226366,0.48674987177295265,0.015301760984783724
2004,MINNESOTA,FREEBORN,9733,252,7681,17666,0.5509453186912714,0.43478999207517266,0.014264689233555982
2004,MINNESOTA,GOODHUE,12103,371,13134,25608,0.4726257419556389,0.5128865979381443,0.014487660106216807
2004,MINNESOTA,GRANT,1856,70,1893,3819,0.4859910971458497,0.4956794972505892,0.018329405603561142
2004,MINNESOTA,HENNEPIN,383842,8007,255135,646984,0.593278968258875,0.3943451460932573,0.012375885647867645
2004,MINNESOTA,HOUSTON,5276,175,5631,11082,0.47608734885399745,0.508121277747699,0.015791373398303554
2004,MINNESOTA,HUBBARD,4741,155,6444,11340,0.41807760141093475,0.5682539682539682,0.013668430335097001
2004,MINNESOTA,ISANTI,7883,240,11190,19313,0.40817066224822657,0.5794024750168281,0.012426862734945374
2004,MINNESOTA,ITASCA,13290,372,10705,24367,0.5454097755160668,0.43932367546271595,0.01526654902121722
2004,MINNESOTA,JACKSON,2652,103,3024,5779,0.45890292438138086,0.523273922824018,0.017823152794601144
2004,MINNESOTA,KANABEC,3592,129,4527,8248,0.4354995150339476,0.5488603297769156,0.01564015518913676
2004,MINNESOTA,KANDIYOHI,9337,308,11704,21349,0.43735069558293127,0.5482223991756054,0.014426905241463301
2004,MINNESOTA,KITTSON,1333,42,1307,2682,0.4970171513795675,0.4873228933631618,0.015659955257270694
2004,MINNESOTA,KOOCHICHING,3662,108,3539,7309,0.5010261321658229,0.48419756464632646,0.014776303187850596
2004,MINNESOTA,LAC QUI PARLE,2390,58,2093,4541,0.5263157894736842,0.4609116934595904,0.012772517066725391
2004,MINNESOTA,LAKE,4212,90,2769,7071,0.5956724649978786,0.39159949087823503,0.012728044123886296
2004,MINNESOTA,LAKE OF THE WOODS,921,51,1428,2400,0.38375,0.595,0.02125
2004,MINNESOTA,LE SUEUR,6466,212,7746,14424,0.4482806433721575,0.5370216306156406,0.014697726012201887
2004,MINNESOTA,LINCOLN,1558,48,1736,3342,0.46618791143028127,0.5194494314781568,0.01436265709156194
2004,MINNESOTA,LYON,5292,178,7203,12673,0.4175806833425393,0.5683737078829006,0.014045608774560089
2004,MINNESOTA,MAHNOMEN,1339,37,1132,2508,0.5338915470494418,0.4513556618819777,0.014752791068580542
2004,MINNESOTA,MARSHALL,2308,67,3187,5562,0.4149586479683567,0.5729953254225099,0.012046026609133405
2004,MINNESOTA,MARTIN,4590,146,6311,11047,0.4154974201140581,0.5712863220783924,0.01321625780754956
2004,MINNESOTA,MCLEOD,6712,293,11407,18412,0.3645448620464914,0.6195416033021942,0.01591353465131436
2004,MINNESOTA,MEEKER,5292,188,6854,12334,0.42905788876276957,0.5556996919085455,0.015242419328684935
2004,MINNESOTA,MILLE LACS,5677,194,7194,13065,0.43451970914657484,0.5506314580941447,0.01484883275928052
2004,MINNESOTA,MORRISON,6794,266,9698,16758,0.40541830767394677,0.5787086764530374,0.015873015873015872
2004,MINNESOTA,MOWER,12334,297,7591,20222,0.6099297794481258,0.37538324596973593,0.014686974582138265
2004,MINNESOTA,MURRAY,2218,61,2719,4998,0.44377751100440177,0.5440176070428171,0.012204881952781112
2004,MINNESOTA,NICOLLET,8797,255,8689,17741,0.49585705428104393,0.4897694605715574,0.014373485147398682
2004,MINNESOTA,NOBLES,3898,147,5159,9204,0.4235115167318557,0.5605171664493699,0.015971316818774447
2004,MINNESOTA,NORMAN,1954,62,1794,3810,0.5128608923884515,0.47086614173228347,0.01627296587926509
2004,MINNESOTA,OLMSTED,33285,920,37371,71576,0.46503017771319993,0.522116351849782,0.012853470437017995
2004,MINNESOTA,OTTER TAIL,12038,406,19734,32178,0.3741065324134502,0.6132761514077941,0.012617316178755672
2004,MINNESOTA,PENNINGTON,3117,133,3767,7017,0.44420692603676787,0.5368391050306399,0.018953968932592276
2004,MINNESOTA,PINE,7228,257,7033,14518,0.49786471965835516,0.4844331175092988,0.017702162832346054
2004,MINNESOTA,PIPESTONE,1900,66,3066,5032,0.37758346581875996,0.6093004769475358,0.013116057233704292
2004,MINNESOTA,POLK,6729,215,8724,15668,0.42947408731171816,0.5568036762828695,0.013722236405412305
2004,MINNESOTA,POPE,3301,96,3303,6700,0.4926865671641791,0.4929850746268657,0.014328358208955224
2004,MINNESOTA,RAMSEY,171846,3635,97096,272577,0.6304493776070615,0.3562149410992123,0.013335681293726176
2004,MINNESOTA,RED LAKE,963,49,1164,2176,0.44255514705882354,0.5349264705882353,0.022518382352941176
2004,MINNESOTA,REDWOOD,3104,137,4898,8139,0.3813736331244625,0.6017938321661138,0.016832534709423762
2004,MINNESOTA,RENVILLE,3787,132,4430,8349,0.45358725595879745,0.5306024673613606,0.015810276679841896
2004,MINNESOTA,RICE,16425,439,13881,30745,0.5342332086518133,0.45148804683688404,0.01427874451130265
2004,MINNESOTA,ROCK,2000,80,3111,5191,0.38528221922558276,0.599306492005394,0.015411288769023309
2004,MINNESOTA,ROSEAU,2442,114,5355,7911,0.3086841107318923,0.676905574516496,0.01441031475161168
2004,MINNESOTA,SAINT LOUIS,77694,1481,39866,119041,0.6526658882233852,0.3348930200519149,0.012441091724699893
2004,MINNESOTA,SCOTT,23958,626,36055,60639,0.3950922673526938,0.5945843434093571,0.010323389237949175
2004,MINNESOTA,SHERBURNE,15816,456,25182,41454,0.38153133593863076,0.6074685193226227,0.011000144738746562
2004,MINNESOTA,SIBLEY,3109,171,4669,7949,0.3911183796703988,0.5873694804377909,0.021512139891810292
2004,MINNESOTA,STEARNS,32659,1192,41726,75577,0.4321288222607407,0.5520991836140625,0.01577199412519682
2004,MINNESOTA,STEELE,7994,312,10389,18695,0.42760096282428456,0.5557100829098689,0.016688954265846483
2004,MINNESOTA,STEVENS,2821,98,3030,5949,0.47419734409144393,0.5093292990418558,0.016473356866700286
2004,MINNESOTA,SWIFT,3165,89,2481,5735,0.5518744551002616,0.43260680034873583,0.015518744551002616
2004,MINNESOTA,TODD,5034,235,6945,12214,0.412149991812674,0.5686097920419191,0.01924021614540691
2004,MINNESOTA,TRAVERSE,1026,39,1076,2141,0.47921531994395145,0.5025688930406352,0.01821578701541336
2004,MINNESOTA,WABASHA,5548,167,6120,11835,0.4687790452049007,0.5171102661596958,0.014110688635403464
2004,MINNESOTA,WADENA,2791,88,4214,7093,0.3934865360214296,0.5941068659241505,0.01240659805441985
2004,MINNESOTA,WASECA,4179,164,5457,9800,0.42642857142857143,0.5568367346938775,0.01673469387755102
2004,MINNESOTA,WASHINGTON,61395,1303,65751,128449,0.47797180203816303,0.5118840940762481,0.010144103885588833
2004,MINNESOTA,WATONWAN,2514,99,2970,5583,0.4502955400322407,0.5319720580333154,0.017732401934443847
2004,MINNESOTA,WILKIN,1169,55,2303,3527,0.33144315282109443,0.6529628579529345,0.01559398922597108
2004,MINNESOTA,WINONA,14231,489,12686,27406,0.5192658541925126,0.4628913376632854,0.017842808144202
2004,MINNESOTA,WRIGHT,22618,740,36176,59534,0.37991735814828503,0.6076527698458024,0.012429872005912588
2004,MINNESOTA,YELLOW MEDICINE,2799,81,2878,5758,0.48610628690517543,0.4998263285863147,0.0140673845085099
2004,MISSISSIPPI,ADAMS,7844,45,6487,14376,0.5456316082359488,0.45123817473567057,0.0031302170283806345
2004,MISSISSIPPI,ALCORN,5425,151,8605,14181,0.3825541217121501,0.6067978280798251,0.010648050208024822
2004,MISSISSIPPI,AMITE,2973,38,4106,7117,0.41773219052971755,0.5769284811015878,0.005339328368694675
2004,MISSISSIPPI,ATTALA,3014,49,4882,7945,0.3793580868470736,0.6144745122718691,0.006167400881057269
2004,MISSISSIPPI,BENTON,2234,33,1962,4229,0.5282572712225112,0.4639394655947032,0.007803263182785528
2004,MISSISSIPPI,BOLIVAR,8560,145,4722,13427,0.637521412080137,0.3516794518507485,0.01079913606911447
2004,MISSISSIPPI,CALHOUN,2211,24,4096,6331,0.3492339282893698,0.6469752013899858,0.003790870320644448
2004,MISSISSIPPI,CARROLL,1897,28,3652,5577,0.3401470324547248,0.6548323471400395,0.00502062040523579
2004,MISSISSIPPI,CHICKASAW,4078,72,4193,8343,0.488793000119861,0.5025770106676255,0.008629989212513484
2004,MISSISSIPPI,CHOCTAW,1290,20,2598,3908,0.33009211873080857,0.6647901740020471,0.00511770726714432
2004,MISSISSIPPI,CLAIBORNE,4338,42,941,5321,0.8152602894192821,0.17684645743281338,0.00789325314790453
2004,MISSISSIPPI,CLARKE,2377,34,5027,7438,0.3195751546114547,0.6758537241193869,0.004571121269158376
2004,MISSISSIPPI,CLAY,4732,46,4333,9111,0.5193721874657008,0.4755789704752497,0.005048842059049501
2004,MISSISSIPPI,COAHOMA,6741,132,3643,10516,0.641023202738684,0.346424496006086,0.012552301255230125
2004,MISSISSIPPI,COPIAH,4902,54,6316,11272,0.43488289567068844,0.5603264726756565,0.004790631653655075
2004,MISSISSIPPI,COVINGTON,3135,49,5010,8194,0.38259702221137415,0.611422992433488,0.005979985355137905
2004,MISSISSIPPI,DESOTO,13247,297,35437,48981,0.2704518078438578,0.7234846164839428,0.0060635756721994245
2004,MISSISSIPPI,FORREST,9781,189,15966,25936,0.3771206045650833,0.6155922270203578,0.007287168414558914
2004,MISSISSIPPI,FRANKLIN,1566,24,2883,4473,0.3501006036217304,0.6445338698859826,0.0053655264922870555
2004,MISSISSIPPI,GEORGE,1715,53,6182,7950,0.21572327044025158,0.7776100628930818,0.006666666666666667
2004,MISSISSIPPI,GREENE,1419,29,3827,5275,0.2690047393364929,0.7254976303317535,0.005497630331753554
2004,MISSISSIPPI,GRENADA,4154,52,5844,10050,0.41333333333333333,0.5814925373134329,0.005174129353233831
2004,MISSISSIPPI,HANCOCK,5023,195,12332,17550,0.2862108262108262,0.7026780626780627,0.011111111111111112
2004,MISSISSIPPI,HARRISON,22555,474,38781,61810,0.36490859084290567,0.6274227471282964,0.007668662028797929
2004,MISSISSIPPI,HINDS,51370,626,34269,86265,0.5954906393091056,0.3972526517127456,0.0072567089781487275
2004,MISSISSIPPI,HOLMES,6170,49,1925,8144,0.7576129666011788,0.2363703339882122,0.006016699410609038
2004,MISSISSIPPI,HUMPHREYS,2975,50,1626,4651,0.6396473876585681,0.34960223607826274,0.010750376263169211
2004,MISSISSIPPI,ISSAQUENA,510,15,437,962,0.5301455301455301,0.45426195426195426,0.015592515592515593
2004,MISSISSIPPI,ITAWAMBA,2771,74,6751,9596,0.28876615256356813,0.7035223009587328,0.0077115464776990415
2004,MISSISSIPPI,JACKSON,15046,333,34035,49414,0.3044886064678026,0.6887724126765694,0.006738980855627959
2004,MISSISSIPPI,JASPER,4081,37,3808,7926,0.5148877113298006,0.4804441079989907,0.004668180671208681
2004,MISSISSIPPI,JEFFERSON,2798,15,627,3440,0.8133720930232559,0.18226744186046512,0.00436046511627907
2004,MISSISSIPPI,JEFFERSON DAVIS,2955,138,2667,5760,0.5130208333333334,0.4630208333333333,0.023958333333333335
2004,MISSISSIPPI,JONES,7344,142,19032,26518,0.2769439625914473,0.7177011841013651,0.005354853307187571
2004,MISSISSIPPI,KEMPER,2454,28,2107,4589,0.5347570276748747,0.4591414251470909,0.00610154717803443
2004,MISSISSIPPI,LAFAYETTE,6218,166,9004,15388,0.40408110215752535,0.5851312711203536,0.010787626722121134
2004,MISSISSIPPI,LAMAR,3876,130,16288,20294,0.19099241155021188,0.8026017542130679,0.006405834236720213
2004,MISSISSIPPI,LAUDERDALE,10026,134,19395,29555,0.3392319404500085,0.6562341397394688,0.004533919810522754
2004,MISSISSIPPI,LAWRENCE,2355,48,4119,6522,0.3610855565777369,0.6315547378104875,0.007359705611775529
2004,MISSISSIPPI,LEAKE,3212,35,4926,8173,0.39300134589502017,0.6027162608589257,0.0042823932460540805
2004,MISSISSIPPI,LEE,9895,237,19878,30010,0.32972342552482503,0.662379206931023,0.00789736754415195
2004,MISSISSIPPI,LEFLORE,7240,17,4427,11684,0.6196508045190003,0.37889421431016773,0.001454981170831907
2004,MISSISSIPPI,LINCOLN,4372,65,9889,14326,0.3051793941086137,0.6902834008097166,0.004537205081669692
2004,MISSISSIPPI,LOWNDES,7904,202,12642,20748,0.38095238095238093,0.6093117408906883,0.009735878156930788
2004,MISSISSIPPI,MADISON,12942,191,24015,37148,0.34839022289221494,0.6464681813287391,0.0051415957790459784
2004,MISSISSIPPI,MARION,3828,59,7845,11732,0.3262870780770542,0.6686839413569724,0.005028980565973406
2004,MISSISSIPPI,MARSHALL,8472,82,5932,14486,0.5848405356896313,0.4094988264531272,0.0056606378572414745
2004,MISSISSIPPI,MONROE,6149,87,9223,15459,0.39776182159259976,0.5966103887702956,0.005627789637104599
2004,MISSISSIPPI,MONTGOMERY,2422,21,2953,5396,0.44885100074128986,0.5472572275759822,0.0038917716827279467
2004,MISSISSIPPI,NESHOBA,2515,37,7581,10133,0.24819895391295765,0.7481496101845455,0.0036514359024967928
2004,MISSISSIPPI,NEWTON,2274,42,6156,8472,0.26841359773371104,0.726628895184136,0.004957507082152974
2004,MISSISSIPPI,NOXUBEE,4293,29,1698,6020,0.7131229235880399,0.28205980066445185,0.0048172757475083055
2004,MISSISSIPPI,OKTIBBEHA,4178,79,5485,9742,0.4288647095052351,0.5630260726750154,0.008109217819749538
2004,MISSISSIPPI,PANOLA,6540,56,6734,13330,0.490622655663916,0.5051762940735184,0.0042010502625656415
2004,MISSISSIPPI,PEARL RIVER,4392,117,14612,19121,0.2296950996286805,0.764185973536949,0.006118926834370588
2004,MISSISSIPPI,PERRY,1259,22,3729,5010,0.25129740518962074,0.744311377245509,0.004391217564870259
2004,MISSISSIPPI,PIKE,7578,90,8547,16215,0.4673450508788159,0.527104532839963,0.005550416281221091
2004,MISSISSIPPI,PONTOTOC,2591,95,8375,11061,0.2342464514962481,0.7571648133080192,0.008588735195732755
2004,MISSISSIPPI,PRENTISS,3306,67,6503,9876,0.3347509113001215,0.6584649655731065,0.006784123126771973
2004,MISSISSIPPI,QUITMAN,2032,24,1360,3416,0.594847775175644,0.3981264637002342,0.00702576112412178
2004,MISSISSIPPI,RANKIN,10738,656,41971,53365,0.20121802679658954,0.7864892719947532,0.01229270120865736
2004,MISSISSIPPI,SCOTT,3780,31,6364,10175,0.3714987714987715,0.6254545454545455,0.003046683046683047
2004,MISSISSIPPI,SHARKEY,1553,413,1115,3081,0.5040571243102888,0.361895488477767,0.13404738721194417
2004,MISSISSIPPI,SIMPSON,3262,5,6810,10077,0.32370745261486555,0.6757963679666568,0.0004961794184777216
2004,MISSISSIPPI,SMITH,1493,47,5566,7106,0.21010413734871938,0.7832817337461301,0.006614128905150577
2004,MISSISSIPPI,STONE,1502,56,4072,5630,0.26678507992895206,0.7232682060390764,0.00994671403197158
2004,MISSISSIPPI,SUNFLOWER,6057,114,3492,9663,0.6268239677118908,0.3613784538963055,0.011797578391803787
2004,MISSISSIPPI,TALLAHATCHIE,3377,59,2725,6161,0.5481253043337121,0.4422983281934751,0.009576367472812855
2004,MISSISSIPPI,TATE,4279,59,6663,11001,0.38896463957822014,0.6056722116171257,0.005363148804654123
2004,MISSISSIPPI,TIPPAH,2983,82,6048,9113,0.3273345769779436,0.6636672884889718,0.008998134533084604
2004,MISSISSIPPI,TISHOMINGO,2775,102,5288,8165,0.33986527862829147,0.647642375995101,0.012492345376607471
2004,MISSISSIPPI,TUNICA,1934,36,845,2815,0.6870337477797513,0.30017761989342806,0.012788632326820605
2004,MISSISSIPPI,UNION,2710,67,7422,10199,0.2657123247377194,0.727718403765075,0.006569271497205608
2004,MISSISSIPPI,WALTHALL,2550,36,3873,6459,0.3947979563399907,0.5996284254528564,0.00557361820715281
2004,MISSISSIPPI,WARREN,8244,100,11773,20117,0.4098026544713426,0.5852264254113436,0.0049709201173137145
2004,MISSISSIPPI,WASHINGTON,10562,282,7031,17875,0.5908811188811188,0.39334265734265733,0.015776223776223775
2004,MISSISSIPPI,WAYNE,3155,39,5333,8527,0.37000117274539696,0.6254251202064032,0.004573707048199835
2004,MISSISSIPPI,WEBSTER,1318,16,3668,5002,0.26349460215913634,0.7333066773290684,0.003198720511795282
2004,MISSISSIPPI,WILKINSON,2794,31,1563,4388,0.6367365542388331,0.35619872379216044,0.007064721969006381
2004,MISSISSIPPI,WINSTON,3960,47,5375,9382,0.42208484331699,0.5729055638456619,0.005009592837348114
2004,MISSISSIPPI,YALOBUSHA,2656,37,3278,5971,0.44481661363255737,0.5489867693853626,0.006196616982080054
2004,MISSISSIPPI,YAZOO,4798,301,5595,10694,0.4486628015709744,0.523190574153731,0.028146624275294557
2004,MISSOURI,ADAIR,4938,99,6367,11404,0.43300596282006315,0.558312872676254,0.008681164503682918
2004,MISSOURI,ANDREW,3069,62,5135,8266,0.3712799419308009,0.6212194531817082,0.007500604887490926
2004,MISSOURI,ATCHISON,1005,14,2137,3156,0.31844106463878324,0.6771229404309252,0.004435994930291508
2004,MISSOURI,AUDRAIN,4318,71,6294,10683,0.4041935785827951,0.5891603482167931,0.006646073200411869
2004,MISSOURI,BARRY,4223,105,9599,13927,0.30322395347167375,0.6892367344008042,0.007539312127522079
2004,MISSOURI,BARTON,1373,46,4572,5991,0.22917709898180605,0.7631447170756134,0.007678183942580538
2004,MISSOURI,BATES,3398,64,5004,8466,0.4013701866288684,0.5910701630049611,0.007559650366170565
2004,MISSOURI,BENTON,3381,53,5575,9009,0.3752913752913753,0.6188256188256188,0.005883005883005883
2004,MISSOURI,BOLLINGER,1754,39,4102,5895,0.29754028837998303,0.695843935538592,0.0066157760814249365
2004,MISSOURI,BOONE,37643,602,37801,76046,0.49500302448518,0.4970807143044999,0.00791626121032007
2004,MISSOURI,BUCHANAN,17799,339,19812,37950,0.46901185770750986,0.5220553359683795,0.008932806324110672
2004,MISSOURI,BUTLER,4666,79,11696,16441,0.28380268840094885,0.711392251079618,0.004805060519433125
2004,MISSOURI,CALDWELL,1645,30,2593,4268,0.38542642924086223,0.6075445173383318,0.007029053420805998
2004,MISSOURI,CALLAWAY,6559,106,11108,17773,0.3690429302875148,0.6249929668598436,0.005964102852641647
2004,MISSOURI,CAMDEN,6296,101,13122,19519,0.3225575080690609,0.6722680465187766,0.005174445412162509
2004,MISSOURI,CAPE GIRARDEAU,10568,183,23814,34565,0.30574280341385796,0.6889628236655576,0.005294372920584406
2004,MISSOURI,CARROLL,1568,18,3155,4741,0.3307319130985024,0.6654714195317444,0.0037966673697532164
2004,MISSOURI,CARTER,964,18,1797,2779,0.34688736955739474,0.6466354803886291,0.006477150053976251
2004,MISSOURI,CASS,16681,283,27253,44217,0.377253092701902,0.6163466540018545,0.006400253296243526
2004,MISSOURI,CEDAR,1910,55,4238,6203,0.3079155247460906,0.683217797839755,0.008866677414154442
2004,MISSOURI,CHARITON,1892,27,2421,4340,0.4359447004608295,0.5578341013824885,0.006221198156682027
2004,MISSOURI,CHRISTIAN,9059,187,22102,31348,0.2889817532218961,0.7050529539364553,0.00596529284164859
2004,MISSOURI,CLARK,1794,43,1899,3736,0.4801927194860814,0.5082976445396146,0.011509635974304069
2004,MISSOURI,CLAY,44670,597,51193,96460,0.4630935102633216,0.5307173958117354,0.006189093924942981
2004,MISSOURI,CLINTON,4165,88,5287,9540,0.43658280922431864,0.5541928721174004,0.009224318658280923
2004,MISSOURI,COLE,11753,196,24752,36701,0.3202365058172802,0.674423040244135,0.0053404539385847796
2004,MISSOURI,COOPER,2400,50,5058,7508,0.3196590303676079,0.6736814064997336,0.006659563132658497
2004,MISSOURI,CRAWFORD,3632,63,5686,9381,0.38716554738300824,0.6061187506662403,0.006715701950751519
2004,MISSOURI,DADE,1104,22,2963,4089,0.26999266324284665,0.7246270481780387,0.005380288579114698
2004,MISSOURI,DALLAS,2407,64,4788,7259,0.3315883730541397,0.6595949855351977,0.008816641410662625
2004,MISSOURI,DAVIESS,1402,41,2351,3794,0.3695308381655245,0.6196626251976806,0.01080653663679494
2004,MISSOURI,DEKALB,1707,38,2941,4686,0.36427656850192064,0.627614169867691,0.00810926163038839
2004,MISSOURI,DENT,1865,70,4369,6304,0.2958439086294416,0.6930520304568528,0.011104060913705584
2004,MISSOURI,DOUGLAS,1741,88,4498,6327,0.2751699067488541,0.710921447763553,0.013908645487592856
2004,MISSOURI,DUNKLIN,4901,56,6720,11677,0.41971396762867175,0.5754902800376809,0.004795752333647341
2004,MISSOURI,FRANKLIN,18556,333,26429,45318,0.40946202391985526,0.5831899024670109,0.007348073613133854
2004,MISSOURI,GASCONADE,2355,63,4753,7171,0.3284060800446242,0.6628085343745642,0.008785385580811602
2004,MISSOURI,GENTRY,1201,26,2085,3312,0.3626207729468599,0.6295289855072463,0.00785024154589372
2004,MISSOURI,GREENE,46657,724,77885,125266,0.3724633978892916,0.6217569013140039,0.0057797007967046125
2004,MISSOURI,GRUNDY,1561,75,3172,4808,0.3246672212978369,0.6597337770382695,0.01559900166389351
2004,MISSOURI,HARRISON,1279,40,2729,4048,0.3159584980237154,0.6741600790513834,0.009881422924901186
2004,MISSOURI,HENRY,4461,55,6361,10877,0.41013147007446904,0.5848119885997978,0.0050565413257331986
2004,MISSOURI,HICKORY,2043,32,2791,4866,0.4198520345252774,0.5735717221537197,0.006576243321002877
2004,MISSOURI,HOLT,811,16,1864,2691,0.3013749535488666,0.6926793013749536,0.005945745076179859
2004,MISSOURI,HOWARD,1972,34,2915,4921,0.40073155862629545,0.5923592765698029,0.006909164803901646
2004,MISSOURI,HOWELL,5118,164,11097,16379,0.3124732889675804,0.6775138897368582,0.01001282129556139
2004,MISSOURI,IRON,2157,45,2477,4679,0.46099593930326993,0.5293866210728788,0.00961743962385125
2004,MISSOURI,JACKSON,79029,1102,94439,174570,0.45270665062725557,0.5409806954230395,0.00631265394970499
2004,MISSOURI,JASPER,13002,237,31846,45085,0.2883885993124099,0.7063546634135521,0.005256737274037929
2004,MISSOURI,JEFFERSON,46057,583,46624,93264,0.4938347057814376,0.49991422199348085,0.006251072225081489
2004,MISSOURI,JOHNSON,7790,189,12257,20236,0.3849575014825064,0.6057027080450682,0.00933979047242538
2004,MISSOURI,KANSAS CITY,104625,737,36061,141423,0.7398018709827963,0.25498681261180994,0.005211316405393748
2004,MISSOURI,KNOX,761,10,1207,1978,0.38473205257836196,0.6102123356926188,0.005055611729019211
2004,MISSOURI,LACLEDE,4213,78,10578,14869,0.2833411796354832,0.7114130069271639,0.0052458134373528816
2004,MISSOURI,LAFAYETTE,6412,114,9656,16182,0.39624273884563094,0.5967123964899271,0.0070448646644419724
2004,MISSOURI,LAWRENCE,4506,106,11194,15806,0.285081614576743,0.7082120713653043,0.006706314057952676
2004,MISSOURI,LEWIS,1754,28,2862,4644,0.3776916451335056,0.6162790697674418,0.006029285099052541
2004,MISSOURI,LINCOLN,8368,155,11316,19839,0.42179545339986896,0.5703916528050809,0.007812893795050154
2004,MISSOURI,LINN,2440,36,3422,5898,0.4136995591726009,0.5801966768396066,0.006103763987792472
2004,MISSOURI,LIVINGSTON,2278,39,4029,6346,0.35896627797037506,0.6348881184998424,0.00614560352978254
2004,MISSOURI,MACON,2856,41,4673,7570,0.37727873183619554,0.6173051519154558,0.005416116248348745
2004,MISSOURI,MADISON,1972,41,2905,4918,0.40097600650671006,0.590687271248475,0.008336722244814965
2004,MISSOURI,MARIES,1563,36,2825,4424,0.3533001808318264,0.6385623869801085,0.0081374321880651
2004,MISSOURI,MARION,4568,70,7815,12453,0.3668192403436923,0.6275596241869429,0.005621135469364812
2004,MISSOURI,MCDONALD,2215,67,5443,7725,0.2867313915857605,0.7045954692556634,0.008673139158576051
2004,MISSOURI,MERCER,582,28,1207,1817,0.3203082003302146,0.6642817831590534,0.015410016510731976
2004,MISSOURI,MILLER,2959,75,7797,10831,0.27319730403471515,0.7198781275967131,0.006924568368571692
2004,MISSOURI,MISSISSIPPI,2374,21,2903,5298,0.4480936202340506,0.5479426198565497,0.003963759909399773
2004,MISSOURI,MONITEAU,1913,35,4743,6691,0.28590644148856675,0.7088626513226722,0.005230907188761022
2004,MISSOURI,MONROE,1647,28,2632,4307,0.3824007429765498,0.611098212212677,0.00650104481077316
2004,MISSOURI,MONTGOMERY,2147,50,3563,5760,0.37274305555555554,0.6185763888888889,0.008680555555555556
2004,MISSOURI,MORGAN,3053,61,5657,8771,0.3480788963630145,0.6449663664348421,0.006954737202143427
2004,MISSOURI,NEW MADRID,3716,37,4154,7907,0.46996332363728344,0.525357278360946,0.004679398001770583
2004,MISSOURI,NEWTON,6564,138,17187,23889,0.27477081501946504,0.7194524676629411,0.005776717317593872
2004,MISSOURI,NODAWAY,3830,63,6226,10119,0.3784958988042297,0.6152781895444214,0.006225911651348948
2004,MISSOURI,OREGON,1823,81,2769,4673,0.3901134175048149,0.5925529638347956,0.01733361866038947
2004,MISSOURI,OSAGE,1673,23,4975,6671,0.25078698845750264,0.7457652525858193,0.003447758956678159
2004,MISSOURI,OZARK,1561,63,3083,4707,0.33163373698746546,0.6549819417888252,0.01338432122370937
2004,MISSOURI,PEMISCOT,3381,27,3398,6806,0.49676755803702616,0.4992653540993241,0.0039670878636497205
2004,MISSOURI,PERRY,2621,43,5583,8247,0.31781253789256697,0.6769734448890505,0.005214017218382442
2004,MISSOURI,PETTIS,5801,92,11603,17496,0.33156149977137633,0.6631801554641061,0.005258344764517604
2004,MISSOURI,PHELPS,6666,160,11874,18700,0.3564705882352941,0.6349732620320856,0.008556149732620321
2004,MISSOURI,PIKE,3670,56,4314,8040,0.4564676616915423,0.5365671641791044,0.006965174129353234
2004,MISSOURI,PLATTE,18412,256,23302,41970,0.4386943054562783,0.5552060995949488,0.006099594948772933
2004,MISSOURI,POLK,3775,92,8586,12453,0.30313980566931664,0.6894724162852325,0.007387778045450895
2004,MISSOURI,PULASKI,3551,52,8618,12221,0.2905654201783815,0.7051796088699779,0.004254970951640619
2004,MISSOURI,PUTNAM,772,13,1660,2445,0.31574642126789365,0.6789366053169734,0.005316973415132925
2004,MISSOURI,RALLS,2031,17,2986,5034,0.4034564958283671,0.5931664680174811,0.003377036154151768
2004,MISSOURI,RANDOLPH,3586,61,6551,10198,0.3516375759952932,0.6423808589919592,0.005981565012747598
2004,MISSOURI,RAY,5034,81,5673,10788,0.46662958843159064,0.5258620689655172,0.007508342602892102
2004,MISSOURI,REYNOLDS,1449,19,1896,3364,0.4307372175980975,0.5636147443519619,0.005648038049940547
2004,MISSOURI,RIPLEY,1907,53,3693,5653,0.33734300371484166,0.6532814434813373,0.00937555280382098
2004,MISSOURI,SALINE,4479,71,5389,9939,0.4506489586477513,0.5422074655397927,0.007143575812455981
2004,MISSOURI,SCHUYLER,894,13,1124,2031,0.4401772525849335,0.5534219596258001,0.006400787789266372
2004,MISSOURI,SCOTLAND,828,17,1352,2197,0.37687756030951297,0.6153846153846154,0.007737824305871643
2004,MISSOURI,SCOTT,6057,61,11330,17448,0.34714580467675377,0.6493580926180651,0.0034961027051811098
2004,MISSOURI,SHANNON,1618,38,2511,4167,0.3882889368850492,0.6025917926565875,0.00911927045836333
2004,MISSOURI,SHELBY,1201,21,2280,3502,0.34294688749286123,0.6510565391205025,0.005996573386636208
2004,MISSOURI,ST. CHARLES,66855,807,95826,163488,0.4089290957134469,0.5861347621843805,0.004936142102172637
2004,MISSOURI,ST. CLAIR,1841,26,3098,4965,0.3707955689828802,0.6239677744209466,0.0052366565961732125
2004,MISSOURI,ST. FRANCOIS,10748,98,12087,22933,0.468669602755854,0.5270570793180134,0.004273317926132648
2004,MISSOURI,ST. LOUIS CITY,116133,712,27793,144638,0.802921777126343,0.1921555884345746,0.004922634439082398
2004,MISSOURI,ST. LOUIS COUNTY,295284,2730,244969,542983,0.5438181305860404,0.4511540876970366,0.005027781716922998
2004,MISSOURI,STE. GENEVIEVE,4281,74,3791,8146,0.525534004419347,0.4653817824699239,0.009084213110729192
2004,MISSOURI,STODDARD,3946,64,9242,13252,0.2977663748868095,0.6974041654089949,0.004829459704195593
2004,MISSOURI,STONE,4578,77,10534,15189,0.30140233063401145,0.6935282112054777,0.005069458160510896
2004,MISSOURI,SULLIVAN,1178,31,1880,3089,0.3813531887342182,0.6086112010359339,0.010035610229847848
2004,MISSOURI,TANEY,5601,101,13578,19280,0.29050829875518674,0.7042531120331951,0.005238589211618257
2004,MISSOURI,TEXAS,3664,120,7234,11018,0.3325467416954075,0.6565619894717735,0.010891268832819023
2004,MISSOURI,VERNON,3206,54,5732,8992,0.3565391459074733,0.6374555160142349,0.006005338078291815
2004,MISSOURI,WARREN,5461,88,7883,13432,0.40656640857653364,0.586882072662299,0.006551518761167362
2004,MISSOURI,WASHINGTON,4459,78,4641,9178,0.48583569405099153,0.5056657223796034,0.0084985835694051
2004,MISSOURI,WAYNE,2250,35,3919,6204,0.36266924564796904,0.6316892327530625,0.005641521598968408
2004,MISSOURI,WEBSTER,4657,93,10194,14944,0.3116300856531049,0.6821466809421841,0.006223233404710921
2004,MISSOURI,WORTH,436,5,691,1132,0.38515901060070673,0.6104240282685512,0.00441696113074205
2004,MISSOURI,WRIGHT,2188,68,6090,8346,0.2621615144979631,0.7296908698777858,0.008147615624251139
2004,MONTANA,BEAVERHEAD,1103,72,3067,4242,0.26001885902876004,0.723008015087223,0.016973125884016973
2004,MONTANA,BIG HORN,2215,68,2028,4311,0.5138019021108792,0.4704244954766875,0.01577360241243331
2004,MONTANA,BLAINE,1300,44,1424,2768,0.46965317919075145,0.5144508670520231,0.015895953757225433
2004,MONTANA,BROADWATER,533,42,1778,2353,0.2265193370165746,0.7556311092222694,0.017849553761155972
2004,MONTANA,CARBON,1847,132,3342,5321,0.34711520390903966,0.628077429054689,0.02480736703627138
2004,MONTANA,CARTER,76,10,623,709,0.1071932299012694,0.8787023977433004,0.014104372355430184
2004,MONTANA,CASCADE,13701,730,19028,33459,0.40948623688693625,0.5686960160196061,0.021817747093457664
2004,MONTANA,CHOUTEAU,946,62,1913,2921,0.32386169120164326,0.6549127011297501,0.021225607668606643
2004,MONTANA,CUSTER,1630,121,3297,5048,0.32290015847860537,0.6531299524564184,0.023969889064976227
2004,MONTANA,DANIELS,326,29,764,1119,0.291331546023235,0.6827524575513851,0.025915996425379804
2004,MONTANA,DAWSON,1494,106,2884,4484,0.33318465655664586,0.6431757359500446,0.023639607493309546
2004,MONTANA,DEER LODGE,2700,118,1725,4543,0.5943209333039842,0.37970504072198985,0.025974025974025976
2004,MONTANA,FALLON,289,24,1178,1491,0.1938296445338699,0.790073775989269,0.01609657947686117
2004,MONTANA,FERGUS,1582,120,4425,6127,0.2582014036233067,0.7222131548881998,0.019585441488493553
2004,MONTANA,FLATHEAD,11587,1072,26019,38678,0.2995759863488288,0.6727079993794922,0.02771601427167899
2004,MONTANA,GALLATIN,16405,1044,22392,39841,0.411761752968048,0.562034085489822,0.026204161542129966
2004,MONTANA,GARFIELD,52,13,590,655,0.07938931297709924,0.9007633587786259,0.01984732824427481
2004,MONTANA,GLACIER,2641,93,1828,4562,0.5789127575624726,0.40070144673388863,0.020385795703638757
2004,MONTANA,GOLDEN VALLEY,119,7,396,522,0.22796934865900384,0.7586206896551724,0.013409961685823755
2004,MONTANA,GRANITE,404,57,1144,1605,0.25171339563862927,0.712772585669782,0.03551401869158879
2004,MONTANA,HILL,2997,155,3505,6657,0.4502027940513745,0.5265134444945171,0.023283761454108456
2004,MONTANA,JEFFERSON,1881,143,3844,5868,0.3205521472392638,0.6550783912747103,0.024369461486025902
2004,MONTANA,JUDITH BASIN,322,20,944,1286,0.25038880248833595,0.7340590979782271,0.015552099533437015
2004,MONTANA,LAKE,4960,371,7245,12576,0.3944020356234097,0.5760973282442748,0.029500636132315523
2004,MONTANA,LEWIS AND CLARK,12717,631,16494,29842,0.4261443602975672,0.5527109443066819,0.021144695395750954
2004,MONTANA,LIBERTY,281,18,734,1033,0.27202323330106487,0.7105517909002904,0.017424975798644726
2004,MONTANA,LINCOLN,2320,238,5889,8447,0.2746537232153427,0.6971705931099799,0.0281756836746774
2004,MONTANA,MADISON,983,82,2868,3933,0.24993643529112636,0.7292143401983219,0.020849224510551743
2004,MONTANA,MCCONE,320,26,791,1137,0.28144239226033424,0.6956904133685137,0.022867194371152155
2004,MONTANA,MEAGHER,247,28,698,973,0.2538540596094553,0.7173689619732785,0.02877697841726619
2004,MONTANA,MINERAL,542,53,1242,1837,0.2950462710941753,0.6761023407729995,0.02885138813282526
2004,MONTANA,MISSOULA,26983,1480,23989,52452,0.5144322428124761,0.45735148326088615,0.028216273926637687
2004,MONTANA,MUSSELSHELL,538,46,1663,2247,0.2394303515798843,0.7400979083222073,0.020471740097908322
2004,MONTANA,PARK,3199,247,4771,8217,0.3893148350979676,0.5806255324327614,0.030059632469271024
2004,MONTANA,PETROLEUM,55,9,228,292,0.18835616438356165,0.7808219178082192,0.030821917808219176
2004,MONTANA,PHILLIPS,456,37,1677,2170,0.21013824884792626,0.772811059907834,0.017050691244239632
2004,MONTANA,PONDERA,956,51,1853,2860,0.33426573426573425,0.6479020979020979,0.01783216783216783
2004,MONTANA,POWDER RIVER,154,19,856,1029,0.14965986394557823,0.8318756073858115,0.0184645286686103
2004,MONTANA,POWELL,761,76,1993,2830,0.268904593639576,0.7042402826855124,0.02685512367491166
2004,MONTANA,PRAIRIE,181,9,546,736,0.24592391304347827,0.7418478260869565,0.012228260869565218
2004,MONTANA,RAVALLI,6144,443,13279,19866,0.3092721232256116,0.6684284707540521,0.022299406020336254
2004,MONTANA,RICHLAND,1120,78,3110,4308,0.25998142989786444,0.7219127205199629,0.018105849582172703
2004,MONTANA,ROOSEVELT,2195,71,1762,4028,0.54493545183714,0.4374379344587885,0.0176266137040715
2004,MONTANA,ROSEBUD,1520,83,1982,3585,0.42398884239888424,0.5528591352859136,0.02315202231520223
2004,MONTANA,SANDERS,1502,190,3461,5153,0.29148069085969336,0.6716475839316903,0.03687172520861634
2004,MONTANA,SHERIDAN,846,33,1159,2038,0.4151128557409225,0.5686947988223748,0.01619234543670265
2004,MONTANA,SILVER BOW,9307,396,6381,16084,0.5786495896543149,0.3967296692365083,0.024620741109176822
2004,MONTANA,STILLWATER,1025,98,3090,4213,0.2432945644433895,0.7334441015903157,0.023261333966294803
2004,MONTANA,SWEET GRASS,445,29,1509,1983,0.22440746343923348,0.7609682299546142,0.014624306606152295
2004,MONTANA,TETON,1047,80,2232,3359,0.3116999106877047,0.6644834772253647,0.023816612086930634
2004,MONTANA,TOOLE,690,38,1583,2311,0.298572046733016,0.6849848550411077,0.016443098225876245
2004,MONTANA,TREASURE,121,13,348,482,0.25103734439834025,0.7219917012448133,0.026970954356846474
2004,MONTANA,VALLEY,1431,111,2476,4018,0.3561473369835739,0.6162269785963166,0.027625684420109507
2004,MONTANA,WHEATLAND,250,23,706,979,0.2553626149131767,0.7211440245148111,0.02349336057201226
2004,MONTANA,WIBAUX,144,9,407,560,0.2571428571428571,0.7267857142857143,0.01607142857142857
2004,MONTANA,YELLOWSTONE,24120,1263,40903,66286,0.3638777419062849,0.6170684609118064,0.019053797181908697
2004,NEBRASKA,ADAMS,3791,262,9233,13286,0.2853379497215114,0.6949420442571127,0.019720006021375885
2004,NEBRASKA,ANTELOPE,613,50,2761,3424,0.1790303738317757,0.8063668224299065,0.014602803738317757
2004,NEBRASKA,ARTHUR,24,2,240,266,0.09022556390977443,0.9022556390977443,0.007518796992481203
2004,NEBRASKA,BANNER,56,2,379,437,0.12814645308924486,0.8672768878718535,0.004576659038901602
2004,NEBRASKA,BLAINE,38,0,301,339,0.11209439528023599,0.887905604719764,0.0
2004,NEBRASKA,BOONE,546,40,2309,2895,0.18860103626943006,0.7975820379965458,0.013816925734024179
2004,NEBRASKA,BOX BUTTE,1657,99,3396,5152,0.32162267080745344,0.6591614906832298,0.019215838509316772
2004,NEBRASKA,BOYD,228,9,911,1148,0.1986062717770035,0.7935540069686411,0.0078397212543554
2004,NEBRASKA,BROWN,268,39,1426,1733,0.15464512406231967,0.8228505481823427,0.022504327755337564
2004,NEBRASKA,BUFFALO,4100,286,14222,18608,0.220335339638865,0.7642949269131556,0.015369733447979364
2004,NEBRASKA,BURT,1272,47,2349,3668,0.346782988004362,0.6404034896401308,0.012813522355507088
2004,NEBRASKA,BUTLER,1068,84,3016,4168,0.2562380038387716,0.7236084452975048,0.02015355086372361
2004,NEBRASKA,CASS,3619,147,7763,11529,0.31390406800242865,0.6733454766241651,0.012750455373406194
2004,NEBRASKA,CEDAR,1083,66,3387,4536,0.23875661375661375,0.7466931216931217,0.01455026455026455
2004,NEBRASKA,CHASE,302,19,1652,1973,0.15306639635073493,0.8373035985808414,0.00963000506842372
2004,NEBRASKA,CHERRY,483,50,2509,3042,0.15877712031558186,0.8247863247863247,0.01643655489809336
2004,NEBRASKA,CHEYENNE,893,62,3791,4746,0.18815844922039612,0.7987779182469448,0.013063632532659082
2004,NEBRASKA,CLAY,743,51,2543,3337,0.2226550794126461,0.7620617320946959,0.015283188492658075
2004,NEBRASKA,COLFAX,990,54,2589,3633,0.27250206440957886,0.7126341866226259,0.01486374896779521
2004,NEBRASKA,CUMING,966,53,3330,4349,0.22212002759255,0.7656932628190388,0.01218670958841113
2004,NEBRASKA,CUSTER,1040,54,4518,5612,0.18531717747683535,0.8050605844618675,0.00962223806129722
2004,NEBRASKA,DAKOTA,3027,62,3526,6615,0.4575963718820862,0.5330309901738474,0.009372637944066516
2004,NEBRASKA,DAWES,1119,66,2809,3994,0.2801702553830746,0.7033049574361542,0.016524787180771158
2004,NEBRASKA,DAWSON,1728,79,6149,7956,0.2171945701357466,0.7728758169934641,0.00992961287078934
2004,NEBRASKA,DEUEL,222,11,820,1053,0.21082621082621084,0.7787274453941121,0.010446343779677113
2004,NEBRASKA,DIXON,938,43,2028,3009,0.31173147224991693,0.6739780658025922,0.014290461947490861
2004,NEBRASKA,DODGE,5250,206,10716,16172,0.32463517190205293,0.6626267623052189,0.012738065792728173
2004,NEBRASKA,DOUGLAS,83330,2928,120813,207071,0.4024223575488601,0.5834375648932009,0.014140077557939064
2004,NEBRASKA,DUNDY,186,9,858,1053,0.17663817663817663,0.8148148148148148,0.008547008547008548
2004,NEBRASKA,FILLMORE,828,51,2314,3193,0.25931725649859066,0.7247103037895396,0.015972439711869714
2004,NEBRASKA,FRANKLIN,412,25,1277,1714,0.24037339556592766,0.7450408401400234,0.014585764294049008
2004,NEBRASKA,FRONTIER,275,32,1160,1467,0.18745739604635311,0.7907293796864349,0.021813224267211998
2004,NEBRASKA,FURNAS,492,25,1950,2467,0.19943250912038912,0.7904337251722741,0.010133765707336847
2004,NEBRASKA,GAGE,3655,154,6575,10384,0.35198382126348227,0.6331856702619415,0.014830508474576272
2004,NEBRASKA,GARDEN,201,12,970,1183,0.16990701606086223,0.819949281487743,0.01014370245139476
2004,NEBRASKA,GARFIELD,196,15,806,1017,0.1927236971484759,0.7925270403146509,0.014749262536873156
2004,NEBRASKA,GOSPER,222,7,890,1119,0.19839142091152814,0.7953529937444147,0.006255585344057194
2004,NEBRASKA,GRANT,41,3,352,396,0.10353535353535354,0.8888888888888888,0.007575757575757576
2004,NEBRASKA,GREELEY,361,22,865,1248,0.28926282051282054,0.6931089743589743,0.017628205128205128
2004,NEBRASKA,HALL,6228,334,14592,21154,0.29441240427342347,0.6897986196464025,0.01578897608017396
2004,NEBRASKA,HAMILTON,1012,69,3785,4866,0.20797369502671598,0.7778462803123716,0.014180024660912454
2004,NEBRASKA,HARLAN,398,32,1467,1897,0.20980495519240908,0.7733263046916183,0.01686874011597259
2004,NEBRASKA,HAYES,66,8,524,598,0.11036789297658862,0.8762541806020067,0.013377926421404682
2004,NEBRASKA,HITCHCOCK,296,19,1171,1486,0.19919246298788695,0.7880215343203231,0.01278600269179004
2004,NEBRASKA,HOLT,894,63,4217,5174,0.17278701198299187,0.8150367220718979,0.012176265945110166
2004,NEBRASKA,HOOKER,64,5,392,461,0.13882863340563992,0.8503253796095445,0.010845986984815618
2004,NEBRASKA,HOWARD,900,59,2020,2979,0.3021148036253776,0.6780798925814031,0.019805303793219202
2004,NEBRASKA,JEFFERSON,1352,59,2600,4011,0.3370730491149339,0.6482174021441037,0.014709548740962353
2004,NEBRASKA,JOHNSON,885,39,1470,2394,0.36967418546365916,0.6140350877192983,0.016290726817042606
2004,NEBRASKA,KEARNEY,707,51,2621,3379,0.2092335010358094,0.7756732761171944,0.015093222846996152
2004,NEBRASKA,KEITH,743,38,3356,4137,0.1795987430505197,0.8112158569011361,0.00918540004834421
2004,NEBRASKA,KEYA PAHA,98,9,442,549,0.1785063752276867,0.8051001821493625,0.01639344262295082
2004,NEBRASKA,KIMBALL,366,20,1491,1877,0.1949920085242408,0.7943526904635055,0.010655301012253596
2004,NEBRASKA,KNOX,1086,65,3062,4213,0.2577735580346546,0.7267980061713744,0.015428435793971042
2004,NEBRASKA,LANCASTER,52747,1998,69764,124509,0.42364005814840694,0.5603129091069722,0.01604703274462087
2004,NEBRASKA,LINCOLN,4905,238,11056,16199,0.30279646891783446,0.6825112661275388,0.014692264954626829
2004,NEBRASKA,LOGAN,67,5,357,429,0.1561771561771562,0.8321678321678322,0.011655011655011656
2004,NEBRASKA,LOUP,68,4,314,386,0.17616580310880828,0.8134715025906736,0.010362694300518135
2004,NEBRASKA,MADISON,2934,174,10981,14089,0.20824756902548086,0.7794023706437646,0.01235006033075449
2004,NEBRASKA,MCPHERSON,49,4,259,312,0.15705128205128205,0.8301282051282052,0.01282051282051282
2004,NEBRASKA,MERRICK,833,53,2771,3657,0.2277823352474706,0.757724911129341,0.014492753623188406
2004,NEBRASKA,MORRILL,495,43,1755,2293,0.2158744003488879,0.765372873964239,0.01875272568687309
2004,NEBRASKA,NANCE,459,35,1237,1731,0.2651646447140381,0.7146158290005777,0.020219526285384173
2004,NEBRASKA,NEMAHA,1066,54,2595,3715,0.2869448183041723,0.6985195154777928,0.014535666218034994
2004,NEBRASKA,NUCKOLLS,541,46,1884,2471,0.2189397005261028,0.7624443545123432,0.018615944961554026
2004,NEBRASKA,OTOE,2275,93,5018,7386,0.3080151638234498,0.6793934470620092,0.012591389114541024
2004,NEBRASKA,PAWNEE,481,16,986,1483,0.32434254888739045,0.6648685097774781,0.01078894133513149
2004,NEBRASKA,PERKINS,262,11,1285,1558,0.1681643132220796,0.824775353016688,0.007060333761232349
2004,NEBRASKA,PHELPS,830,41,3872,4743,0.17499472907442548,0.8163609529833439,0.008644317942230655
2004,NEBRASKA,PIERCE,546,28,2824,3398,0.16068275456150677,0.8310771041789288,0.00824014125956445
2004,NEBRASKA,PLATTE,2657,200,11130,13987,0.18996210767140917,0.7957389004075213,0.014298991921069565
2004,NEBRASKA,POLK,549,32,2146,2727,0.20132013201320131,0.7869453612027869,0.011734506784011734
2004,NEBRASKA,RED WILLOW,1055,74,4129,5258,0.200646633701027,0.7852795739825028,0.01407379231647014
2004,NEBRASKA,RICHARDSON,1297,57,2924,4278,0.3031790556334736,0.6834969611968209,0.01332398316970547
2004,NEBRASKA,ROCK,130,13,740,883,0.14722536806342015,0.8380520951302378,0.014722536806342015
2004,NEBRASKA,SALINE,2420,75,3071,5566,0.43478260869565216,0.5517427236794826,0.013474667624865252
2004,NEBRASKA,SARPY,17455,716,40163,58334,0.2992251517125519,0.6885007028491102,0.012274145438337847
2004,NEBRASKA,SAUNDERS,2884,164,6441,9489,0.3039308673200548,0.6787859626936453,0.017283169986299925
2004,NEBRASKA,SCOTTS BLUFF,3843,169,10378,14390,0.2670604586518416,0.7211952744961779,0.011744266851980541
2004,NEBRASKA,SEWARD,2114,98,5353,7565,0.27944481163251816,0.7076007931262392,0.012954395241242565
2004,NEBRASKA,SHERIDAN,430,33,2136,2599,0.1654482493266641,0.8218545594459408,0.012697191227395151
2004,NEBRASKA,SHERMAN,541,30,1072,1643,0.3292757151552039,0.6524650030432136,0.018259281801582473
2004,NEBRASKA,SIOUX,123,9,677,809,0.15203955500618047,0.8368355995055624,0.011124845488257108
2004,NEBRASKA,STANTON,559,27,2159,2745,0.20364298724954463,0.7865209471766849,0.009836065573770493
2004,NEBRASKA,THAYER,764,39,2075,2878,0.26546212647671996,0.7209867963863794,0.013551077136900626
2004,NEBRASKA,THOMAS,60,6,378,444,0.13513513513513514,0.8513513513513513,0.013513513513513514
2004,NEBRASKA,THURSTON,1212,21,1154,2387,0.5077503142019271,0.4834520318391286,0.008797653958944282
2004,NEBRASKA,VALLEY,564,26,1801,2391,0.23588456712672523,0.753241321622752,0.010874111250522794
2004,NEBRASKA,WASHINGTON,2754,113,7083,9950,0.2767839195979899,0.7118592964824121,0.01135678391959799
2004,NEBRASKA,WAYNE,1059,55,2971,4085,0.2592411260709914,0.7272949816401468,0.01346389228886169
2004,NEBRASKA,WEBSTER,557,42,1403,2002,0.27822177822177824,0.7007992007992008,0.02097902097902098
2004,NEBRASKA,WHEELER,81,6,366,453,0.17880794701986755,0.8079470198675497,0.013245033112582781
2004,NEBRASKA,YORK,1304,100,5393,6797,0.1918493452993968,0.7934382815948212,0.014712373105781962
2004,NEVADA,CARSON CITY,9441,494,13171,23106,0.408595170085692,0.5700251017051848,0.02137972820912317
2004,NEVADA,CHURCHILL,2705,197,7335,10237,0.2642375696004689,0.7165185112826024,0.019243919116928788
2004,NEVADA,CLARK,281767,8293,255337,545397,0.5166273375174414,0.46816722497556823,0.01520543750699032
2004,NEVADA,DOUGLAS,8275,431,15192,23898,0.3462632856305967,0.6357017323625408,0.018034982006862498
2004,NEVADA,ELKO,3050,321,11938,15309,0.1992292115748906,0.7798027304200144,0.020968058005095044
2004,NEVADA,ESMERALDA,99,15,367,481,0.20582120582120583,0.762993762993763,0.031185031185031187
2004,NEVADA,EUREKA,144,23,571,738,0.1951219512195122,0.7737127371273713,0.03116531165311653
2004,NEVADA,HUMBOLDT,1361,110,3896,5367,0.25358673374324575,0.7259176448667785,0.02049562138997578
2004,NEVADA,LANDER,414,37,1602,2053,0.20165611300535802,0.7803214807598636,0.01802240623477837
2004,NEVADA,LINCOLN,418,50,1579,2047,0.20420127015144113,0.7713727405959941,0.024425989252564728
2004,NEVADA,LYON,5637,378,11136,17151,0.32866888228091656,0.6492915864964142,0.02203953122266923
2004,NEVADA,MINERAL,931,60,1336,2327,0.40008594757198107,0.5741297808336915,0.02578427159432746
2004,NEVADA,NYE,5616,407,8487,14510,0.3870434183321847,0.5849069607167471,0.02804962095106823
2004,NEVADA,PERSHING,538,38,1341,1917,0.2806468440271257,0.6995305164319249,0.0198226395409494
2004,NEVADA,STOREY,871,44,1253,2168,0.4017527675276753,0.5779520295202952,0.02029520295202952
2004,NEVADA,WASHOE,74841,2693,81545,159079,0.47046436047498413,0.512606943719787,0.01692869580522885
2004,NEVADA,WHITE PINE,1082,116,2604,3802,0.28458705944239876,0.6849026827985271,0.03051025775907417
2004,NEW HAMPSHIRE,BELKNAP,14080,298,17920,32298,0.4359403059012942,0.5548331166016471,0.009226577497058642
2004,NEW HAMPSHIRE,CARROLL,13319,289,14614,28222,0.4719367869038339,0.5178229749840549,0.01024023811211112
2004,NEW HAMPSHIRE,CHESHIRE,24438,436,16463,41337,0.591189491254808,0.39826305730943223,0.010547451435759731
2004,NEW HAMPSHIRE,COOS,8585,191,8143,16919,0.5074176960813287,0.4812932206395177,0.011289083279153614
2004,NEW HAMPSHIRE,GRAFTON,26180,505,20277,46962,0.557471998637196,0.4317746262935991,0.010753375069204889
2004,NEW HAMPSHIRE,HILLSBOROUGH,94121,1582,99724,195427,0.4816171767463042,0.5102877289217969,0.008095094331898868
2004,NEW HAMPSHIRE,MERRIMACK,39975,620,36060,76655,0.5214924010175461,0.47041941164959883,0.008088187332854999
2004,NEW HAMPSHIRE,ROCKINGHAM,75437,1260,82069,158766,0.47514581207563333,0.516917979920134,0.007936208004232644
2004,NEW HAMPSHIRE,STRAFFORD,32942,513,25825,59280,0.5557017543859649,0.43564439946018896,0.008653846153846154
2004,NEW HAMPSHIRE,SULLIVAN,11434,220,10142,21796,0.5245916681959992,0.4653147366489264,0.010093595155074325
2004,NEW JERSEY,ATLANTIC,55746,864,49487,106097,0.525424847073904,0.4664316615926935,0.008143491333402452
2004,NEW JERSEY,BERGEN,207666,2745,189833,400244,0.5188485024135278,0.4742931811594927,0.006858316426979543
2004,NEW JERSEY,BURLINGTON,110411,1609,95936,207956,0.5309344284367847,0.4613283579218681,0.007737213641347208
2004,NEW JERSEY,CAMDEN,137765,1741,81427,220933,0.6235600838263183,0.36855969909429553,0.007880217079386059
2004,NEW JERSEY,CAPE MAY,21475,455,28832,50762,0.4230526771994799,0.5679839249832552,0.008963397817264884
2004,NEW JERSEY,CUMBERLAND,27875,948,24362,53185,0.5241139419009119,0.45806148350098713,0.017824574598100967
2004,NEW JERSEY,ESSEX,203681,2293,83374,289348,0.7039309067282303,0.28814437977798363,0.00792471349378603
2004,NEW JERSEY,GLOUCESTER,66835,1096,60033,127964,0.5222953330624238,0.4691397580569535,0.008564908880622675
2004,NEW JERSEY,HUDSON,127447,1353,60646,189446,0.6727352385376307,0.32012288462147526,0.007141876840893975
2004,NEW JERSEY,HUNTERDON,26050,742,39888,66680,0.3906718656268746,0.5982003599280143,0.011127774445110978
2004,NEW JERSEY,MERCER,91580,1326,56604,149510,0.612534278643569,0.37859674938131227,0.008868971975118722
2004,NEW JERSEY,MIDDLESEX,166628,2685,126492,295805,0.5633035276618042,0.4276195466608069,0.00907692567738882
2004,NEW JERSEY,MONMOUTH,133773,2516,163650,299939,0.44600068680631727,0.5456109408913146,0.008388372302368148
2004,NEW JERSEY,MORRIS,98066,1847,135241,235154,0.41702884067462176,0.5751167320139143,0.007854427311463977
2004,NEW JERSEY,OCEAN,99839,2263,152204,254306,0.3925939616053101,0.5985073100909928,0.008898728303697121
2004,NEW JERSEY,PASSAIC,94962,1149,75200,171311,0.5543251746823029,0.43896772536497947,0.006707099952717572
2004,NEW JERSEY,SALEM,13749,311,15721,29781,0.46167019240455326,0.5278869077599811,0.010442899835465565
2004,NEW JERSEY,SOMERSET,66476,1295,72508,140279,0.4738841879397486,0.5168842093257009,0.009231602734550431
2004,NEW JERSEY,SUSSEX,23990,900,44506,69396,0.34569715833765635,0.6413337944550118,0.012969047207331835
2004,NEW JERSEY,UNION,119372,1498,82517,203387,0.5869205013103099,0.40571422952302755,0.007365269166662569
2004,NEW JERSEY,WARREN,18044,622,29542,48208,0.37429472286757387,0.6128028542980418,0.012902422834384334
2004,NEW MEXICO,BERNALILLO,132252,3105,121454,256811,0.5149779409760485,0.4729314554283111,0.012090603595640374
2004,NEW MEXICO,CATRON,551,15,1427,1993,0.2764676367285499,0.7160060210737581,0.007526342197691922
2004,NEW MEXICO,CHAVES,6726,206,14773,21705,0.3098825155494126,0.6806265837364662,0.00949090071412117
2004,NEW MEXICO,CIBOLA,3913,97,3477,7487,0.5226392413516763,0.46440496861226127,0.012955790036062509
2004,NEW MEXICO,COLFAX,2824,62,3082,5968,0.47319034852546915,0.5164209115281502,0.010388739946380697
2004,NEW MEXICO,CURRY,3541,96,10649,14286,0.24786504269914603,0.745415091698166,0.006719865602687947
2004,NEW MEXICO,DE BACA,281,6,706,993,0.28298086606243705,0.7109768378650554,0.006042296072507553
2004,NEW MEXICO,DONA ANA,31762,650,29548,61960,0.5126210458360232,0.47688831504196255,0.010490639122014202
2004,NEW MEXICO,EDDY,6880,122,13268,20270,0.3394178589047854,0.654563394178589,0.006018746916625555
2004,NEW MEXICO,GRANT,7095,162,6135,13392,0.5297939068100358,0.45810931899641577,0.012096774193548387
2004,NEW MEXICO,GUADALUPE,1340,13,914,2267,0.5910895456550507,0.4031760035288928,0.005734450816056462
2004,NEW MEXICO,HARDING,259,5,380,644,0.40217391304347827,0.5900621118012422,0.007763975155279503
2004,NEW MEXICO,HIDALGO,861,22,1081,1964,0.43839103869653767,0.5504073319755601,0.01120162932790224
2004,NEW MEXICO,LEA,3646,105,14430,18181,0.20053902425609152,0.7936857158572136,0.005775259886694901
2004,NEW MEXICO,LINCOLN,2822,122,6070,9014,0.3130685600177502,0.6733969380962946,0.013534501885955182
2004,NEW MEXICO,LOS ALAMOS,5206,181,5810,11197,0.4649459676699116,0.5188889881218184,0.01616504420827007
2004,NEW MEXICO,LUNA,3340,89,4164,7593,0.439878835769788,0.5483998419596997,0.011721322270512313
2004,NEW MEXICO,MCKINLEY,13051,221,7351,20623,0.6328371235998642,0.3564466857392232,0.010716190660912573
2004,NEW MEXICO,MORA,1876,22,928,2826,0.6638358103326256,0.3283793347487615,0.00778485491861288
2004,NEW MEXICO,OTERO,6433,265,14066,20764,0.3098150645347717,0.6774224619533809,0.012762473511847429
2004,NEW MEXICO,QUAY,1422,34,2661,4117,0.345397133835317,0.6463444255525869,0.008258440612096187
2004,NEW MEXICO,RIO ARRIBA,9753,97,5149,14999,0.6502433495566371,0.34328955263684247,0.006467097806520434
2004,NEW MEXICO,ROOSEVELT,2082,65,4997,7144,0.2914333706606943,0.699468085106383,0.009098544232922732
2004,NEW MEXICO,SAN JUAN,14843,638,29525,45006,0.3298004710483047,0.6560236412922721,0.014175887659423188
2004,NEW MEXICO,SAN MIGUEL,8683,120,3313,12116,0.7166556619346319,0.27344007923407065,0.009904258831297457
2004,NEW MEXICO,SANDOVAL,21421,492,22628,44541,0.4809276846051952,0.5080263128353651,0.011046002559439617
2004,NEW MEXICO,SANTA FE,47074,660,18466,66200,0.7110876132930514,0.27894259818731115,0.009969788519637462
2004,NEW MEXICO,SIERRA,1926,69,3162,5157,0.37347294938917974,0.6131471785922048,0.013379872018615475
2004,NEW MEXICO,SOCORRO,4025,130,3696,7851,0.5126735447713667,0.4707680550248376,0.016558400203795696
2004,NEW MEXICO,TAOS,10987,182,3666,14835,0.740613414223121,0.24711830131445905,0.012268284462419952
2004,NEW MEXICO,TORRANCE,2386,95,4026,6507,0.36668203473182726,0.6187183033656063,0.014599661902566468
2004,NEW MEXICO,UNION,411,16,1454,1881,0.21850079744816586,0.7729930887825625,0.008506113769271665
2004,NEW MEXICO,VALENCIA,11270,268,14474,26012,0.4332615715823466,0.5564354913117023,0.0103029371059511
2004,NEW YORK,ALBANY,86213,8617,52369,147199,0.5856901201774468,0.3557700799597823,0.05853979986277081
2004,NEW YORK,ALLEGANY,6392,984,11894,19270,0.33170731707317075,0.6172288531395952,0.05106382978723404
2004,NEW YORK,BRONX,276938,12253,53738,342929,0.8075665808374328,0.15670299099813664,0.03573042816443054
2004,NEW YORK,BROOME,44496,5294,42100,91890,0.4842311459353575,0.4581564914571771,0.057612362607465446
2004,NEW YORK,CATTARAUGUS,13087,2147,19028,34262,0.3819683614500029,0.5553674624948923,0.06266417605510478
2004,NEW YORK,CAYUGA,16913,2513,16626,36052,0.4691279263286364,0.4611672029291024,0.06970487074226119
2004,NEW YORK,CHAUTAUQUA,26369,3839,30734,60942,0.4326900987824489,0.5043155787470054,0.06299432247054576
2004,NEW YORK,CHEMUNG,16639,1694,20742,39075,0.4258221369161868,0.5308253358925143,0.043352527191298784
2004,NEW YORK,CHENANGO,9003,1194,11144,21341,0.4218640176186683,0.5221873389250739,0.055948643456257906
2004,NEW YORK,CLINTON,17040,2063,14633,33736,0.5050984111927911,0.4337502964192554,0.06115129238795352
2004,NEW YORK,COLUMBIA,15238,2540,13325,31103,0.4899205864386072,0.4284152654084815,0.0816641481529113
2004,NEW YORK,CORTLAND,10354,1321,11085,22760,0.454920913884007,0.48703866432337434,0.05804042179261863
2004,NEW YORK,DELAWARE,8425,1267,11474,21166,0.39804403288292545,0.5420958140413872,0.05986015307568742
2004,NEW YORK,DUTCHESS,56533,8025,59323,123881,0.45634923838199565,0.47887085186590356,0.06477990975210081
2004,NEW YORK,ERIE,240563,31377,173198,445138,0.5404234192542537,0.38908832766467927,0.070488253081067
2004,NEW YORK,ESSEX,8474,1218,9390,19082,0.4440834294099151,0.49208678335604233,0.06382978723404255
2004,NEW YORK,FRANKLIN,9286,927,8103,18316,0.5069884254203975,0.4424000873553178,0.050611487224284775
2004,NEW YORK,FULTON,8919,1254,12042,22215,0.4014854827819041,0.5420661715057393,0.05644834571235652
2004,NEW YORK,GENESEE,9970,1909,15701,27580,0.36149383611312547,0.5692893401015229,0.06921682378535171
2004,NEW YORK,GREENE,8607,1632,12159,22398,0.3842753817305117,0.5428609697294401,0.07286364854004822
2004,NEW YORK,HAMILTON,1120,214,2358,3692,0.30335861321776814,0.6386782231852655,0.05796316359696641
2004,NEW YORK,HERKIMER,11383,1662,15265,28310,0.4020840692334864,0.5392087601554221,0.058707170611091486
2004,NEW YORK,JEFFERSON,16342,2210,20248,38800,0.4211855670103093,0.5218556701030928,0.05695876288659794
2004,NEW YORK,KINGS,494165,34415,159200,687780,0.7184928320102358,0.23146936520398964,0.05003780278577452
2004,NEW YORK,LEWIS,4417,632,6348,11397,0.3875581293322804,0.5569886812319031,0.055453189435816445
2004,NEW YORK,LIVINGSTON,11107,1956,16885,29948,0.3708761853880059,0.5638106050487511,0.06531320956324295
2004,NEW YORK,MADISON,12665,2038,15584,30287,0.4181662099250503,0.5145441938785618,0.06728959619638789
2004,NEW YORK,MONROE,168088,21519,153374,342981,0.4900796254019902,0.4471792898148877,0.0627410847831221
2004,NEW YORK,MONTGOMERY,9175,1283,10763,21221,0.4323547429433109,0.5071862777437444,0.06045897931294472
2004,NEW YORK,NASSAU,317283,27558,273502,618343,0.5131181237597903,0.44231437891267467,0.04456749732753504
2004,NEW YORK,NEW YORK,509841,27023,104883,641747,0.794457940590295,0.16343356494070094,0.04210849446900414
2004,NEW YORK,NIAGARA,45644,6411,44525,96580,0.4726030234002899,0.4610167736591427,0.0663802029405674
2004,NEW YORK,ONEIDA,39658,6142,49569,95369,0.4158374314504713,0.5197600897566295,0.06440247879289916
2004,NEW YORK,ONONDAGA,112618,13848,88123,214589,0.5248078885683796,0.41065944666315607,0.06453266476846437
2004,NEW YORK,ONTARIO,20503,2988,26611,50102,0.4092251806315117,0.5311364815775818,0.05963833779090655
2004,NEW YORK,ORANGE,61642,8021,75010,144673,0.4260781210039192,0.5184796057315463,0.0554422732645345
2004,NEW YORK,ORLEANS,5734,1043,9796,16573,0.3459844325107102,0.591081880166536,0.06293368732275388
2004,NEW YORK,OSWEGO,23261,3671,24675,51607,0.45073342763578583,0.4781328114403085,0.07113376092390568
2004,NEW YORK,OTSEGO,12402,1482,12768,26652,0.46533093201260695,0.4790634849167042,0.05560558307068888
2004,NEW YORK,PUTNAM,18892,3274,24397,46563,0.4057298713570861,0.5239567897257479,0.07031333891716599
2004,NEW YORK,QUEENS,422609,24505,157948,605062,0.698455695449392,0.26104432273056316,0.04049998182004489
2004,NEW YORK,RENSSELAER,34741,5483,32290,72514,0.47909369225253057,0.44529332266872607,0.07561298507874341
2004,NEW YORK,RICHMOND,66255,8569,85302,160126,0.41376790777262906,0.5327179845871376,0.053514107640233316
2004,NEW YORK,ROCKLAND,62391,7330,61510,131231,0.47542882398213837,0.46871547119202017,0.05585570482584146
2004,NEW YORK,SARATOGA,47367,5797,53709,106873,0.4432082939563781,0.5025497553170586,0.05424195072656331
2004,NEW YORK,SCHENECTADY,34762,4705,30002,69469,0.5003958600238956,0.4318760886150657,0.06772805136103874
2004,NEW YORK,SCHOHARIE,5455,954,8148,14557,0.37473380504224774,0.5597307137459642,0.06553548121178815
2004,NEW YORK,SCHUYLER,3290,573,4727,8590,0.3830034924330617,0.550291036088475,0.06670547147846333
2004,NEW YORK,SENECA,6771,951,7603,15325,0.4418270799347471,0.4961174551386623,0.06205546492659054
2004,NEW YORK,ST. LAWRENCE,22173,2272,17310,41755,0.531026224404263,0.4145611304035445,0.05441264519219255
2004,NEW YORK,STEUBEN,14090,2128,26066,42284,0.3332229684987229,0.6164506669189291,0.05032636458234793
2004,NEW YORK,SUFFOLK,307011,39515,292186,638712,0.48067203998046065,0.4574612657974173,0.06186669422212202
2004,NEW YORK,SULLIVAN,14447,2121,14398,30966,0.4665439514306013,0.46496157075502165,0.06849447781437706
2004,NEW YORK,TIOGA,9415,1144,13343,23902,0.3939000920425069,0.5582378043678353,0.04786210358965777
2004,NEW YORK,TOMPKINS,25659,3204,13539,42402,0.6051365501627282,0.3193009763690392,0.07556247346823262
2004,NEW YORK,ULSTER,45530,6948,35234,87712,0.5190851878876322,0.4017010215249909,0.07921379058737688
2004,NEW YORK,WARREN,13054,1792,16213,31059,0.4202968543739335,0.5220065037509256,0.05769664187514086
2004,NEW YORK,WASHINGTON,10295,1660,13148,25103,0.41011034537704655,0.5237621001473928,0.0661275544755607
2004,NEW YORK,WAYNE,15093,2981,23126,41200,0.3663349514563107,0.5613106796116505,0.07235436893203884
2004,NEW YORK,WESTCHESTER,224992,19517,151261,395770,0.5684918007933901,0.3821942037041716,0.049313995502438285
2004,NEW YORK,WYOMING,5894,1085,11185,18164,0.3244879982382735,0.6157784628936358,0.05973353886809073
2004,NEW YORK,YATES,4062,596,6053,10711,0.37923629913173373,0.5651199701241714,0.05564373074409486
2004,NORTH CAROLINA,ALAMANCE,20686,187,33302,54175,0.3818366405168436,0.6147115828334102,0.0034517766497461928
2004,NORTH CAROLINA,ALEXANDER,4618,54,10928,15600,0.29602564102564105,0.7005128205128205,0.0034615384615384616
2004,NORTH CAROLINA,ALLEGHANY,1922,22,2883,4827,0.39817692148332295,0.5972653822249845,0.0045576962916925624
2004,NORTH CAROLINA,ANSON,5413,16,3796,9225,0.5867750677506776,0.41149051490514904,0.0017344173441734417
2004,NORTH CAROLINA,ASHE,4477,54,7292,11823,0.3786686966083058,0.616763934703544,0.004567368688150216
2004,NORTH CAROLINA,AVERY,1805,41,5678,7524,0.2398989898989899,0.7546517809675705,0.005449229133439659
2004,NORTH CAROLINA,BEAUFORT,7025,65,12432,19522,0.3598504251613564,0.6368199979510296,0.003329576887613974
2004,NORTH CAROLINA,BERTIE,4938,37,3057,8032,0.6147908366533864,0.3806025896414343,0.004606573705179283
2004,NORTH CAROLINA,BLADEN,6109,30,6174,12313,0.49614228863802484,0.5014212620807277,0.002436449281247462
2004,NORTH CAROLINA,BRUNSWICK,14903,149,22925,37977,0.39242172894120125,0.6036548437211997,0.003923427337599073
2004,NORTH CAROLINA,BUNCOMBE,51868,654,52491,105013,0.4939198004056641,0.4998523992267624,0.006227800367573539
2004,NORTH CAROLINA,BURKE,11728,112,18922,30762,0.38124959365450883,0.615109550744425,0.0036408556010662507
2004,NORTH CAROLINA,CABARRUS,19803,241,40780,60824,0.32557871892673945,0.6704590293305275,0.003962251742733132
2004,NORTH CAROLINA,CALDWELL,9999,163,21186,31348,0.3189677172387393,0.6758325890008932,0.005199693760367488
2004,NORTH CAROLINA,CAMDEN,1339,11,2480,3830,0.3496083550913838,0.6475195822454308,0.0028720626631853785
2004,NORTH CAROLINA,CARTERET,7732,127,17716,25575,0.30232649071358747,0.6927077223851418,0.004965786901270772
2004,NORTH CAROLINA,CASWELL,4539,30,4868,9437,0.48097912472183957,0.5158418989085515,0.003178976369608986
2004,NORTH CAROLINA,CATAWBA,18858,228,39602,58688,0.3213263358778626,0.6747887131952017,0.0038849509269356596
2004,NORTH CAROLINA,CHATHAM,12897,133,12892,25922,0.49753105470256925,0.4973381683512075,0.005130776946223286
2004,NORTH CAROLINA,CHEROKEE,3635,47,7517,11199,0.32458255201357267,0.6712206447004196,0.004196803286007679
2004,NORTH CAROLINA,CHOWAN,2406,13,2967,5386,0.4467137021908652,0.5508726327515782,0.0024136650575566285
2004,NORTH CAROLINA,CLAY,1628,29,3209,4866,0.33456637895602137,0.6594739005343198,0.005959720509658858
2004,NORTH CAROLINA,CLEVELAND,14215,114,22750,37079,0.38337064106367486,0.613554842363602,0.003074516572723105
2004,NORTH CAROLINA,COLUMBUS,10343,75,10773,21191,0.48808456420178375,0.5083761974423104,0.0035392383559058093
2004,NORTH CAROLINA,CRAVEN,14019,162,23575,37756,0.3713052230109122,0.6244040682275664,0.0042907087615213476
2004,NORTH CAROLINA,CUMBERLAND,45788,299,49139,95226,0.48083506605338877,0.5160250351794677,0.0031398987671434272
2004,NORTH CAROLINA,CURRITUCK,2909,54,6013,8976,0.32408645276292336,0.669897504456328,0.006016042780748663
2004,NORTH CAROLINA,DARE,6136,67,9345,15548,0.39464882943143814,0.6010419346539748,0.0043092359145870856
2004,NORTH CAROLINA,DAVIDSON,17191,230,42075,59496,0.2889437945408095,0.7071903993545785,0.003865806104612075
2004,NORTH CAROLINA,DAVIE,4233,75,12372,16680,0.2537769784172662,0.741726618705036,0.0044964028776978415
2004,NORTH CAROLINA,DUPLIN,6923,49,9611,16583,0.4174757281553398,0.5795694385816801,0.0029548332629801602
2004,NORTH CAROLINA,DURHAM,74524,513,34614,109651,0.6796472444391752,0.31567427565640077,0.004678479904424037
2004,NORTH CAROLINA,EDGECOMBE,12877,39,8163,21079,0.6108923573224536,0.3872574600313108,0.00185018264623559
2004,NORTH CAROLINA,FORSYTH,63340,491,75294,139125,0.45527403414195866,0.5411967654986523,0.0035292003593890386
2004,NORTH CAROLINA,FRANKLIN,9286,92,11540,20918,0.4439238932976384,0.5516779806864901,0.004398126015871498
2004,NORTH CAROLINA,GASTON,20254,249,43252,63755,0.31768488745980705,0.6784095365069406,0.0039055760332522937
2004,NORTH CAROLINA,GATES,2121,8,1924,4053,0.5233160621761658,0.47471009129040215,0.0019738465334320256
2004,NORTH CAROLINA,GRAHAM,1272,22,2693,3987,0.3190368698269376,0.6754451968898921,0.005517933283170303
2004,NORTH CAROLINA,GRANVILLE,9057,53,9491,18601,0.48690930595129295,0.5102413848717811,0.0028493091769259717
2004,NORTH CAROLINA,GREENE,2665,7,3800,6472,0.4117737948084054,0.5871446229913473,0.0010815822002472187
2004,NORTH CAROLINA,GUILFORD,100042,1018,98254,199314,0.5019316254753805,0.4929608557351716,0.005107518789447806
2004,NORTH CAROLINA,HALIFAX,11528,31,8088,19647,0.5867562477731969,0.4116659031913269,0.0015778490354761542
2004,NORTH CAROLINA,HARNETT,11563,86,20922,32571,0.3550090571367167,0.6423505572441742,0.0026403856191090235
2004,NORTH CAROLINA,HAYWOOD,11237,150,14545,25932,0.4333256208545426,0.5608900200524448,0.005784359093012495
2004,NORTH CAROLINA,HENDERSON,15003,206,28025,43234,0.34701855021510847,0.6482166813156313,0.004764768469260304
2004,NORTH CAROLINA,HERTFORD,5141,49,2942,8132,0.632193802262666,0.3617806197737334,0.006025577963600591
2004,NORTH CAROLINA,HOKE,5794,37,5257,11088,0.5225468975468975,0.4741161616161616,0.003336940836940837
2004,NORTH CAROLINA,HYDE,1048,10,1235,2293,0.4570431748800698,0.538595726122983,0.00436109899694723
2004,NORTH CAROLINA,IREDELL,18065,233,38675,56973,0.31708002036052163,0.6788303231355204,0.004089656503958016
2004,NORTH CAROLINA,JACKSON,6737,86,7351,14174,0.47530689995766895,0.5186256526033582,0.006067447438972767
2004,NORTH CAROLINA,JOHNSTON,17266,188,36903,54357,0.3176407822359586,0.6789006015784536,0.0034586161855878726
2004,NORTH CAROLINA,JONES,1893,13,2607,4513,0.4194549080434301,0.5776645247064037,0.0028805672501661865
2004,NORTH CAROLINA,LEE,7657,52,11834,19543,0.3918026915007931,0.6055365092360436,0.002660799263163281
2004,NORTH CAROLINA,LENOIR,10207,33,12939,23179,0.4403554941973338,0.558220803313344,0.0014237024893222314
2004,NORTH CAROLINA,LINCOLN,9434,93,20052,29579,0.3189424929848879,0.6779133844957571,0.0031441225193549476
2004,NORTH CAROLINA,MACON,5489,87,9448,15024,0.36534877529286475,0.6288604898828541,0.00579073482428115
2004,NORTH CAROLINA,MADISON,4234,54,5175,9463,0.44742682024727887,0.546866744161471,0.005706435591250132
2004,NORTH CAROLINA,MARTIN,5102,16,5334,10452,0.48813624186758514,0.5103329506314581,0.0015308075009567547
2004,NORTH CAROLINA,MCDOWELL,5330,82,10590,16002,0.33308336457942755,0.6617922759655043,0.005124359455068116
2004,NORTH CAROLINA,MECKLENBURG,166828,1190,155084,323102,0.5163323037307104,0.47998464881059233,0.0036830474586972534
2004,NORTH CAROLINA,MITCHELL,2080,32,5686,7798,0.26673506027186455,0.7291613234162606,0.004103616311874839
2004,NORTH CAROLINA,MONTGOMERY,4313,22,5745,10080,0.4278769841269841,0.5699404761904762,0.0021825396825396826
2004,NORTH CAROLINA,MOORE,13555,113,24714,38382,0.353160335573967,0.643895576051274,0.0029440883747590017
2004,NORTH CAROLINA,NASH,15693,78,21902,37673,0.41655827781169535,0.5813712738566081,0.0020704483316964406
2004,NORTH CAROLINA,NEW HANOVER,35572,324,45351,81247,0.4378253966300294,0.5581867638189718,0.0039878395509988064
2004,NORTH CAROLINA,NORTHAMPTON,5584,10,3176,8770,0.6367160775370582,0.3621436716077537,0.0011402508551881414
2004,NORTH CAROLINA,ONSLOW,11250,137,25890,37277,0.30179467231805135,0.6945301392279422,0.003675188454006492
2004,NORTH CAROLINA,ORANGE,42910,472,20771,64153,0.6688697332938444,0.323772855517279,0.007357411188876592
2004,NORTH CAROLINA,PAMLICO,2335,24,3679,6038,0.38671745611129515,0.6093077177873468,0.003974826101358066
2004,NORTH CAROLINA,PASQUOTANK,6984,55,6609,13648,0.5117233294255569,0.48424677608440797,0.00402989449003517
2004,NORTH CAROLINA,PENDER,6999,49,10037,17085,0.409657594381036,0.5874743927421715,0.002868012876792508
2004,NORTH CAROLINA,PERQUIMANS,1971,22,2965,4958,0.39753933037515127,0.5980233965308592,0.004437273093989512
2004,NORTH CAROLINA,PERSON,6198,43,8973,15214,0.4073879321677402,0.589785723675562,0.002826344156697778
2004,NORTH CAROLINA,PITT,24924,129,28590,53643,0.46462725798333426,0.5329679548123707,0.002404787204295062
2004,NORTH CAROLINA,POLK,3787,94,5140,9021,0.41979824853120495,0.5697816206628977,0.01042013080589735
2004,NORTH CAROLINA,RANDOLPH,12966,173,37771,50910,0.25468473777253975,0.7419171086230603,0.0033981536043999213
2004,NORTH CAROLINA,RICHMOND,8383,53,7709,16145,0.5192319603592443,0.4774852895633323,0.003282750077423351
2004,NORTH CAROLINA,ROBESON,17868,94,15909,33871,0.5275309261610227,0.4696938383868206,0.0027752354521567123
2004,NORTH CAROLINA,ROCKINGHAM,14430,118,22840,37388,0.3859527121001391,0.6108911950358403,0.0031560928640205414
2004,NORTH CAROLINA,ROWAN,16735,217,34915,51867,0.32265216804519253,0.6731640542155899,0.004183777739217615
2004,NORTH CAROLINA,RUTHERFORD,8184,131,16343,24658,0.3319003974369373,0.6627869251358586,0.005312677427204153
2004,NORTH CAROLINA,SAMPSON,9649,39,12600,22288,0.4329235463029433,0.5653266331658291,0.0017498205312275663
2004,NORTH CAROLINA,SCOTLAND,6386,20,5141,11547,0.5530440807136052,0.4452238676712566,0.001732051615138131
2004,NORTH CAROLINA,STANLY,7650,89,17814,25553,0.29937776386334286,0.6971392791453058,0.003482956991351309
2004,NORTH CAROLINA,STOKES,5767,64,13583,19414,0.29705367260739673,0.6996497373029772,0.003296590089626043
2004,NORTH CAROLINA,SURRY,8304,101,17587,25992,0.31948291782086796,0.676631271160357,0.003885811018775008
2004,NORTH CAROLINA,SWAIN,2419,32,2593,5044,0.4795796986518636,0.5140761300555114,0.006344171292624901
2004,NORTH CAROLINA,TRANSYLVANIA,6097,105,9386,15588,0.39113420579933283,0.6021298434693354,0.006735950731331794
2004,NORTH CAROLINA,TYRRELL,731,4,855,1590,0.459748427672956,0.5377358490566038,0.0025157232704402514
2004,NORTH CAROLINA,UNION,17974,207,42820,61001,0.29465090736217436,0.7019557056441698,0.0033933869936558416
2004,NORTH CAROLINA,VANCE,8762,31,6884,15677,0.5589079543279964,0.4391146265229317,0.0019774191490718887
2004,NORTH CAROLINA,WAKE,169909,1611,177324,348844,0.48706298517388863,0.5083189047253214,0.004618110100790038
2004,NORTH CAROLINA,WARREN,5171,16,2840,8027,0.6442008222249906,0.35380590507038745,0.001993272704621901
2004,NORTH CAROLINA,WASHINGTON,2969,18,2484,5471,0.5426795832571741,0.45403034180222995,0.003290074940595869
2004,NORTH CAROLINA,WATAUGA,11232,159,12659,24050,0.46702702702702703,0.5263617463617464,0.006611226611226611
2004,NORTH CAROLINA,WAYNE,15076,87,24883,40046,0.37646706287769066,0.621360435499176,0.0021725016231333967
2004,NORTH CAROLINA,WILKES,7862,95,19197,27154,0.2895337703469102,0.7069676659055756,0.0034985637475141783
2004,NORTH CAROLINA,WILSON,14206,65,16264,30535,0.4652366137219584,0.5326346815130178,0.002128704765023743
2004,NORTH CAROLINA,YADKIN,3451,46,11816,15313,0.2253640697446614,0.7716319467119441,0.0030039835433945013
2004,NORTH CAROLINA,YANCEY,4434,57,4940,9431,0.4701516276110699,0.523804474605026,0.006043897783904146
2004,NORTH DAKOTA,ADAMS,353,23,915,1291,0.273431448489543,0.7087529047250194,0.017815646785437646
2004,NORTH DAKOTA,BARNES,2186,86,3541,5813,0.3760536728023396,0.6091519009117495,0.01479442628591089
2004,NORTH DAKOTA,BENSON,1196,48,1002,2246,0.5325022261798753,0.44612644701691895,0.0213713268032057
2004,NORTH DAKOTA,BILLINGS,99,16,449,564,0.17553191489361702,0.7960992907801419,0.028368794326241134
2004,NORTH DAKOTA,BOTTINEAU,1168,38,2468,3674,0.31790963527490473,0.6717474142623843,0.010342950462710943
2004,NORTH DAKOTA,BOWMAN,397,39,1280,1716,0.23135198135198135,0.745920745920746,0.022727272727272728
2004,NORTH DAKOTA,BURKE,336,21,808,1165,0.28841201716738196,0.6935622317596567,0.018025751072961373
2004,NORTH DAKOTA,BURLEIGH,11621,616,26577,38814,0.2994022775287267,0.6847271603029834,0.015870562168289793
2004,NORTH DAKOTA,CASS,26010,1082,39619,66711,0.3898907226694248,0.5938900631080332,0.01621921422254201
2004,NORTH DAKOTA,CAVALIER,887,35,1522,2444,0.36292962356792147,0.6227495908346972,0.014320785597381341
2004,NORTH DAKOTA,DICKEY,883,48,1890,2821,0.3130095710740872,0.6699751861042184,0.017015242821694435
2004,NORTH DAKOTA,DIVIDE,487,30,751,1268,0.3840694006309148,0.5922712933753943,0.02365930599369085
2004,NORTH DAKOTA,DUNN,571,25,1178,1774,0.3218714768883878,0.6640360766629086,0.014092446448703494
2004,NORTH DAKOTA,EDDY,534,24,655,1213,0.4402308326463314,0.5399835119538334,0.01978565539983512
2004,NORTH DAKOTA,EMMONS,611,53,1449,2113,0.28916232844297207,0.6857548509228585,0.025082820634169428
2004,NORTH DAKOTA,FOSTER,518,29,1219,1766,0.29331823329558326,0.6902604756511891,0.01642129105322763
2004,NORTH DAKOTA,GOLDEN VALLEY,195,13,719,927,0.21035598705501618,0.7756202804746494,0.014023732470334413
2004,NORTH DAKOTA,GRAND FORKS,12646,526,17298,30470,0.4150311782080735,0.5677059402691171,0.01726288152280932
2004,NORTH DAKOTA,GRANT,264,26,952,1242,0.21256038647342995,0.7665056360708534,0.020933977455716585
2004,NORTH DAKOTA,GRIGGS,505,27,907,1439,0.35093815149409313,0.6302988186240445,0.018763029881862403
2004,NORTH DAKOTA,HETTINGER,405,45,1044,1494,0.2710843373493976,0.6987951807228916,0.030120481927710843
2004,NORTH DAKOTA,KIDDER,433,34,902,1369,0.3162892622352082,0.6588750913075238,0.02483564645726808
2004,NORTH DAKOTA,LAMOURE,712,31,1592,2335,0.3049250535331906,0.6817987152034262,0.013276231263383297
2004,NORTH DAKOTA,LOGAN,265,21,844,1130,0.2345132743362832,0.7469026548672566,0.018584070796460177
2004,NORTH DAKOTA,MCHENRY,1030,46,1744,2820,0.36524822695035464,0.6184397163120567,0.016312056737588652
2004,NORTH DAKOTA,MCINTOSH,436,32,1254,1722,0.25319396051103366,0.7282229965156795,0.018583042973286876
2004,NORTH DAKOTA,MCKENZIE,847,18,1897,2762,0.30666183924692253,0.6868211440984794,0.0065170166545981175
2004,NORTH DAKOTA,MCLEAN,1664,72,3014,4750,0.3503157894736842,0.6345263157894737,0.015157894736842105
2004,NORTH DAKOTA,MERCER,1245,87,3285,4617,0.2696556205328135,0.7115009746588694,0.018843404808317088
2004,NORTH DAKOTA,MORTON,4073,235,8325,12633,0.32240956225757933,0.6589883638090714,0.018602073933349166
2004,NORTH DAKOTA,MOUNTRAIL,1465,38,1527,3030,0.4834983498349835,0.503960396039604,0.012541254125412541
2004,NORTH DAKOTA,NELSON,778,37,1107,1922,0.404786680541103,0.5759625390218522,0.019250780437044746
2004,NORTH DAKOTA,OLIVER,310,19,790,1119,0.2770330652368186,0.7059874888293118,0.016979445933869526
2004,NORTH DAKOTA,PEMBINA,1321,69,2466,3856,0.3425829875518672,0.6395228215767634,0.017894190871369293
2004,NORTH DAKOTA,PIERCE,686,34,1475,2195,0.3125284738041002,0.6719817767653758,0.015489749430523917
2004,NORTH DAKOTA,RAMSEY,1885,72,2943,4900,0.3846938775510204,0.6006122448979592,0.014693877551020407
2004,NORTH DAKOTA,RANSOM,1199,51,1352,2602,0.4607993850883935,0.5196003074558032,0.01960030745580323
2004,NORTH DAKOTA,RENVILLE,497,19,953,1469,0.33832539142273654,0.6487406398910823,0.012933968686181076
2004,NORTH DAKOTA,RICHLAND,2821,130,5264,8215,0.3433962264150943,0.6407790626902009,0.01582471089470481
2004,NORTH DAKOTA,ROLETTE,2564,88,1392,4044,0.6340257171117705,0.34421364985163205,0.021760633036597428
2004,NORTH DAKOTA,SARGENT,1021,32,1147,2200,0.4640909090909091,0.5213636363636364,0.014545454545454545
2004,NORTH DAKOTA,SHERIDAN,200,17,727,944,0.211864406779661,0.7701271186440678,0.018008474576271187
2004,NORTH DAKOTA,SIOUX,804,17,319,1140,0.7052631578947368,0.27982456140350875,0.014912280701754385
2004,NORTH DAKOTA,SLOPE,89,8,335,432,0.20601851851851852,0.7754629629629629,0.018518518518518517
2004,NORTH DAKOTA,STARK,3013,167,7220,10400,0.28971153846153846,0.6942307692307692,0.016057692307692308
2004,NORTH DAKOTA,STEELE,616,11,586,1213,0.5078318219291014,0.4830997526793075,0.009068425391591096
2004,NORTH DAKOTA,STUTSMAN,3438,167,6517,10122,0.3396561944279787,0.6438450899031812,0.01649871566884015
2004,NORTH DAKOTA,TOWNER,606,31,754,1391,0.43565780014378147,0.5420560747663551,0.02228612508986341
2004,NORTH DAKOTA,TRAILL,1651,54,2543,4248,0.388653483992467,0.5986346516007532,0.012711864406779662
2004,NORTH DAKOTA,WALSH,1905,87,3194,5186,0.3673351330505206,0.6158889317392982,0.016775935210181257
2004,NORTH DAKOTA,WARD,8236,368,17008,25612,0.32156801499297205,0.6640637201311885,0.01436826487583945
2004,NORTH DAKOTA,WELLS,858,49,1654,2561,0.3350253807106599,0.6458414681764936,0.019133151112846546
2004,NORTH DAKOTA,WILLIAMS,2512,139,6278,8929,0.28133049613618544,0.7031022510919476,0.01556725277186695
2004,OHIO,ADAMS,4280,66,7653,11999,0.35669639136594716,0.6378031502625219,0.005500458371530961
2004,OHIO,ALLEN,16483,206,32585,49274,0.33451718959288873,0.6613021065876528,0.004180703819458538
2004,OHIO,ASHLAND,8555,194,16171,24920,0.34329855537720705,0.6489165329052969,0.007784911717495987
2004,OHIO,ASHTABULA,24061,309,21039,45409,0.5298729326785439,0.4633222488933912,0.006804818428064921
2004,OHIO,ATHENS,18997,200,10847,30044,0.6323059512714685,0.3610371455199041,0.006656903208627347
2004,OHIO,AUGLAIZE,5904,115,17012,23031,0.2563501367721766,0.7386565932873084,0.004993269940514958
2004,OHIO,BELMONT,17574,157,15589,33320,0.5274309723889555,0.46785714285714286,0.0047118847539015605
2004,OHIO,BROWN,7140,105,12647,19892,0.35893826663985523,0.6357832294389705,0.005278503921174341
2004,OHIO,BUTLER,56234,702,109866,166802,0.3371302502368077,0.6586611671322886,0.004208582630903706
2004,OHIO,CARROLL,6298,117,7695,14110,0.44635010630758326,0.5453579021970234,0.008291991495393338
2004,OHIO,CHAMPAIGN,6967,90,11718,18775,0.37107856191744343,0.6241278295605859,0.004793608521970706
2004,OHIO,CLARK,33534,331,34938,68803,0.4873915381596733,0.5077976251035565,0.004810836736770199
2004,OHIO,CLERMONT,25885,211,62946,89042,0.2907055097594394,0.7069248219941151,0.002369668246445498
2004,OHIO,CLINTON,5417,59,12938,18414,0.29417834256543934,0.7026175735853155,0.0032040838492451394
2004,OHIO,COLUMBIANA,23426,283,25754,49463,0.47360653417706167,0.520672017467602,0.005721448355336312
2004,OHIO,COSHOCTON,6878,87,9277,16242,0.4234700160078808,0.5711735008003941,0.005356483191725157
2004,OHIO,CRAWFORD,7773,143,13885,21801,0.35654327783129214,0.6368973900279804,0.00655933214072749
2004,OHIO,CUYAHOGA,448486,3674,221606,673766,0.665640593321717,0.3289064749482758,0.005452931730007154
2004,OHIO,DARKE,7849,161,18307,26317,0.29824828057909336,0.6956340008359615,0.006117718584945093
2004,OHIO,DEFIANCE,6975,144,11393,18512,0.3767826274848747,0.6154386343993086,0.007778738115816767
2004,OHIO,DELAWARE,27048,265,53142,80455,0.336187931141632,0.660518302156485,0.00329376670188304
2004,OHIO,ERIE,21408,67,18601,40076,0.5341850484080247,0.4641431280566923,0.0016718235352829623
2004,OHIO,FAIRFIELD,24774,384,42697,67855,0.3651020558543954,0.629238818067939,0.0056591260776656105
2004,OHIO,FAYETTE,4334,47,7375,11756,0.368662810479755,0.6273392310309629,0.003997958489282069
2004,OHIO,FRANKLIN,285800,2772,237252,525824,0.5435278724440117,0.4512004016553067,0.005271725900681597
2004,OHIO,FULTON,8224,90,13639,21953,0.3746185031658543,0.6212818293627295,0.004099667471416208
2004,OHIO,GALLIA,5364,51,8577,13992,0.3833619210977702,0.6129931389365352,0.003644939965694683
2004,OHIO,GEAUGA,19840,221,30358,50419,0.3935024494734128,0.6021142823142069,0.004383268212380253
2004,OHIO,GREENE,30530,365,48377,79272,0.38512968008880816,0.6102659198708245,0.004604400040367343
2004,OHIO,GUERNSEY,7768,111,9961,17840,0.4354260089686099,0.5583520179372198,0.006221973094170404
2004,OHIO,HAMILTON,199499,1731,222404,423634,0.470923013733553,0.5249909119664616,0.004086074299985365
2004,OHIO,HANCOCK,10343,162,25101,35606,0.2904847497612762,0.7049654552603494,0.004549794978374431
2004,OHIO,HARDIN,4889,60,8436,13385,0.3652596189764662,0.6302577512140456,0.0044826298094882335
2004,OHIO,HARRISON,3780,55,4274,8109,0.46614872364039955,0.5270686891108645,0.0067825872487359724
2004,OHIO,HENRY,5110,92,9901,15103,0.33834337548831356,0.6555651195126796,0.00609150499900682
2004,OHIO,HIGHLAND,6194,76,12212,18482,0.33513688994697544,0.6607510009739206,0.004112109079103993
2004,OHIO,HOCKING,6173,88,6935,13196,0.4677932706880873,0.5255380418308578,0.006668687481054865
2004,OHIO,HOLMES,2695,57,8466,11218,0.2402389017650205,0.754679978605812,0.005081119629167409
2004,OHIO,HURON,10585,173,14834,25592,0.4136058143169741,0.5796342607064707,0.006759924976555173
2004,OHIO,JACKSON,5699,49,8585,14333,0.39761389799762786,0.5989674178469266,0.0034186841554454755
2004,OHIO,JEFFERSON,19019,163,17184,36366,0.5229885057471264,0.47252928559643625,0.004482208656437331
2004,OHIO,KNOX,9828,157,17081,27066,0.3631123919308357,0.6310869725855317,0.005800635483632602
2004,OHIO,LAKE,59049,581,62193,121823,0.48471142559286834,0.510519360055162,0.004769214351969661
2004,OHIO,LAWRENCE,12111,138,15457,27706,0.4371255323756587,0.5578935970547896,0.004980870569551722
2004,OHIO,LICKING,30051,351,49014,79416,0.37839981867633726,0.6171804170444243,0.004419764279238441
2004,OHIO,LOGAN,6825,102,14471,21398,0.318955042527339,0.6762781568370876,0.004766800635573418
2004,OHIO,LORAIN,78965,569,61196,140730,0.5611099268102039,0.4348468698927023,0.004043203297093726
2004,OHIO,LUCAS,132536,547,87106,220189,0.6019192602718574,0.39559651027072196,0.0024842294574206705
2004,OHIO,MADISON,6200,78,11120,17398,0.35636280032187606,0.6391539257385906,0.00448327393953328
2004,OHIO,MAHONING,83069,950,48712,132731,0.6258447536747256,0.3669979130723041,0.007157333252970293
2004,OHIO,MARION,11930,157,17171,29258,0.4077517260236517,0.5868822202474537,0.005366053728894662
2004,OHIO,MEDINA,36264,420,48183,84867,0.4273038990420305,0.5677471808830288,0.00494892007494079
2004,OHIO,MEIGS,4437,61,6273,10771,0.4119394670875499,0.5823971776065361,0.005663355305914029
2004,OHIO,MERCER,5117,122,15649,20888,0.24497319034852547,0.7491861355802375,0.005840674071237074
2004,OHIO,MIAMI,17611,164,34005,51780,0.34011201235998456,0.656720741599073,0.003167246040942449
2004,OHIO,MONROE,4243,62,3424,7729,0.5489714063915125,0.44300685729072325,0.008021736317764264
2004,OHIO,MONTGOMERY,142977,1215,138361,282553,0.5060183399220677,0.4896815818625178,0.004300078215414453
2004,OHIO,MORGAN,2873,70,3757,6700,0.42880597014925376,0.5607462686567164,0.010447761194029851
2004,OHIO,MORROW,5775,79,10475,16329,0.3536652581297079,0.6414967236205524,0.004838018249739727
2004,OHIO,MUSKINGUM,16421,191,22251,38863,0.42253557368190825,0.5725497259604251,0.004914700357666675
2004,OHIO,NOBLE,2654,45,3841,6540,0.40581039755351683,0.5873088685015291,0.006880733944954129
2004,OHIO,OTTAWA,11114,68,12075,23257,0.4778776282409597,0.5191985208754354,0.002923850883604936
2004,OHIO,PAULDING,3610,64,6205,9879,0.3654216013766576,0.6281000101224821,0.006478388500860411
2004,OHIO,PERRY,7257,76,7855,15188,0.4778114300763761,0.5171846194363972,0.005003950487226758
2004,OHIO,PICKAWAY,8578,112,14160,22850,0.37540481400437636,0.6196936542669584,0.004901531728665208
2004,OHIO,PIKE,5989,67,6519,12575,0.4762624254473161,0.5184095427435388,0.005328031809145129
2004,OHIO,PORTAGE,40674,389,35583,76646,0.5306734858961981,0.4642512329410537,0.0050752811627482195
2004,OHIO,PREBLE,7274,119,13733,21126,0.344315062008899,0.6500520685411342,0.005632869449966865
2004,OHIO,PUTNAM,4392,87,14370,18849,0.23300970873786409,0.7623746617857712,0.0046156294763647935
2004,OHIO,RICHLAND,24645,330,36892,61867,0.39835453472772236,0.5963114422874877,0.005334022984789953
2004,OHIO,ROSS,13977,463,17229,31669,0.4413464271053712,0.544033597524393,0.014619975370235877
2004,OHIO,SANDUSKY,12653,104,16198,28955,0.43698843032291484,0.559419789328268,0.00359178034881713
2004,OHIO,SCIOTO,16823,117,18257,35197,0.47796687217660594,0.5187089808790522,0.0033241469443418474
2004,OHIO,SENECA,10958,148,15885,26991,0.4059871809121559,0.5885295098366122,0.0054833092512318925
2004,OHIO,SHELBY,6534,116,16204,22854,0.2859018114990811,0.7090224905924565,0.0050756979084624135
2004,OHIO,STARK,95338,907,92211,188456,0.5058899690113342,0.4892972364902152,0.004812794498450567
2004,OHIO,SUMMIT,156578,1173,118553,276304,0.5666874167583531,0.4290672592506804,0.004245323990966472
2004,OHIO,TRUMBULL,66673,495,40976,108144,0.6165205651723628,0.37890220446811657,0.004577230359520639
2004,OHIO,TUSCARAWAS,18854,225,23825,42904,0.43944620548200636,0.5553095282491143,0.005244266268879359
2004,OHIO,UNION,6665,96,15869,22630,0.2945205479452055,0.7012372956252761,0.004242156429518339
2004,OHIO,VAN WERT,4094,54,10678,14826,0.2761365169297181,0.7202212329691083,0.003642250101173614
2004,OHIO,VINTON,2651,28,3251,5930,0.4470489038785835,0.54822934232715,0.004721753794266442
2004,OHIO,WARREN,26043,341,68035,94419,0.2758237219203762,0.7205647168472448,0.003611561232379076
2004,OHIO,WASHINGTON,12475,146,17480,30101,0.41443805853626126,0.5807116042656391,0.004850337198099731
2004,OHIO,WAYNE,19786,183,31879,51848,0.3816154914365067,0.6148549606542201,0.0035295479092732605
2004,OHIO,WILLIAMS,6481,118,12040,18639,0.34771178711304257,0.6459574011481303,0.00633081173882719
2004,OHIO,WOOD,29401,353,33592,63346,0.46413348909165536,0.5302939412117577,0.0055725696965869985
2004,OHIO,WYANDOT,3707,81,7256,11044,0.33565737051792827,0.6570083303151032,0.00733429916696849
2004,OKLAHOMA,ADAIR,2562,0,4971,7533,0.34010354440461965,0.6598964555953803,0.0
2004,OKLAHOMA,ALFALFA,470,0,2201,2671,0.17596405840509172,0.8240359415949082,0.0
2004,OKLAHOMA,ATOKA,1946,0,3142,5088,0.3824685534591195,0.6175314465408805,0.0
2004,OKLAHOMA,BEAVER,297,0,2272,2569,0.11560918645387311,0.8843908135461269,0.0
2004,OKLAHOMA,BECKHAM,1931,0,5454,7385,0.2614759647935003,0.7385240352064997,0.0
2004,OKLAHOMA,BLAINE,1222,0,3199,4421,0.2764080524768152,0.7235919475231848,0.0
2004,OKLAHOMA,BRYAN,5745,0,8615,14360,0.40006963788300837,0.5999303621169917,0.0
2004,OKLAHOMA,CADDO,3916,0,6491,10407,0.37628519265878735,0.6237148073412127,0.0
2004,OKLAHOMA,CANADIAN,9712,0,33297,43009,0.22581320188797693,0.7741867981120231,0.0
2004,OKLAHOMA,CARTER,6466,0,12178,18644,0.34681398841450334,0.6531860115854967,0.0
2004,OKLAHOMA,CHEROKEE,8623,0,9569,18192,0.4739995602462621,0.5260004397537379,0.0
2004,OKLAHOMA,CHOCTAW,2639,0,3168,5807,0.4544515240227312,0.5455484759772689,0.0
2004,OKLAHOMA,CIMARRON,184,0,1242,1426,0.12903225806451613,0.8709677419354839,0.0
2004,OKLAHOMA,CLEVELAND,34007,0,65720,99727,0.3410009325458502,0.6589990674541498,0.0
2004,OKLAHOMA,COAL,1203,0,1396,2599,0.46287033474413236,0.5371296652558677,0.0
2004,OKLAHOMA,COMANCHE,12022,0,21170,33192,0.36219570980959265,0.6378042901904073,0.0
2004,OKLAHOMA,COTTON,898,0,1742,2640,0.34015151515151515,0.6598484848484848,0.0
2004,OKLAHOMA,CRAIG,2504,0,3894,6398,0.39137230384495153,0.6086276961550484,0.0
2004,OKLAHOMA,CREEK,9929,0,18848,28777,0.34503249122563157,0.6549675087743684,0.0
2004,OKLAHOMA,CUSTER,2801,0,7839,10640,0.2632518796992481,0.7367481203007519,0.0
2004,OKLAHOMA,DELAWARE,5591,0,10017,15608,0.35821373654536137,0.6417862634546386,0.0
2004,OKLAHOMA,DEWEY,408,0,1843,2251,0.18125277654375832,0.8187472234562416,0.0
2004,OKLAHOMA,ELLIS,395,0,1685,2080,0.18990384615384615,0.8100961538461539,0.0
2004,OKLAHOMA,GARFIELD,5586,0,17685,23271,0.24004125306175067,0.7599587469382493,0.0
2004,OKLAHOMA,GARVIN,3707,0,7610,11317,0.32756030750198817,0.6724396924980118,0.0
2004,OKLAHOMA,GRADY,5970,0,14136,20106,0.2969262906595046,0.7030737093404954,0.0
2004,OKLAHOMA,GRANT,571,0,1950,2521,0.22649742165807218,0.7735025783419278,0.0
2004,OKLAHOMA,GREER,719,0,1529,2248,0.31983985765124556,0.6801601423487544,0.0
2004,OKLAHOMA,HARMON,354,0,838,1192,0.29697986577181207,0.7030201342281879,0.0
2004,OKLAHOMA,HARPER,268,0,1397,1665,0.16096096096096096,0.8390390390390391,0.0
2004,OKLAHOMA,HASKELL,2378,0,2946,5324,0.44665664913598796,0.553343350864012,0.0
2004,OKLAHOMA,HUGHES,2283,0,3066,5349,0.42680874929893436,0.5731912507010656,0.0
2004,OKLAHOMA,JACKSON,2232,0,7024,9256,0.2411408815903198,0.7588591184096802,0.0
2004,OKLAHOMA,JEFFERSON,1057,0,1546,2603,0.4060699193238571,0.593930080676143,0.0
2004,OKLAHOMA,JOHNSTON,1713,0,2635,4348,0.3939742410303588,0.6060257589696412,0.0
2004,OKLAHOMA,KAY,5957,0,14121,20078,0.296692897698974,0.703307102301026,0.0
2004,OKLAHOMA,KINGFISHER,1022,0,5630,6652,0.15363800360793747,0.8463619963920626,0.0
2004,OKLAHOMA,KIOWA,1413,0,2610,4023,0.3512304250559284,0.6487695749440716,0.0
2004,OKLAHOMA,LATIMER,1945,0,2535,4480,0.4341517857142857,0.5658482142857143,0.0
2004,OKLAHOMA,LE FLORE,6741,0,10683,17424,0.3868801652892562,0.6131198347107438,0.0
2004,OKLAHOMA,LINCOLN,4041,0,10149,14190,0.2847780126849894,0.7152219873150105,0.0
2004,OKLAHOMA,LOGAN,4869,0,11474,16343,0.2979257174325399,0.7020742825674601,0.0
2004,OKLAHOMA,LOVE,1538,0,2295,3833,0.4012522828072006,0.5987477171927994,0.0
2004,OKLAHOMA,MAJOR,537,0,3122,3659,0.14676141022137196,0.853238589778628,0.0
2004,OKLAHOMA,MARSHALL,2088,0,3363,5451,0.3830489818381948,0.6169510181618052,0.0
2004,OKLAHOMA,MAYES,6933,0,9946,16879,0.4107470821731145,0.5892529178268855,0.0
2004,OKLAHOMA,MCCLAIN,3742,0,10041,13783,0.2714938692592324,0.7285061307407676,0.0
2004,OKLAHOMA,MCCURTAIN,3684,0,7472,11156,0.33022588741484404,0.669774112585156,0.0
2004,OKLAHOMA,MCINTOSH,4488,0,4692,9180,0.4888888888888889,0.5111111111111111,0.0
2004,OKLAHOMA,MURRAY,2130,0,3665,5795,0.36755823986194996,0.6324417601380501,0.0
2004,OKLAHOMA,MUSKOGEE,12585,0,15124,27709,0.45418456097296905,0.5458154390270309,0.0
2004,OKLAHOMA,NOBLE,1335,0,3993,5328,0.2505630630630631,0.7494369369369369,0.0
2004,OKLAHOMA,NOWATA,1660,0,2805,4465,0.3717805151175812,0.6282194848824189,0.0
2004,OKLAHOMA,OKFUSKEE,1743,0,2542,4285,0.40676779463243873,0.5932322053675613,0.0
2004,OKLAHOMA,OKLAHOMA,97298,0,174741,272039,0.35766195288175595,0.642338047118244,0.0
2004,OKLAHOMA,OKMULGEE,7367,0,8363,15730,0.46834075015893195,0.531659249841068,0.0
2004,OKLAHOMA,OSAGE,8068,0,11467,19535,0.41300230355771694,0.5869976964422831,0.0
2004,OKLAHOMA,OTTAWA,5086,0,7443,12529,0.4059382233218932,0.5940617766781068,0.0
2004,OKLAHOMA,PAWNEE,2564,0,4412,6976,0.36754587155963303,0.632454128440367,0.0
2004,OKLAHOMA,PAYNE,10101,0,19560,29661,0.34054819459896835,0.6594518054010317,0.0
2004,OKLAHOMA,PITTSBURG,7452,0,11134,18586,0.40094694931669,0.59905305068331,0.0
2004,OKLAHOMA,PONTOTOC,5165,0,9647,14812,0.3487037537132055,0.6512962462867945,0.0
2004,OKLAHOMA,POTTAWATOMIE,8638,0,17215,25853,0.3341198313541949,0.6658801686458051,0.0
2004,OKLAHOMA,PUSHMATAHA,1934,0,2863,4797,0.4031686470710861,0.5968313529289139,0.0
2004,OKLAHOMA,ROGER MILLS,382,0,1388,1770,0.21581920903954802,0.784180790960452,0.0
2004,OKLAHOMA,ROGERS,11918,0,24976,36894,0.3230335555916951,0.6769664444083049,0.0
2004,OKLAHOMA,SEMINOLE,3648,0,5624,9272,0.39344262295081966,0.6065573770491803,0.0
2004,OKLAHOMA,SEQUOYAH,5910,0,8865,14775,0.4,0.6,0.0
2004,OKLAHOMA,STEPHENS,5515,0,13646,19161,0.287824226292991,0.712175773707009,0.0
2004,OKLAHOMA,TEXAS,1016,0,5450,6466,0.15712960098979276,0.8428703990102072,0.0
2004,OKLAHOMA,TILLMAN,1175,0,2273,3448,0.3407772621809745,0.6592227378190255,0.0
2004,OKLAHOMA,TULSA,90220,0,163452,253672,0.35565612286732473,0.6443438771326753,0.0
2004,OKLAHOMA,WAGONER,9157,0,19081,28238,0.32427933989659324,0.6757206601034068,0.0
2004,OKLAHOMA,WASHINGTON,6862,0,16551,23413,0.29308503822662624,0.7069149617733738,0.0
2004,OKLAHOMA,WASHITA,1340,0,3705,5045,0.26560951437066405,0.734390485629336,0.0
2004,OKLAHOMA,WOODS,932,0,3166,4098,0.22742801366520254,0.7725719863347975,0.0
2004,OKLAHOMA,WOODWARD,1458,0,6193,7651,0.1905633250555483,0.8094366749444517,0.0
2004,OREGON,BAKER,2616,165,6253,9034,0.2895727252601284,0.6921629400044277,0.01826433473544388
2004,OREGON,BENTON,26515,760,18460,45735,0.5797529244561058,0.4036296053350825,0.016617470208811633
2004,OREGON,CLACKAMAS,95129,2180,97691,195000,0.48784102564102566,0.5009794871794871,0.011179487179487179
2004,OREGON,CLATSOP,10461,345,8503,19309,0.541768087420374,0.4403645968201357,0.017867315759490392
2004,OREGON,COLUMBIA,12563,486,11868,24917,0.504193923827106,0.4763013203836738,0.019504755789220212
2004,OREGON,COOS,14393,678,18291,33362,0.4314189796774774,0.5482584976919849,0.02032252263053774
2004,OREGON,CROOK,3024,197,6830,10051,0.3008655855138792,0.6795343746890856,0.01960003979703512
2004,OREGON,CURRY,5220,247,7332,12799,0.40784436284084696,0.5728572544730057,0.019298382686147354
2004,OREGON,DESCHUTES,31179,1112,41757,74048,0.42106471477960244,0.5639179991356957,0.015017286084701814
2004,OREGON,DOUGLAS,18089,939,35956,54984,0.3289866142877928,0.6539356903826568,0.017077695329550415
2004,OREGON,GILLIAM,370,13,755,1138,0.3251318101933216,0.663444639718805,0.011423550087873463
2004,OREGON,GRANT,780,77,3204,4061,0.19207091849298202,0.7889682344250185,0.018960847081999507
2004,OREGON,HARNEY,839,48,2815,3702,0.22663425175580768,0.7603997839005943,0.012965964343598054
2004,OREGON,HOOD RIVER,5587,148,4124,9859,0.5666903337052439,0.41829800182574295,0.015011664469013085
2004,OREGON,JACKSON,44366,1304,56519,102189,0.4341563181947176,0.5530830128487411,0.01276066895654131
2004,OREGON,JEFFERSON,3243,110,4762,8115,0.399630314232902,0.5868145409735058,0.013555144793592114
2004,OREGON,JOSEPHINE,15214,820,26241,42275,0.3598817267888823,0.6207214665878179,0.019396806623299824
2004,OREGON,KLAMATH,8264,518,22733,31515,0.26222433761700775,0.7213390448992544,0.0164366174837379
2004,OREGON,LAKE,802,64,3039,3905,0.20537772087067863,0.7782330345710627,0.01638924455825864
2004,OREGON,LANE,107769,3096,75007,185872,0.5798022294912628,0.4035411465955066,0.01665662391323061
2004,OREGON,LINCOLN,13753,412,10160,24325,0.5653854059609456,0.41767728674203497,0.016937307297019526
2004,OREGON,LINN,19940,841,31260,52041,0.38315943198631847,0.6006802328932956,0.01616033512038585
2004,OREGON,MALHEUR,2577,146,8123,10846,0.23759911488106214,0.7489397012723584,0.013461183846579385
2004,OREGON,MARION,57671,2048,69900,129619,0.4449270554471181,0.5392727917974989,0.015800152755383084
2004,OREGON,MORROW,1361,56,2732,4149,0.3280308508074235,0.658471920944806,0.013497228247770547
2004,OREGON,MULTNOMAH,259585,4670,98439,362694,0.7157135215912036,0.27141061059736304,0.01287586781143333
2004,OREGON,POLK,15484,497,19508,35489,0.4363042069373609,0.5496914536898757,0.01400433937276339
2004,OREGON,SHERMAN,390,20,694,1104,0.3532608695652174,0.6286231884057971,0.018115942028985508
2004,OREGON,TILLAMOOK,6750,198,7003,13951,0.4838362841373378,0.5019711848613002,0.01419253100136191
2004,OREGON,UMATILLA,8884,370,17068,26322,0.3375123470860877,0.6484309702910113,0.014056682622900996
2004,OREGON,UNION,4428,212,8879,13519,0.32753901915822176,0.6567793475848805,0.015681633256897698
2004,OREGON,WALLOWA,1269,120,3132,4521,0.28069011280690115,0.6927670869276709,0.026542800265428004
2004,OREGON,WASCO,5691,192,6119,12002,0.4741709715047492,0.5098316947175471,0.015997333777703716
2004,OREGON,WASHINGTON,121140,2945,107223,231308,0.5237172946893319,0.4635507634841856,0.012731941826482438
2004,OREGON,WHEELER,245,23,612,880,0.2784090909090909,0.6954545454545454,0.026136363636363635
2004,OREGON,YAMHILL,17572,731,23839,42142,0.41697119263442645,0.5656826918513597,0.017346115514213847
2004,PENNSYLVANIA,ADAMS,13764,217,28247,42228,0.325944870701904,0.668916358814057,0.005138770484039026
2004,PENNSYLVANIA,ALLEGHENY,368912,4632,271925,645469,0.5715410035183719,0.4212828191594019,0.007176177322226164
2004,PENNSYLVANIA,ARMSTRONG,12025,147,18925,31097,0.38669325015274786,0.6085796057497508,0.004727144097501366
2004,PENNSYLVANIA,BEAVER,42146,481,39916,82543,0.5105944780296331,0.48357825618162653,0.005827265788740414
2004,PENNSYLVANIA,BEDFORD,6016,57,16606,22679,0.26526742801710834,0.7322192336522775,0.0025133383306142247
2004,PENNSYLVANIA,BERKS,76309,1056,87122,164487,0.46392116094281005,0.529658878817171,0.006419960240018968
2004,PENNSYLVANIA,BLAIR,18105,322,35751,54178,0.3341762338956772,0.659880394255971,0.005943371848351729
2004,PENNSYLVANIA,BRADFORD,8590,120,16942,25652,0.33486667706221734,0.6604553251208483,0.004677997816934352
2004,PENNSYLVANIA,BUCKS,163438,1909,154469,319816,0.5110375966180554,0.4829933461740501,0.005969057207894539
2004,PENNSYLVANIA,BUTLER,30090,376,54959,85425,0.3522388059701492,0.6433596722270998,0.004401521802750951
2004,PENNSYLVANIA,CAMBRIA,32591,344,34048,66983,0.4865562904020423,0.5083080781690876,0.005135631428870011
2004,PENNSYLVANIA,CAMERON,794,13,1599,2406,0.33000831255195345,0.6645885286783042,0.005403158769742311
2004,PENNSYLVANIA,CARBON,12223,301,12519,25043,0.48808050153735577,0.499900171704668,0.012019326757976281
2004,PENNSYLVANIA,CENTRE,30733,387,33133,64253,0.4783122967020995,0.5156646382270088,0.006023065070891631
2004,PENNSYLVANIA,CHESTER,109708,1079,120036,230823,0.47529059062571755,0.520034831884171,0.004674577490111471
2004,PENNSYLVANIA,CLARION,6049,72,11063,17184,0.3520135009310987,0.6437965549348231,0.004189944134078212
2004,PENNSYLVANIA,CLEARFIELD,13518,182,20533,34233,0.39488213127683813,0.5998013612596033,0.005316507463558554
2004,PENNSYLVANIA,CLINTON,5823,109,8035,13967,0.4169112908999785,0.5752845994129019,0.007804109687119639
2004,PENNSYLVANIA,COLUMBIA,10679,138,16052,26869,0.397446871859764,0.5974170977706651,0.005136030369570881
2004,PENNSYLVANIA,CRAWFORD,16013,344,21965,38322,0.4178539742184646,0.5731694587965137,0.008976566985021658
2004,PENNSYLVANIA,CUMBERLAND,37928,506,67648,106082,0.35753473727870894,0.6376953677343942,0.004769894986896929
2004,PENNSYLVANIA,DAUPHIN,55299,613,65296,121208,0.45623226189690447,0.5387103161507492,0.00505742195234638
2004,PENNSYLVANIA,DELAWARE,162601,1512,120425,284538,0.5714561851141148,0.42322993765331873,0.005313877232566476
2004,PENNSYLVANIA,ELK,6602,76,7872,14550,0.45374570446735396,0.5410309278350516,0.005223367697594502
2004,PENNSYLVANIA,ERIE,67921,605,57372,125898,0.5394922874072662,0.4557022351427346,0.004805477449999206
2004,PENNSYLVANIA,FAYETTE,29120,542,25045,54707,0.532290200522785,0.45780247500319887,0.009907324474016122
2004,PENNSYLVANIA,FOREST,989,13,1571,2573,0.3843762145355616,0.6105713175281772,0.005052467936261173
2004,PENNSYLVANIA,FRANKLIN,16562,190,41817,58569,0.2827775785825266,0.7139783844695999,0.0032440369478734486
2004,PENNSYLVANIA,FULTON,1475,24,4772,6271,0.23520969542337744,0.7609631637697337,0.0038271408068888536
2004,PENNSYLVANIA,GREENE,7674,105,7786,15565,0.4930292322518471,0.5002248634757469,0.006745904272406039
2004,PENNSYLVANIA,HUNTINGDON,5879,53,12126,18058,0.32556207774947393,0.6715029349872632,0.00293498726326282
2004,PENNSYLVANIA,INDIANA,15831,163,20254,36248,0.43674133745310084,0.5587618627234606,0.0044967998234385345
2004,PENNSYLVANIA,JEFFERSON,6073,116,13371,19560,0.310480572597137,0.6835889570552147,0.005930470347648262
2004,PENNSYLVANIA,JUNIATA,2797,65,7144,10006,0.27953228063162106,0.7139716170297822,0.006496102338596842
2004,PENNSYLVANIA,LACKAWANNA,59573,1480,44766,105819,0.5629707330441603,0.42304312080061235,0.013986146155227322
2004,PENNSYLVANIA,LANCASTER,74328,1359,145591,221278,0.3359032529216642,0.6579551514384621,0.006141595639873824
2004,PENNSYLVANIA,LAWRENCE,21387,117,21938,43442,0.4923115878642788,0.5049951659684176,0.002693246167303531
2004,PENNSYLVANIA,LEBANON,18109,467,37089,55665,0.3253211173987245,0.6662894098625707,0.008389472738704752
2004,PENNSYLVANIA,LEHIGH,73940,991,70160,145091,0.5096112095167861,0.4835585942615324,0.006830196221681566
2004,PENNSYLVANIA,LUZERNE,69573,1502,64953,136028,0.5114608757020613,0.4774972799717705,0.011041844326168141
2004,PENNSYLVANIA,LYCOMING,15681,407,33961,50049,0.31331295330576037,0.6785550160842374,0.008132030610002198
2004,PENNSYLVANIA,MCKEAN,6294,191,10941,17426,0.36118443704808906,0.6278549294158154,0.01096063353609549
2004,PENNSYLVANIA,MERCER,24831,422,26311,51564,0.48155690016290437,0.5102590954929797,0.00818400434411605
2004,PENNSYLVANIA,MIFFLIN,4889,187,11726,16802,0.2909772646113558,0.6978931079633377,0.011129627425306512
2004,PENNSYLVANIA,MONROE,27967,404,27971,56342,0.496379255262504,0.49645025025735684,0.00717049448013915
2004,PENNSYLVANIA,MONTGOMERY,222048,1802,175741,399591,0.555688191175477,0.43980219774719653,0.004509611077326566
2004,PENNSYLVANIA,MONTOUR,2666,55,4903,7624,0.3496852046169989,0.6431007345225603,0.007214060860440714
2004,PENNSYLVANIA,NORTHAMPTON,63446,1192,62102,126740,0.5005996528325706,0.48999526589869025,0.009405081268739152
2004,PENNSYLVANIA,NORTHUMBERLAND,14602,270,22262,37134,0.39322453815909947,0.5995044972262616,0.007270964614638876
2004,PENNSYLVANIA,PERRY,5423,85,13919,19427,0.2791475781129356,0.7164770679981469,0.004375353888917486
2004,PENNSYLVANIA,PHILADELPHIA,542205,1765,130099,674069,0.8043761098641237,0.19300546383233763,0.0026184263035386587
2004,PENNSYLVANIA,PIKE,8656,199,12444,21299,0.4064040565284755,0.5842527818207428,0.009343161650781726
2004,PENNSYLVANIA,POTTER,2268,54,5640,7962,0.2848530519969857,0.7083647324792766,0.006782215523737754
2004,PENNSYLVANIA,SCHUYLKILL,29231,398,35640,65269,0.44785426465856687,0.5460478940998024,0.00609784124163079
2004,PENNSYLVANIA,SNYDER,4348,69,10566,14983,0.2901955549622906,0.7051992257892278,0.004605219248481613
2004,PENNSYLVANIA,SOMERSET,12842,134,23802,36778,0.34917613790853225,0.6471803795747457,0.0036434825167219534
2004,PENNSYLVANIA,SULLIVAN,1213,16,2056,3285,0.36925418569254187,0.6258751902587519,0.004870624048706241
2004,PENNSYLVANIA,SUSQUEHANNA,7351,116,11573,19040,0.38608193277310926,0.6078256302521008,0.006092436974789916
2004,PENNSYLVANIA,TIOGA,5437,115,12019,17571,0.30943031130840587,0.6840248136133401,0.006544875078253941
2004,PENNSYLVANIA,UNION,5700,89,10334,16123,0.35353222105067295,0.6409477144452025,0.005520064504124542
2004,PENNSYLVANIA,VENANGO,9024,163,14472,23659,0.3814193330233738,0.6116911112050383,0.00688955577158798
2004,PENNSYLVANIA,WARREN,8044,230,10999,19273,0.4173714522907695,0.5706947543195143,0.011933793389716183
2004,PENNSYLVANIA,WASHINGTON,48225,279,47673,96177,0.5014192582426151,0.4956798402944571,0.002900901462927727
2004,PENNSYLVANIA,WAYNE,8060,194,13713,21967,0.3669140073746984,0.6242545636636774,0.008831428961624255
2004,PENNSYLVANIA,WESTMORELAND,77774,835,100087,178696,0.43523078300577517,0.5600964766978556,0.004672740296369253
2004,PENNSYLVANIA,WYOMING,4982,68,7782,12832,0.38824812967581046,0.6064526184538653,0.00529925187032419
2004,PENNSYLVANIA,YORK,63701,1298,114270,179269,0.3553375095526834,0.6374219747976505,0.007240515649666144
2004,RHODE ISLAND,BRISTOL,14448,374,9855,24677,0.5854844592130324,0.3993597276816469,0.015155813105320744
2004,RHODE ISLAND,FEDERAL PRECINCT,0,0,0,0,,,
2004,RHODE ISLAND,KENT,42830,1313,33699,77842,0.5502171064463914,0.4329153927185838,0.016867500835024793
2004,RHODE ISLAND,NEWPORT,22992,723,16622,40337,0.5699977687978779,0.41207824082108235,0.01792399038103974
2004,RHODE ISLAND,PROVIDENCE,144811,3799,82337,230947,0.6270313102140318,0.3565190281752956,0.01644966161067258
2004,RHODE ISLAND,WASHINGTON,34679,1274,26533,62486,0.5549883173830938,0.42462311557788945,0.02038856703901674
2004,SOUTH CAROLINA,ABBEVILLE,4389,100,5436,9925,0.44221662468513856,0.5477078085642317,0.010075566750629723
2004,SOUTH CAROLINA,AIKEN,19799,616,39077,59492,0.33280104888052175,0.6568446177637329,0.01035433335574531
2004,SOUTH CAROLINA,ALLENDALE,2565,41,985,3591,0.7142857142857143,0.27429685324422165,0.011417432470064048
2004,SOUTH CAROLINA,ANDERSON,20697,670,43355,64722,0.31978307221655694,0.669864960909737,0.010351966873706004
2004,SOUTH CAROLINA,BAMBERG,3841,57,2138,6036,0.6363485752153745,0.35420808482438704,0.009443339960238568
2004,SOUTH CAROLINA,BARNWELL,3982,97,4606,8685,0.4584916522740357,0.5303396660909614,0.011168681635002878
2004,SOUTH CAROLINA,BEAUFORT,21505,399,33331,55235,0.38933647144021,0.6034398479225129,0.007223680637277088
2004,SOUTH CAROLINA,BERKELEY,20142,691,32104,52937,0.3804900164346298,0.606456731586603,0.013053251978767213
2004,SOUTH CAROLINA,CALHOUN,3393,78,3448,6919,0.4903887845064316,0.49833791010261597,0.01127330539095245
2004,SOUTH CAROLINA,CHARLESTON,63758,2261,70297,136316,0.4677220575721119,0.5156914815575574,0.0165864608703307
2004,SOUTH CAROLINA,CHEROKEE,6466,158,12090,18714,0.34551672544619,0.6460403975633215,0.008442876990488405
2004,SOUTH CAROLINA,CHESTER,5790,141,5798,11729,0.49364822235484696,0.49433029243754795,0.01202148520760508
2004,SOUTH CAROLINA,CHESTERFIELD,6729,68,7252,14049,0.47896647448216956,0.5161933233682112,0.00484020214961919
2004,SOUTH CAROLINA,CLARENDON,7087,52,6061,13200,0.5368939393939394,0.45916666666666667,0.00393939393939394
2004,SOUTH CAROLINA,COLLETON,6699,143,7264,14106,0.4749042960442365,0.5149581738267404,0.01013753012902311
2004,SOUTH CAROLINA,DARLINGTON,11829,209,13416,25454,0.4647206725858411,0.5270684371807968,0.008210890233362144
2004,SOUTH CAROLINA,DILLON,4832,102,4301,9235,0.5232268543584191,0.46572820790471037,0.0110449377368706
2004,SOUTH CAROLINA,DORCHESTER,14733,578,26006,41317,0.3565844567611395,0.6294261442021444,0.013989399036716121
2004,SOUTH CAROLINA,EDGEFIELD,4051,84,5611,9746,0.4156577057254258,0.575723373691771,0.008618920582803202
2004,SOUTH CAROLINA,FAIRFIELD,5764,140,3531,9435,0.6109167991520933,0.3742448330683625,0.01483836777954425
2004,SOUTH CAROLINA,FLORENCE,21442,414,27689,49545,0.432778282369563,0.5588656776667675,0.008356039963669392
2004,SOUTH CAROLINA,GEORGETOWN,10602,385,12606,23593,0.44937057601831054,0.5343110244564065,0.016318399525282922
2004,SOUTH CAROLINA,GREENVILLE,55347,2005,111481,168833,0.32782098286472433,0.6603033767095295,0.011875640425746152
2004,SOUTH CAROLINA,GREENWOOD,8954,224,14264,23442,0.3819639962460541,0.6084805050763586,0.009555498677587237
2004,SOUTH CAROLINA,HAMPTON,4832,87,3097,8016,0.6027944111776448,0.38635229540918165,0.010853293413173653
2004,SOUTH CAROLINA,HORRY,29547,1353,50447,81347,0.36322175372171067,0.6201457951737618,0.016632451104527518
2004,SOUTH CAROLINA,JASPER,3840,73,2933,6846,0.5609114811568799,0.4284253578732106,0.010663160969909435
2004,SOUTH CAROLINA,KERSHAW,8515,240,14160,22915,0.3715906611389919,0.6179358498799913,0.010473488981016802
2004,SOUTH CAROLINA,LANCASTER,7631,267,12916,20814,0.3666282309983665,0.6205438647064476,0.012827904295185932
2004,SOUTH CAROLINA,LAURENS,9205,158,14466,23829,0.38629401149859416,0.6070754123127282,0.006630576188677662
2004,SOUTH CAROLINA,LEE,4960,37,2901,7898,0.6280070904026336,0.36730817928589515,0.004684730311471258
2004,SOUTH CAROLINA,LEXINGTON,25393,907,67132,93432,0.2717805462796472,0.7185118588920284,0.009707594828324343
2004,SOUTH CAROLINA,MARION,7767,151,5589,13507,0.5750351669504701,0.4137854445842896,0.011179388465240246
2004,SOUTH CAROLINA,MARLBORO,4984,153,3423,8560,0.5822429906542056,0.39988317757009345,0.017873831775700934
2004,SOUTH CAROLINA,MCCORMICK,2648,78,2396,5122,0.5169855525185475,0.4677860210855135,0.015228426395939087
2004,SOUTH CAROLINA,NEWBERRY,4483,272,7654,12409,0.36127004593440243,0.6168103795632203,0.021919574502377307
2004,SOUTH CAROLINA,OCONEE,8395,326,18811,27532,0.3049179137004213,0.6832413191922126,0.011840767107365974
2004,SOUTH CAROLINA,ORANGEBURG,24698,171,12695,37564,0.6574912149930785,0.33795655414758813,0.004552230859333404
2004,SOUTH CAROLINA,PICKENS,10287,464,29759,40510,0.25393729943223897,0.7346087385830659,0.011453961984695137
2004,SOUTH CAROLINA,RICHLAND,76283,1306,56212,133801,0.5701227942989963,0.4201164415811541,0.009760764119849627
2004,SOUTH CAROLINA,SALUDA,3001,40,4537,7578,0.3960147796252309,0.5987067827922935,0.005278437582475587
2004,SOUTH CAROLINA,SPARTANBURG,33633,1121,62004,96758,0.3475991649269311,0.6408152297484446,0.011585605324624321
2004,SOUTH CAROLINA,SUMTER,18695,234,18074,37003,0.5052293057319677,0.4884468826851877,0.006323811582844634
2004,SOUTH CAROLINA,UNION,5236,106,6592,11934,0.43874643874643876,0.5523713759007877,0.008882185352773589
2004,SOUTH CAROLINA,WILLIAMSBURG,9044,79,4795,13918,0.6498060066101451,0.34451789050150883,0.005676102888346027
2004,SOUTH CAROLINA,YORK,24226,721,45234,70181,0.3451931434433821,0.6445334207264074,0.010273435830210455
2004,SOUTH DAKOTA,AURORA,620,20,1009,1649,0.3759854457246816,0.6118859915100061,0.01212856276531231
2004,SOUTH DAKOTA,BEADLE,3443,120,4917,8480,0.4060141509433962,0.5798349056603773,0.014150943396226415
2004,SOUTH DAKOTA,BENNETT,759,38,833,1630,0.4656441717791411,0.5110429447852761,0.023312883435582823
2004,SOUTH DAKOTA,BON HOMME,1293,52,2063,3408,0.37940140845070425,0.6053403755868545,0.015258215962441314
2004,SOUTH DAKOTA,BROOKINGS,5443,270,7662,13375,0.40695327102803736,0.5728598130841122,0.020186915887850466
2004,SOUTH DAKOTA,BROWN,7943,270,10386,18599,0.427065971288779,0.558417119199957,0.014516909511264046
2004,SOUTH DAKOTA,BRULE,1040,45,1544,2629,0.39558767592240396,0.5872955496386458,0.017116774438950173
2004,SOUTH DAKOTA,BUFFALO,603,15,223,841,0.7170035671819263,0.26516052318668254,0.0178359096313912
2004,SOUTH DAKOTA,BUTTE,1009,96,3166,4271,0.23624443924139546,0.7412783891360337,0.022477171622570825
2004,SOUTH DAKOTA,CAMPBELL,239,12,708,959,0.2492179353493222,0.7382690302398331,0.01251303441084463
2004,SOUTH DAKOTA,CHARLES MIX,2155,87,2556,4798,0.44914547728220094,0.5327219674864527,0.018132555231346395
2004,SOUTH DAKOTA,CLARK,875,17,1435,2327,0.3760206274172755,0.6166738289643318,0.00730554361839278
2004,SOUTH DAKOTA,CLAY,3315,129,2692,6136,0.5402542372881356,0.438722294654498,0.02102346805736636
2004,SOUTH DAKOTA,CODINGTON,4803,170,7778,12751,0.376676339110658,0.6099913732256294,0.01333228766371265
2004,SOUTH DAKOTA,CORSON,972,32,720,1724,0.5638051044083526,0.4176334106728538,0.018561484918793503
2004,SOUTH DAKOTA,CUSTER,1272,110,2922,4304,0.2955390334572491,0.6789033457249071,0.025557620817843865
2004,SOUTH DAKOTA,DAVISON,3263,128,5561,8952,0.3644995531724754,0.6212019660411081,0.014298480786416443
2004,SOUTH DAKOTA,DAY,1817,52,1671,3540,0.5132768361581921,0.47203389830508474,0.014689265536723164
2004,SOUTH DAKOTA,DEUEL,961,45,1406,2412,0.398424543946932,0.5829187396351575,0.018656716417910446
2004,SOUTH DAKOTA,DEWEY,1606,37,921,2564,0.6263650546021841,0.359204368174727,0.014430577223088924
2004,SOUTH DAKOTA,DOUGLAS,393,23,1596,2012,0.19532803180914513,0.7932405566600398,0.01143141153081511
2004,SOUTH DAKOTA,EDMUNDS,765,35,1434,2234,0.3424350940017905,0.6418979409131602,0.01566696508504924
2004,SOUTH DAKOTA,FALL RIVER,1326,106,2413,3845,0.3448634590377113,0.6275682704811444,0.027568270481144342
2004,SOUTH DAKOTA,FAULK,418,6,945,1369,0.30533235938641345,0.6902848794740687,0.004382761139517896
2004,SOUTH DAKOTA,GRANT,1633,65,2392,4090,0.3992665036674817,0.5848410757946211,0.01589242053789731
2004,SOUTH DAKOTA,GREGORY,813,48,1685,2546,0.319324430479183,0.6618224666142969,0.018853102906520033
2004,SOUTH DAKOTA,HAAKON,219,14,1007,1240,0.17661290322580644,0.8120967741935484,0.01129032258064516
2004,SOUTH DAKOTA,HAMLIN,1015,50,1946,3011,0.33709730986383263,0.6462969113251411,0.016605778811026237
2004,SOUTH DAKOTA,HAND,668,37,1482,2187,0.30544124371284864,0.6776406035665294,0.016918152720621856
2004,SOUTH DAKOTA,HANSON,745,26,1379,2150,0.34651162790697676,0.6413953488372093,0.012093023255813953
2004,SOUTH DAKOTA,HARDING,94,17,704,815,0.11533742331288344,0.8638036809815951,0.020858895705521473
2004,SOUTH DAKOTA,HUGHES,2697,121,6017,8835,0.30526315789473685,0.681041312959819,0.013695529145444255
2004,SOUTH DAKOTA,HUTCHINSON,1177,71,2899,4147,0.2838196286472148,0.6990595611285266,0.0171208102242585
2004,SOUTH DAKOTA,HYDE,259,10,631,900,0.2877777777777778,0.7011111111111111,0.011111111111111112
2004,SOUTH DAKOTA,JACKSON,508,37,726,1271,0.3996852871754524,0.5712037765538945,0.029110936270653028
2004,SOUTH DAKOTA,JERAULD,482,18,736,1236,0.38996763754045305,0.5954692556634305,0.014563106796116505
2004,SOUTH DAKOTA,JONES,134,18,565,717,0.18688981868898186,0.7880055788005579,0.02510460251046025
2004,SOUTH DAKOTA,KINGSBURY,1163,47,1804,3014,0.3858659588586596,0.5985401459854015,0.015593895155938951
2004,SOUTH DAKOTA,LAKE,2509,139,3359,6007,0.41767937406359246,0.5591809555518562,0.023139670384551357
2004,SOUTH DAKOTA,LAWRENCE,3857,273,7489,11619,0.3319562785093382,0.6445477235562441,0.023495997934417763
2004,SOUTH DAKOTA,LINCOLN,5703,202,11161,17066,0.33417320989101135,0.6539903902496191,0.011836399859369507
2004,SOUTH DAKOTA,LYMAN,872,39,1029,1940,0.44948453608247424,0.5304123711340206,0.020103092783505156
2004,SOUTH DAKOTA,MARSHALL,1099,23,1242,2364,0.46489001692047377,0.5253807106598984,0.00972927241962775
2004,SOUTH DAKOTA,MCCOOK,1201,53,2017,3271,0.3671660042800367,0.6166309996942831,0.01620299602568022
2004,SOUTH DAKOTA,MCPHERSON,369,30,1180,1579,0.233692210259658,0.747308423052565,0.018999366687777075
2004,SOUTH DAKOTA,MEADE,2941,216,8347,11504,0.2556502086230876,0.7255737134909597,0.018776077885952713
2004,SOUTH DAKOTA,MELLETTE,361,17,553,931,0.3877551020408163,0.5939849624060151,0.018259935553168637
2004,SOUTH DAKOTA,MINER,641,19,810,1470,0.43605442176870746,0.5510204081632653,0.01292517006802721
2004,SOUTH DAKOTA,MINNEHAHA,32314,1129,44189,77632,0.41624587798845836,0.5692111500412201,0.014542971970321518
2004,SOUTH DAKOTA,MOODY,1609,52,1790,3451,0.46624166908142567,0.5186902347145755,0.015068096203998842
2004,SOUTH DAKOTA,OGLALA LAKOTA,3566,122,526,4214,0.8462268628381585,0.12482202183198861,0.02895111532985287
2004,SOUTH DAKOTA,PENNINGTON,14213,779,29976,44968,0.3160692047678349,0.6666073652375022,0.01732342999466287
2004,SOUTH DAKOTA,PERKINS,418,66,1329,1813,0.23055708769994485,0.7330391616105901,0.03640375068946498
2004,SOUTH DAKOTA,POTTER,463,12,1143,1618,0.2861557478368356,0.7064276885043264,0.007416563658838072
2004,SOUTH DAKOTA,ROBERTS,2527,59,2396,4982,0.5072260136491369,0.4809313528703332,0.011842633480529908
2004,SOUTH DAKOTA,SANBORN,581,28,817,1426,0.4074333800841515,0.5729312762973352,0.019635343618513323
2004,SOUTH DAKOTA,SPINK,1478,37,2259,3774,0.39162692103868574,0.5985691573926868,0.00980392156862745
2004,SOUTH DAKOTA,STANLEY,464,30,1129,1623,0.2858903265557609,0.6956253850893407,0.018484288354898338
2004,SOUTH DAKOTA,SULLY,201,14,702,917,0.21919302071973829,0.7655398037077427,0.015267175572519083
2004,SOUTH DAKOTA,TODD,2543,92,889,3524,0.7216231555051078,0.2522701475595914,0.026106696935300794
2004,SOUTH DAKOTA,TRIPP,972,43,2230,3245,0.299537750385208,0.687211093990755,0.01325115562403698
2004,SOUTH DAKOTA,TURNER,1646,104,3084,4834,0.3405047579644187,0.6379809681423252,0.0215142738932561
2004,SOUTH DAKOTA,UNION,3000,61,3987,7048,0.42565266742338254,0.5656923950056754,0.008654937570942111
2004,SOUTH DAKOTA,WALWORTH,878,35,1967,2880,0.30486111111111114,0.6829861111111111,0.012152777777777778
2004,SOUTH DAKOTA,YANKTON,4237,191,6003,10431,0.40619307832422585,0.5754961173425367,0.018310804333237465
2004,SOUTH DAKOTA,ZIEBACH,641,28,447,1116,0.5743727598566308,0.40053763440860213,0.025089605734767026
2004,TENNESSEE,ANDERSON,12896,276,18510,31682,0.4070450097847358,0.5842434189760748,0.008711571239189446
2004,TENNESSEE,BEDFORD,5261,87,8348,13696,0.3841267523364486,0.6095210280373832,0.006352219626168224
2004,TENNESSEE,BENTON,3869,60,3161,7090,0.5456981664315937,0.4458392101551481,0.00846262341325811
2004,TENNESSEE,BLEDSOE,1927,24,2849,4800,0.4014583333333333,0.5935416666666666,0.005
2004,TENNESSEE,BLOUNT,15042,428,33240,48710,0.308807226442209,0.6824060767809484,0.008786696776842538
2004,TENNESSEE,BRADLEY,9426,255,25942,35623,0.26460432866406536,0.7282373747298094,0.0071582966061252565
2004,TENNESSEE,CAMPBELL,6163,96,7859,14118,0.43653491996033433,0.5566652500354158,0.006799830004249894
2004,TENNESSEE,CANNON,2510,34,2923,5467,0.4591183464422901,0.5346625205780136,0.00621913297969636
2004,TENNESSEE,CARROLL,5070,82,6603,11755,0.4313058273075287,0.5617184176945981,0.006975754997873246
2004,TENNESSEE,CARTER,6390,149,15763,22302,0.28652138821630346,0.7067975966281052,0.006681015155591427
2004,TENNESSEE,CHEATHAM,5918,103,9676,15697,0.3770147161878066,0.6164235204179143,0.006561763394279161
2004,TENNESSEE,CHESTER,2182,29,4086,6297,0.3465142131173575,0.6488804192472606,0.004605367635381928
2004,TENNESSEE,CLAIBORNE,4033,58,6447,10538,0.3827101916872272,0.6117859176314291,0.005503890681343709
2004,TENNESSEE,CLAY,1673,32,1647,3352,0.49910501193317425,0.49134844868735084,0.00954653937947494
2004,TENNESSEE,COCKE,3932,79,8290,12301,0.31964880903991544,0.6739289488659459,0.006422242094138688
2004,TENNESSEE,COFFEE,8238,131,11785,20154,0.408752604941947,0.5847474446759948,0.0064999503820581525
2004,TENNESSEE,CROCKETT,2455,21,3239,5715,0.42957130358705164,0.5667541557305337,0.003674540682414698
2004,TENNESSEE,CUMBERLAND,8326,166,15142,23634,0.35228907506135226,0.6406871456376407,0.007023779301007024
2004,TENNESSEE,DAVIDSON,132362,1695,107618,241675,0.5476859418640736,0.44530050687907313,0.007013551256853212
2004,TENNESSEE,DECATUR,2268,45,2566,4879,0.4648493543758967,0.5259274441483911,0.009223201475712236
2004,TENNESSEE,DEKALB,3445,43,3685,7173,0.48027324689809003,0.5137320507458525,0.005994702356057437
2004,TENNESSEE,DICKSON,8592,134,10557,19283,0.4455738215008038,0.547477052325883,0.006949126173313281
2004,TENNESSEE,DYER,5287,75,8447,13809,0.38286624665073504,0.6117025128539358,0.005431240495329133
2004,TENNESSEE,FAYETTE,5692,79,8960,14731,0.3863960355712443,0.6082411241599348,0.005362840268820854
2004,TENNESSEE,FENTRESS,2371,36,4293,6700,0.35388059701492536,0.6407462686567165,0.005373134328358209
2004,TENNESSEE,FRANKLIN,7797,147,9126,17070,0.4567662565905097,0.534622144112478,0.008611599297012303
2004,TENNESSEE,GIBSON,8509,114,10596,19219,0.4427389562412196,0.5513294136011239,0.005931630157656486
2004,TENNESSEE,GILES,5273,101,6162,11536,0.4570908460471567,0.5341539528432733,0.008755201109570041
2004,TENNESSEE,GRAINGER,2569,51,4905,7525,0.3413953488372093,0.651827242524917,0.006777408637873754
2004,TENNESSEE,GREENE,7625,173,16374,24172,0.31544762535164655,0.6773953334436538,0.0071570412046996525
2004,TENNESSEE,GRUNDY,2787,34,2102,4923,0.5661182205971969,0.4269754214909608,0.0069063579118423726
2004,TENNESSEE,HAMBLEN,7426,143,14733,22302,0.3329746211102143,0.6606133979015335,0.006411980988252175
2004,TENNESSEE,HAMILTON,57268,1082,78513,136863,0.4184330315717177,0.5736612524933693,0.007905715934913016
2004,TENNESSEE,HANCOCK,776,18,1756,2550,0.3043137254901961,0.6886274509803921,0.007058823529411765
2004,TENNESSEE,HARDEMAN,5683,77,4702,10462,0.5432039762951635,0.4494360542917224,0.007359969413114127
2004,TENNESSEE,HARDIN,3834,33,6087,9954,0.38517179023508136,0.6115129596142255,0.003315250150693189
2004,TENNESSEE,HAWKINS,6683,102,13445,20230,0.33035096391497776,0.6646070192782996,0.005042016806722689
2004,TENNESSEE,HAYWOOD,4359,49,3140,7548,0.5775039745627981,0.4160042395336513,0.006491785903550609
2004,TENNESSEE,HENDERSON,3448,63,6585,10096,0.3415213946117274,0.6522385103011094,0.0062400950871632326
2004,TENNESSEE,HENRY,5728,105,6337,12170,0.47066557107641743,0.5207066557107641,0.008627773212818405
2004,TENNESSEE,HICKMAN,4261,51,4359,8671,0.49140814208280476,0.5027101833698535,0.0058816745473417135
2004,TENNESSEE,HOUSTON,2126,29,1438,3593,0.5917060951850821,0.4002226551628166,0.008071249652101308
2004,TENNESSEE,HUMPHREYS,4485,47,3261,7793,0.5755164891569358,0.41845245733350445,0.006031053509559861
2004,TENNESSEE,JACKSON,2996,32,2024,5052,0.5930324623911323,0.4006334125098971,0.006334125098970704
2004,TENNESSEE,JEFFERSON,5469,121,11617,17207,0.3178357645144418,0.6751322136339861,0.0070320218515720345
2004,TENNESSEE,JOHNSON,1810,34,4632,6476,0.2794935145151328,0.7152563310685608,0.005250154416306362
2004,TENNESSEE,KNOX,65921,1601,110653,178175,0.36997895327627334,0.6210354988073523,0.008985547916374351
2004,TENNESSEE,LAKE,1039,14,1317,2370,0.4383966244725738,0.5556962025316455,0.00590717299578059
2004,TENNESSEE,LAUDERDALE,4473,44,4164,8681,0.5152632185232117,0.47966824098606153,0.005068540490726875
2004,TENNESSEE,LAWRENCE,6592,107,9952,16651,0.39589213861029365,0.597681820911657,0.006426040478049367
2004,TENNESSEE,LEWIS,2191,43,2819,5053,0.4336037997229369,0.5578864041163665,0.008509796160696616
2004,TENNESSEE,LINCOLN,4546,82,7827,12455,0.36499397832195907,0.6284223203532717,0.006583701324769169
2004,TENNESSEE,LOUDON,5706,115,14041,19862,0.28728224750780385,0.7069278018326453,0.005789950659550901
2004,TENNESSEE,MACON,2739,25,4670,7434,0.36844229217110575,0.6281947807371536,0.003362927091740651
2004,TENNESSEE,MADISON,16837,156,21672,38665,0.4354584249321091,0.5605069184016552,0.004034656666235614
2004,TENNESSEE,MARION,5548,82,5862,11492,0.48277062304211626,0.5100939784197702,0.00713539853811347
2004,TENNESSEE,MARSHALL,4722,68,5825,10615,0.4448422044276967,0.5487517663683467,0.0064060292039566655
2004,TENNESSEE,MAURY,12372,159,17495,30026,0.41204289615666423,0.5826616931992273,0.00529541064410844
2004,TENNESSEE,MCMINN,5889,132,11978,17999,0.32718484360242234,0.6654814156342019,0.007333740763375743
2004,TENNESSEE,MCNAIRY,4101,36,5787,9924,0.41324062877871826,0.5831318016928658,0.0036275695284159614
2004,TENNESSEE,MEIGS,1595,37,2499,4131,0.3861050593076737,0.6049382716049383,0.008956669087388042
2004,TENNESSEE,MONROE,5349,91,10113,15553,0.34392078698643347,0.6502282517842217,0.005850961229344821
2004,TENNESSEE,MONTGOMERY,20061,299,28615,48975,0.40961715160796325,0.5842776927003573,0.006105155691679428
2004,TENNESSEE,MOORE,1084,22,1667,2773,0.39091236927515327,0.6011539848539488,0.007933645870897944
2004,TENNESSEE,MORGAN,2924,35,4401,7360,0.3972826086956522,0.5979619565217391,0.004755434782608696
2004,TENNESSEE,OBION,5549,127,7859,13535,0.40997414111562613,0.580642777983007,0.009383080901366827
2004,TENNESSEE,OVERTON,4518,51,3941,8510,0.5309048178613396,0.46310223266745004,0.005992949471210341
2004,TENNESSEE,PERRY,1579,49,1520,3148,0.5015883100381194,0.48284625158831,0.015565438373570521
2004,TENNESSEE,PICKETT,1033,12,1600,2645,0.39054820415879016,0.6049149338374291,0.004536862003780718
2004,TENNESSEE,POLK,2724,52,3923,6699,0.40662785490371695,0.5856097925063443,0.007762352589938797
2004,TENNESSEE,PUTNAM,10549,239,15619,26407,0.39947741129246034,0.5914719581929034,0.00905063051463627
2004,TENNESSEE,RHEA,3663,86,7288,11037,0.33188366403914105,0.6603243635045756,0.007791972456283411
2004,TENNESSEE,ROANE,8676,165,14423,23264,0.37293672627235214,0.6199707702888583,0.007092503438789546
2004,TENNESSEE,ROBERTSON,9863,127,15329,25319,0.3895493502902958,0.6054346538172913,0.005015995892412813
2004,TENNESSEE,RUTHERFORD,31639,562,52189,84390,0.37491408934707904,0.6184263538333926,0.0066595568195283806
2004,TENNESSEE,SCOTT,3085,33,4508,7626,0.4045371098872279,0.5911355887752426,0.004327301337529505
2004,TENNESSEE,SEQUATCHIE,1986,46,2950,4982,0.3986350863107186,0.5921316740264954,0.00923323966278603
2004,TENNESSEE,SEVIER,8613,204,22127,30944,0.2783415201654602,0.7150659255429163,0.006592554291623578
2004,TENNESSEE,SHELBY,215810,2183,157591,375584,0.5745984919485388,0.41958922637812046,0.005812281673340717
2004,TENNESSEE,SMITH,4038,45,3738,7821,0.5163022631377062,0.4779439969313387,0.005753739930955121
2004,TENNESSEE,STEWART,2860,48,2675,5583,0.5122693892172667,0.47913308257209386,0.008597528210639442
2004,TENNESSEE,SULLIVAN,19626,446,42526,62598,0.31352439375059904,0.6793507779801271,0.007124828269273778
2004,TENNESSEE,SUMNER,21439,329,40141,61909,0.34629859955741493,0.6483871488798074,0.005314251562777626
2004,TENNESSEE,TIPTON,7379,120,14178,21677,0.34040688287124604,0.654057295751257,0.005535821377496886
2004,TENNESSEE,TROUSDALE,1850,26,1314,3190,0.5799373040752351,0.41191222570532915,0.008150470219435737
2004,TENNESSEE,UNICOI,2372,59,5026,7457,0.31809038487327346,0.6739975861606544,0.007912028966072147
2004,TENNESSEE,UNION,2524,41,4145,6710,0.37615499254843515,0.6177347242921013,0.006110283159463488
2004,TENNESSEE,VAN BUREN,1209,18,1119,2346,0.5153452685421995,0.47698209718670076,0.0076726342710997444
2004,TENNESSEE,WARREN,6803,89,7502,14394,0.47262748367375296,0.5211893844657496,0.006183131860497429
2004,TENNESSEE,WASHINGTON,14937,327,29720,44984,0.33205139605192957,0.6606793526587231,0.007269251289347324
2004,TENNESSEE,WAYNE,1951,34,3998,5983,0.3260905900050142,0.6682266421527662,0.005682767842219622
2004,TENNESSEE,WEAKLEY,5584,91,7816,13491,0.413905566674079,0.5793491957601364,0.006745237565784597
2004,TENNESSEE,WHITE,4147,79,5268,9494,0.4368021908573836,0.5548767642721719,0.00832104487044449
2004,TENNESSEE,WILLIAMSON,21719,449,57409,79577,0.2729306206567224,0.7214270455030977,0.005642333840179952
2004,TENNESSEE,WILSON,15256,251,28896,44403,0.34358038871247437,0.650766840078373,0.005652771209152535
2004,TEXAS,ANDERSON,4678,98,11525,16301,0.286976259125207,0.7070118397644316,0.006011901110361328
2004,TEXAS,ANDREWS,677,22,3837,4536,0.1492504409171076,0.8458994708994709,0.0048500881834215165
2004,TEXAS,ANGELINA,9302,130,18932,28364,0.32795092370610635,0.6674658017204907,0.004583274573402905
2004,TEXAS,ARANSAS,2640,59,6569,9268,0.2848511005610703,0.7087829089339663,0.006365990504963314
2004,TEXAS,ARCHER,878,17,3556,4451,0.19725904291170523,0.7989215906537857,0.003819366434509099
2004,TEXAS,ARMSTRONG,170,4,830,1004,0.1693227091633466,0.8266932270916335,0.00398406374501992
2004,TEXAS,ATASCOSA,4421,60,7635,12116,0.3648894024430505,0.6301584681413007,0.0049521294156487285
2004,TEXAS,AUSTIN,2582,48,8072,10702,0.24126331526817418,0.7542515417678939,0.004485142963931975
2004,TEXAS,BAILEY,525,5,1882,2412,0.21766169154228857,0.7802653399668324,0.0020729684908789387
2004,TEXAS,BANDERA,1738,70,6933,8741,0.1988330854593296,0.7931586774968539,0.008008237043816497
2004,TEXAS,BASTROP,9794,357,13290,23441,0.41781493963568106,0.5669553346700226,0.015229725694296318
2004,TEXAS,BAYLOR,467,4,1169,1640,0.2847560975609756,0.7128048780487805,0.0024390243902439024
2004,TEXAS,BEE,4045,45,5428,9518,0.42498424038663585,0.5702878756041185,0.00472788400924564
2004,TEXAS,BELL,27165,424,52135,79724,0.3407380462595956,0.6539436054387637,0.00531834830164066
2004,TEXAS,BEXAR,210976,3640,260698,475314,0.44386658082867325,0.5484753236807668,0.0076580954905599245
2004,TEXAS,BLANCO,1267,40,3277,4584,0.2763961605584642,0.7148778359511344,0.008726003490401396
2004,TEXAS,BORDEN,55,1,303,359,0.1532033426183844,0.8440111420612814,0.002785515320334262
2004,TEXAS,BOSQUE,1815,34,5737,7586,0.2392565251779594,0.7562615344054838,0.004481940416556815
2004,TEXAS,BOWIE,11880,89,21791,33760,0.3518957345971564,0.645468009478673,0.002636255924170616
2004,TEXAS,BRAZORIA,28904,682,63662,93248,0.3099691146190803,0.6827170555936857,0.007313829787234043
2004,TEXAS,BRAZOS,16128,587,37594,54309,0.2969673534773242,0.6922241249148392,0.010808521607836638
2004,TEXAS,BREWSTER,1729,51,1980,3760,0.4598404255319149,0.526595744680851,0.013563829787234043
2004,TEXAS,BRISCOE,191,0,620,811,0.23551171393341552,0.7644882860665845,0.0
2004,TEXAS,BROOKS,1823,6,845,2674,0.681750186985789,0.31600598354525056,0.002243829468960359
2004,TEXAS,BROWN,2523,90,11640,14253,0.17701536518627659,0.8166701747000631,0.006314460113660282
2004,TEXAS,BURLESON,2276,40,4405,6721,0.33864008332093437,0.6554084213658682,0.00595149531319744
2004,TEXAS,BURNET,4147,139,11456,15742,0.26343539575657476,0.7277347223986786,0.008829881844746538
2004,TEXAS,CALDWELL,5052,99,6436,11587,0.43600586864589624,0.5554500733580737,0.008544057996030033
2004,TEXAS,CALHOUN,2561,20,4348,6929,0.3696060037523452,0.6275075768509164,0.002886419396738346
2004,TEXAS,CALLAHAN,1073,39,4542,5654,0.1897771489211178,0.803325079589671,0.006897771489211178
2004,TEXAS,CAMERON,33998,357,34801,69156,0.49161316443981723,0.5032245936722771,0.005162241887905605
2004,TEXAS,CAMP,1778,23,2638,4439,0.4005406623113314,0.5942779905384096,0.0051813471502590676
2004,TEXAS,CARSON,485,9,2450,2944,0.16474184782608695,0.8322010869565217,0.0030570652173913045
2004,TEXAS,CASS,4630,36,7383,12049,0.38426425429496225,0.6127479458876255,0.0029877998174122336
2004,TEXAS,CASTRO,631,5,1794,2430,0.25967078189300413,0.7382716049382716,0.00205761316872428
2004,TEXAS,CHAMBERS,2953,78,8618,11649,0.2534981543480127,0.7398059919306378,0.006695853721349472
2004,TEXAS,CHEROKEE,4439,71,11329,15839,0.2802575920196982,0.7152598017551614,0.004482606225140476
2004,TEXAS,CHILDRESS,511,4,1629,2144,0.23833955223880596,0.7597947761194029,0.0018656716417910447
2004,TEXAS,CLAY,1299,18,3971,5288,0.24565052950075644,0.750945537065053,0.00340393343419062
2004,TEXAS,COCHRAN,249,5,856,1110,0.22432432432432434,0.7711711711711712,0.0045045045045045045
2004,TEXAS,COKE,266,6,1338,1610,0.16521739130434782,0.831055900621118,0.0037267080745341614
2004,TEXAS,COLEMAN,778,13,3035,3826,0.20334553058024046,0.7932566649242028,0.003397804495556717
2004,TEXAS,COLLIN,68935,1784,174435,245154,0.2811905985625362,0.711532342935461,0.0072770585020028224
2004,TEXAS,COLLINGSWORTH,346,1,1051,1398,0.2474964234620887,0.751788268955651,0.000715307582260372
2004,TEXAS,COLORADO,2161,41,5488,7690,0.2810143042912874,0.7136540962288687,0.005331599479843953
2004,TEXAS,COMAL,9153,316,31574,41043,0.2230100138878737,0.7692907438540068,0.007699242258119533
2004,TEXAS,COMANCHE,1431,24,3813,5268,0.2716400911161731,0.7238041002277904,0.004555808656036446
2004,TEXAS,CONCHO,270,12,911,1193,0.22632020117351215,0.7636211232187762,0.010058675607711651
2004,TEXAS,COOKE,3142,57,11908,15107,0.20798305421327862,0.7882438604620374,0.0037730853246839215
2004,TEXAS,CORYELL,5122,82,12421,17625,0.2906099290780142,0.7047375886524823,0.004652482269503546
2004,TEXAS,COTTLE,214,5,549,768,0.2786458333333333,0.71484375,0.006510416666666667
2004,TEXAS,CRANE,254,6,1314,1574,0.1613722998729352,0.8348157560355781,0.0038119440914866584
2004,TEXAS,CROCKETT,473,7,1248,1728,0.27372685185185186,0.7222222222222222,0.004050925925925926
2004,TEXAS,CROSBY,622,6,1647,2275,0.2734065934065934,0.723956043956044,0.0026373626373626374
2004,TEXAS,CULBERSON,375,6,407,788,0.47588832487309646,0.516497461928934,0.007614213197969543
2004,TEXAS,DALLAM,305,4,1473,1782,0.17115600448933782,0.8265993265993266,0.002244668911335578
2004,TEXAS,DALLAS,336641,4822,346246,687709,0.48951082507281424,0.5034774882981028,0.007011686629082941
2004,TEXAS,DAWSON,1114,12,3419,4545,0.24510451045104512,0.7522552255225523,0.0026402640264026403
2004,TEXAS,DEAF SMITH,1133,19,4139,5291,0.21413721413721415,0.7822717822717823,0.003591003591003591
2004,TEXAS,DELTA,627,8,1447,2082,0.3011527377521614,0.6950048030739674,0.0038424591738712775
2004,TEXAS,DENTON,59346,1173,140891,201410,0.294652698475746,0.6995233603098158,0.00582394121443821
2004,TEXAS,DEWITT,1610,22,5100,6732,0.23915626856803326,0.7575757575757576,0.0032679738562091504
2004,TEXAS,DICKENS,245,3,815,1063,0.23047977422389465,0.7666980244590781,0.0028222013170272815
2004,TEXAS,DIMMIT,2365,13,1188,3566,0.6632080762759395,0.3331463825014021,0.0036455412226584407
2004,TEXAS,DONLEY,349,6,1429,1784,0.19562780269058297,0.8010089686098655,0.0033632286995515697
2004,TEXAS,DUVAL,2916,15,1160,4091,0.7127841603519922,0.283549254461012,0.0036665851869958446
2004,TEXAS,EASTLAND,1582,26,5249,6857,0.23071313985708036,0.7654951144815517,0.0037917456613679452
2004,TEXAS,ECTOR,8579,229,27502,36310,0.23627099972459378,0.757422197741669,0.006306802533737262
2004,TEXAS,EDWARDS,217,1,745,963,0.22533748701973,0.7736240913811008,0.0010384215991692627
2004,TEXAS,EL PASO,95142,1170,73261,169573,0.5610680945669416,0.4320322221108313,0.006899683322227006
2004,TEXAS,ELLIS,11640,202,34602,46444,0.2506244078890707,0.745026268193954,0.004349323916975282
2004,TEXAS,ERATH,2710,65,9506,12281,0.22066606953831122,0.7740412018565264,0.005292728605162446
2004,TEXAS,FALLS,2427,21,3454,5902,0.41121653676719755,0.5852253473398847,0.003558115892917655
2004,TEXAS,FANNIN,4001,66,7893,11960,0.33453177257525085,0.6599498327759198,0.005518394648829431
2004,TEXAS,FAYETTE,2803,67,7527,10397,0.2695969991343657,0.723958834279119,0.006444166586515341
2004,TEXAS,FISHER,758,4,1161,1923,0.39417576703068125,0.6037441497659907,0.0020800832033281333
2004,TEXAS,FLOYD,545,7,2032,2584,0.21091331269349844,0.7863777089783281,0.0027089783281733747
2004,TEXAS,FOARD,235,5,347,587,0.40034071550255534,0.5911413969335605,0.008517887563884156
2004,TEXAS,FORT BEND,68722,822,93625,163169,0.42117068805961916,0.5737915903143367,0.005037721626044163
2004,TEXAS,FRANKLIN,1011,21,3185,4217,0.23974389376333888,0.755276262746028,0.004979843490633152
2004,TEXAS,FREESTONE,2070,34,5057,7161,0.2890657729367407,0.7061862868314481,0.0047479402318111995
2004,TEXAS,FRIO,1931,8,1991,3930,0.49134860050890583,0.5066157760814249,0.002035623409669211
2004,TEXAS,GAINES,608,16,3540,4164,0.14601344860710855,0.8501440922190202,0.0038424591738712775
2004,TEXAS,GALVESTON,43919,772,61290,105981,0.4144044687255263,0.5783112067257339,0.007284324548739869
2004,TEXAS,GARZA,326,6,1480,1812,0.17991169977924945,0.8167770419426048,0.0033112582781456954
2004,TEXAS,GILLESPIE,2104,152,9297,11553,0.1821171989959318,0.8047260451830693,0.013156755820998874
2004,TEXAS,GLASSCOCK,44,1,488,533,0.0825515947467167,0.9155722326454033,0.001876172607879925
2004,TEXAS,GOLIAD,1219,15,2267,3501,0.3481862325049986,0.6475292773493287,0.004284490145672665
2004,TEXAS,GONZALES,1709,22,4291,6022,0.2837927598804384,0.7125539687811359,0.0036532713384257723
2004,TEXAS,GRAY,1289,23,7260,8572,0.15037330844610358,0.8469435370975268,0.0026831544563695755
2004,TEXAS,GRAYSON,13452,194,30777,44423,0.3028161087724827,0.6928167840983275,0.0043671071291898345
2004,TEXAS,GREGG,12306,153,29939,42398,0.2902495400726449,0.7061417991414689,0.0036086607858861267
2004,TEXAS,GRIMES,2713,54,5263,8030,0.3378580323785803,0.6554171855541718,0.0067247820672478205
2004,TEXAS,GUADALUPE,10290,254,28208,38752,0.26553468208092484,0.7279108175061932,0.006554500412881916
2004,TEXAS,HALE,2078,51,8025,10154,0.20464841441796336,0.7903289344100847,0.00502265117195194
2004,TEXAS,HALL,413,4,860,1277,0.32341425215348474,0.6734534064212999,0.0031323414252153485
2004,TEXAS,HAMILTON,845,29,2856,3730,0.22654155495978553,0.7656836461126005,0.007774798927613941
2004,TEXAS,HANSFORD,240,4,1903,2147,0.11178388448998602,0.8863530507685142,0.0018630647414997672
2004,TEXAS,HARDEMAN,480,8,1214,1702,0.282021151586369,0.7132784958871915,0.004700352526439483
2004,TEXAS,HARDIN,5608,72,15030,20710,0.27078705939159825,0.7257363592467407,0.0034765813616610334
2004,TEXAS,HARRIS,475865,7380,584723,1067968,0.44557983010726915,0.5475098504824114,0.00691031941031941
2004,TEXAS,HARRISON,9642,108,16473,26223,0.36769248369751745,0.628188994394234,0.004118521908248484
2004,TEXAS,HARTLEY,315,8,1736,2059,0.152986886838271,0.8431277319086935,0.003885381253035454
2004,TEXAS,HASKELL,867,10,1539,2416,0.35885761589403975,0.6370033112582781,0.0041390728476821195
2004,TEXAS,HAYS,20110,692,27021,47823,0.4205089601237898,0.5650210149927859,0.014470024883424294
2004,TEXAS,HEMPHILL,257,6,1380,1643,0.15642118076688982,0.8399269628727937,0.0036518563603164943
2004,TEXAS,HENDERSON,8505,134,20210,28849,0.29481091199001697,0.7005442129709869,0.004644875038996152
2004,TEXAS,HIDALGO,62369,383,50931,113683,0.5486220455125217,0.44800893713220097,0.003369017355277394
2004,TEXAS,HILL,3751,77,9225,13053,0.2873668888378151,0.7067340841185934,0.005899027043591512
2004,TEXAS,HOCKLEY,1385,32,6160,7577,0.18279002243632045,0.8129866701860895,0.0042233073775900755
2004,TEXAS,HOOD,4865,148,16280,21293,0.2284788428121918,0.7645705161320622,0.00695064105574602
2004,TEXAS,HOPKINS,3443,37,8582,12062,0.2854418836013928,0.7114906317360306,0.003067484662576687
2004,TEXAS,HOUSTON,2921,37,5848,8806,0.331705655235067,0.6640926640926641,0.004201680672268907
2004,TEXAS,HOWARD,2663,58,7480,10201,0.261052837957063,0.7332614449563768,0.005685717086560141
2004,TEXAS,HUDSPETH,302,7,577,886,0.34085778781038373,0.6512415349887133,0.007900677200902935
2004,TEXAS,HUNT,7971,158,20065,28194,0.28271972760161734,0.7116762431723062,0.00560402922607647
2004,TEXAS,HUTCHINSON,1503,27,7839,9369,0.16042267050912584,0.8366954851104706,0.002881844380403458
2004,TEXAS,IRION,141,3,684,828,0.17028985507246377,0.8260869565217391,0.0036231884057971015
2004,TEXAS,JACK,643,13,2470,3126,0.2056941778630838,0.7901471529110684,0.004158669225847729
2004,TEXAS,JACKSON,1296,15,3766,5077,0.2552688595627339,0.7417766397478827,0.0029545006893834944
2004,TEXAS,JASPER,4471,55,8347,12873,0.34731608793599006,0.6484114037131982,0.004272508350811777
2004,TEXAS,JEFF DAVIS,378,25,764,1167,0.32390745501285345,0.6546700942587832,0.021422450728363324
2004,TEXAS,JEFFERSON,47066,377,44423,91866,0.5123331809374524,0.48356301569677573,0.0041038033657718855
2004,TEXAS,JIM HOGG,1344,9,712,2065,0.6508474576271186,0.3447941888619855,0.0043583535108958835
2004,TEXAS,JIM WELLS,6824,50,5817,12691,0.5377038846426602,0.45835631549917266,0.003939799858167205
2004,TEXAS,JOHNSON,12325,279,34818,47422,0.2599004681371515,0.7342161865800684,0.005883345282780144
2004,TEXAS,JONES,1658,19,4254,5931,0.2795481369077727,0.7172483560950936,0.0032035069971337042
2004,TEXAS,KARNES,1543,16,3114,4673,0.33019473571581426,0.6663813396105286,0.0034239246736571796
2004,TEXAS,KAUFMAN,8947,115,21304,30366,0.294638740696832,0.701574128960021,0.0037871303431469406
2004,TEXAS,KENDALL,2532,106,11434,14072,0.17993177942012506,0.8125355315520182,0.007532689027856736
2004,TEXAS,KENEDY,85,2,82,169,0.5029585798816568,0.48520710059171596,0.011834319526627219
2004,TEXAS,KENT,138,2,382,522,0.26436781609195403,0.7318007662835249,0.0038314176245210726
2004,TEXAS,KERR,4557,151,16538,21246,0.21448743292855127,0.7784053468888261,0.0071072201826226115
2004,TEXAS,KIMBLE,324,10,1482,1816,0.17841409691629956,0.816079295154185,0.005506607929515419
2004,TEXAS,KING,18,1,137,156,0.11538461538461539,0.8782051282051282,0.00641025641025641
2004,TEXAS,KINNEY,542,7,1051,1600,0.33875,0.656875,0.004375
2004,TEXAS,KLEBERG,4550,57,5366,9973,0.45623182593001105,0.5380527424044921,0.005715431665496842
2004,TEXAS,KNOX,464,7,1081,1552,0.29896907216494845,0.696520618556701,0.004510309278350515
2004,TEXAS,LA SALLE,1229,12,989,2230,0.5511210762331838,0.44349775784753365,0.0053811659192825115
2004,TEXAS,LAMAR,5338,78,12054,17470,0.3055523755008586,0.6899828277046365,0.004464796794504866
2004,TEXAS,LAMB,857,4,3410,4271,0.20065558417232499,0.7984078670100679,0.0009365488176071178
2004,TEXAS,LAMPASAS,1593,10,5422,7025,0.22676156583629895,0.7718149466192171,0.0014234875444839859
2004,TEXAS,LAVACA,2152,51,5974,8177,0.2631772043536749,0.7305857894093188,0.006237006237006237
2004,TEXAS,LEE,1899,29,4160,6088,0.3119250985545335,0.683311432325887,0.004763469119579501
2004,TEXAS,LEON,1754,22,5023,6799,0.2579791145756729,0.7387851154581556,0.003235769966171496
2004,TEXAS,LIBERTY,6780,90,14821,21691,0.31257203448434834,0.6832787792171868,0.004149186298464801
2004,TEXAS,LIMESTONE,2752,38,5028,7818,0.35200818623688923,0.6431312356101304,0.004860578152980302
2004,TEXAS,LIPSCOMB,184,6,1147,1337,0.137621540762902,0.8578908002991773,0.004487658937920718
2004,TEXAS,LIVE OAK,1036,18,3147,4201,0.24660795048797907,0.7491073553915735,0.0042846941204475126
2004,TEXAS,LLANO,2257,65,7241,9563,0.2360138031998327,0.7571891665795253,0.006797030220642058
2004,TEXAS,LOVING,12,3,65,80,0.15,0.8125,0.0375
2004,TEXAS,LUBBOCK,22472,544,70135,93151,0.24124271344376336,0.752917306309111,0.005839980247125635
2004,TEXAS,LYNN,490,5,1776,2271,0.21576398062527521,0.7820343461030383,0.002201673271686482
2004,TEXAS,MADISON,1235,29,2837,4101,0.30114606193611315,0.6917824920751037,0.007071445988783224
2004,TEXAS,MARION,1884,23,2441,4348,0.43330266789328425,0.5614075436982521,0.0052897884084636615
2004,TEXAS,MARTIN,288,5,1514,1807,0.15938018815716656,0.8378527946873271,0.002767017155506364
2004,TEXAS,MASON,459,18,1600,2077,0.2209918151179586,0.7703418391911411,0.008666345690900338
2004,TEXAS,MATAGORDA,4355,47,8119,12521,0.3478156696749461,0.6484306365306285,0.0037536937944253656
2004,TEXAS,MAVERICK,5948,61,4025,10034,0.5927845325891967,0.40113613713374524,0.006079330277058002
2004,TEXAS,MCCULLOCH,745,10,2465,3220,0.23136645962732919,0.765527950310559,0.003105590062111801
2004,TEXAS,MCLENNAN,26760,404,52090,79254,0.3376485729426906,0.6572538925480101,0.005097534509299216
2004,TEXAS,MCMULLEN,95,2,467,564,0.16843971631205673,0.8280141843971631,0.0035460992907801418
2004,TEXAS,MEDINA,4322,115,10389,14826,0.2915149062457844,0.7007284500202348,0.0077566437339808446
2004,TEXAS,MENARD,331,11,761,1103,0.300090661831369,0.6899365367180417,0.009972801450589302
2004,TEXAS,MIDLAND,8005,244,36585,44834,0.17854753089173395,0.8160101708524781,0.005442298255788018
2004,TEXAS,MILAM,3445,47,5291,8783,0.39223499943071843,0.6024137538426506,0.005351246726630992
2004,TEXAS,MILLS,416,21,1794,2231,0.1864634692962797,0.8041237113402062,0.00941281936351412
2004,TEXAS,MITCHELL,639,7,1912,2558,0.24980453479280687,0.7474589523064894,0.002736512900703675
2004,TEXAS,MONTAGUE,1946,41,5910,7897,0.24642269216158036,0.7483854628339875,0.005191845004432063
2004,TEXAS,MONTGOMERY,28628,706,104654,133988,0.21366092485894259,0.7810699465623787,0.005269128578678688
2004,TEXAS,MOORE,1009,18,4601,5628,0.17928216062544422,0.8175195451314854,0.0031982942430703624
2004,TEXAS,MORRIS,2437,23,2818,5278,0.46172792724516865,0.5339143615005684,0.004357711254262978
2004,TEXAS,MOTLEY,113,7,564,684,0.1652046783625731,0.8245614035087719,0.01023391812865497
2004,TEXAS,NACOGDOCHES,7152,154,14160,21466,0.3331780490077332,0.6596478151495389,0.007174135842728035
2004,TEXAS,NAVARRO,5259,60,10715,16034,0.32799052014469254,0.6682674317076213,0.003742048147686167
2004,TEXAS,NEWTON,2513,28,3159,5700,0.44087719298245615,0.5542105263157895,0.004912280701754386
2004,TEXAS,NOLAN,1541,26,3722,5289,0.2913594252221592,0.7037247116657213,0.004915863112119493
2004,TEXAS,NUECES,44439,762,59359,104560,0.4250095638867636,0.5677027543993879,0.007287681713848508
2004,TEXAS,OCHILTREE,251,4,2922,3177,0.07900535096002519,0.9197355996222851,0.0012590494176896443
2004,TEXAS,OLDHAM,108,2,733,843,0.12811387900355872,0.8695136417556346,0.002372479240806643
2004,TEXAS,ORANGE,11476,140,20292,31908,0.35965901968158454,0.6359533659270402,0.004387614391375204
2004,TEXAS,PALO PINTO,2816,61,7137,10014,0.2812063111643699,0.7127022168963452,0.006091471939285001
2004,TEXAS,PANOLA,2958,28,7021,10007,0.2955930848406116,0.7016088737883481,0.0027980413710402717
2004,TEXAS,PARKER,8966,196,31795,40957,0.21891251800668995,0.7763019752423274,0.004785506750982738
2004,TEXAS,PARMER,389,9,2375,2773,0.14028128380815003,0.856473133790119,0.0032455824017309774
2004,TEXAS,PECOS,1242,19,3167,4428,0.2804878048780488,0.7152213188798555,0.004290876242095754
2004,TEXAS,POLK,6964,104,13778,20846,0.3340688861172407,0.6609421471745179,0.004988966708241389
2004,TEXAS,POTTER,7489,166,21401,29056,0.25774366740088106,0.7365432268722467,0.005713105726872247
2004,TEXAS,PRESIDIO,1159,16,715,1890,0.6132275132275132,0.3783068783068783,0.008465608465608466
2004,TEXAS,RAINS,1213,18,2998,4229,0.2868290375975408,0.7089146370300308,0.00425632537242847
2004,TEXAS,RANDALL,7849,218,40520,48587,0.16154526931072097,0.8339679338094552,0.004486796879823821
2004,TEXAS,REAGAN,184,3,956,1143,0.1609798775153106,0.8363954505686789,0.0026246719160104987
2004,TEXAS,REAL,325,6,1314,1645,0.19756838905775076,0.7987841945288754,0.00364741641337386
2004,TEXAS,RED RIVER,2097,14,3379,5490,0.3819672131147541,0.6154826958105647,0.0025500910746812386
2004,TEXAS,REEVES,1600,18,1777,3395,0.47128129602356406,0.5234167893961709,0.005301914580265096
2004,TEXAS,REFUGIO,1232,11,2212,3455,0.35658465991316934,0.640231548480463,0.0031837916063675834
2004,TEXAS,ROBERTS,46,0,461,507,0.09072978303747535,0.9092702169625246,0.0
2004,TEXAS,ROBERTSON,2979,24,3792,6795,0.4384105960264901,0.5580573951434878,0.003532008830022075
2004,TEXAS,ROCKWALL,5320,141,20120,25581,0.20796685039677887,0.7865212462374419,0.005511903365779289
2004,TEXAS,RUNNELS,792,18,3239,4049,0.19560385280316128,0.799950605087676,0.004445542109162756
2004,TEXAS,RUSK,4899,55,13390,18344,0.26706279982555603,0.7299389446140427,0.002998255560401221
2004,TEXAS,SABINE,1476,25,3138,4639,0.31817201983186033,0.6764388876913128,0.0053890924768269025
2004,TEXAS,SAN AUGUSTINE,1506,16,2235,3757,0.40085174341229707,0.5948895395262177,0.004258717061485228
2004,TEXAS,SAN JACINTO,2688,43,5394,8125,0.3308307692307692,0.663876923076923,0.0052923076923076925
2004,TEXAS,SAN PATRICIO,7764,82,13474,21320,0.3641651031894934,0.6319887429643527,0.0038461538461538464
2004,TEXAS,SAN SABA,529,8,1894,2431,0.21760592348827643,0.779103249691485,0.003290826820238585
2004,TEXAS,SCHLEICHER,312,5,1012,1329,0.23476297968397292,0.7614747930775019,0.003762227238525207
2004,TEXAS,SCURRY,981,15,4576,5572,0.1760588657573582,0.8212491026561378,0.0026920315865039484
2004,TEXAS,SHACKELFORD,229,6,1292,1527,0.14996725605762934,0.8461034708578913,0.003929273084479371
2004,TEXAS,SHELBY,2951,33,6295,9279,0.31802996012501344,0.6784136221575601,0.003556417717426447
2004,TEXAS,SHERMAN,124,0,942,1066,0.11632270168855535,0.8836772983114447,0.0
2004,TEXAS,SMITH,19970,302,53392,73664,0.2710957862728063,0.7248045178105995,0.004099695916594266
2004,TEXAS,SOMERVELL,831,19,2701,3551,0.23401858631371444,0.7606308082230357,0.005350605463249789
2004,TEXAS,STARR,7199,30,2552,9781,0.7360188119824149,0.26091401697167976,0.0030671710459053265
2004,TEXAS,STEPHENS,703,13,2803,3519,0.1997726626882637,0.7965331059960216,0.003694231315714692
2004,TEXAS,STERLING,71,0,544,615,0.11544715447154472,0.8845528455284553,0.0
2004,TEXAS,STONEWALL,250,3,499,752,0.3324468085106383,0.663563829787234,0.003989361702127659
2004,TEXAS,SUTTON,280,0,1173,1453,0.19270474879559532,0.8072952512044047,0.0
2004,TEXAS,SWISHER,626,7,1487,2120,0.2952830188679245,0.7014150943396227,0.0033018867924528303
2004,TEXAS,TARRANT,207286,3393,349462,560141,0.3700603955075597,0.6238822010886544,0.006057403403785832
2004,TEXAS,TAYLOR,10648,254,37197,48099,0.22137674379924738,0.7733424811326639,0.005280775068088734
2004,TEXAS,TERRELL,159,4,306,469,0.3390191897654584,0.652452025586354,0.008528784648187633
2004,TEXAS,TERRY,794,10,3166,3970,0.2,0.7974811083123425,0.0025188916876574307
2004,TEXAS,THROCKMORTON,202,5,656,863,0.23406720741599074,0.7601390498261877,0.005793742757821553
2004,TEXAS,TITUS,3173,25,5709,8907,0.3562366677893791,0.6409565510272819,0.002806781183338947
2004,TEXAS,TOM GREEN,9007,225,28185,37417,0.24071945906940695,0.7532672314723254,0.006013309458267633
2004,TEXAS,TRAVIS,197235,6993,147885,352113,0.5601468846648661,0.4199930136064275,0.01986010172870641
2004,TEXAS,TRINITY,2204,24,3985,6213,0.3547400611620795,0.6413970706582971,0.00386286817962337
2004,TEXAS,TYLER,2659,43,5043,7745,0.3433182698515171,0.6511297611362169,0.005551969012265978
2004,TEXAS,UPSHUR,4225,69,10232,14526,0.29085777227041165,0.7043921244664739,0.004750103263114415
2004,TEXAS,UPTON,185,3,1009,1197,0.1545530492898914,0.8429406850459482,0.002506265664160401
2004,TEXAS,UVALDE,3298,37,5148,8483,0.38877755511022044,0.606860780384298,0.004361664505481551
2004,TEXAS,VAL VERDE,4757,70,6968,11795,0.4033064857990674,0.5907587961000423,0.005934718100890208
2004,TEXAS,VAN ZANDT,4822,58,14976,19856,0.24284850926672039,0.7542304593070105,0.0029210314262691378
2004,TEXAS,VICTORIA,8553,174,20875,29602,0.28893318019052766,0.705188838591987,0.005877981217485305
2004,TEXAS,WALKER,5977,135,11710,17822,0.33537201211985185,0.6570530804623499,0.007574907417798227
2004,TEXAS,WALLER,6145,57,7679,13881,0.44269144874288596,0.5532022188603126,0.004106332396801383
2004,TEXAS,WARD,901,11,2856,3768,0.23911889596602973,0.7579617834394905,0.00291932059447983
2004,TEXAS,WASHINGTON,3389,77,9597,13063,0.2594350455484957,0.7346704432366226,0.005894511214881727
2004,TEXAS,WEBB,23654,149,17753,41556,0.5692078159591876,0.42720666089132736,0.003585523149485032
2004,TEXAS,WHARTON,4702,49,9288,14039,0.334924139896004,0.6615855830187335,0.0034902770852624832
2004,TEXAS,WHEELER,420,14,1960,2394,0.17543859649122806,0.8187134502923976,0.005847953216374269
2004,TEXAS,WICHITA,12819,254,32472,45545,0.28145789878142496,0.7129651992534856,0.005576901965089472
2004,TEXAS,WILBARGER,1284,21,3685,4990,0.25731462925851706,0.7384769539078156,0.004208416833667334
2004,TEXAS,WILLACY,2734,19,2209,4962,0.550987505038291,0.44518339379282545,0.0038291011688835145
2004,TEXAS,WILLIAMSON,43117,1797,83284,128198,0.3363313000202811,0.6496513206134261,0.014017379366292765
2004,TEXAS,WILSON,4409,76,10400,14885,0.2962042324487739,0.6986899563318777,0.005105811219348337
2004,TEXAS,WINKLER,391,7,1604,2002,0.1953046953046953,0.8011988011988012,0.0034965034965034965
2004,TEXAS,WISE,4783,71,15177,20031,0.23877989116868853,0.7576756028156357,0.0035445060156757027
2004,TEXAS,WOOD,4034,64,12831,16929,0.23828932600862426,0.7579301789828106,0.003780495008565184
2004,TEXAS,YOAKUM,376,9,2228,2613,0.14389590508993494,0.8526597780329124,0.003444316877152698
2004,TEXAS,YOUNG,1511,24,5874,7409,0.20394115265217977,0.7928195437980834,0.0032393035497368067
2004,TEXAS,ZAPATA,1662,8,1228,2898,0.5734989648033126,0.42374051069703245,0.0027605244996549345
2004,TEXAS,ZAVALA,2332,9,777,3118,0.7479153303399615,0.24919820397690828,0.0028864656831302116
2004,UTAH,BEAVER,493,28,2023,2544,0.19378930817610063,0.7952044025157232,0.0110062893081761
2004,UTAH,BOX ELDER,2244,373,15751,18368,0.12216898954703832,0.8575239547038328,0.02030705574912892
2004,UTAH,CACHE,6375,870,32486,39731,0.16045405350985376,0.8176486874229192,0.0218972590672271
2004,UTAH,CARBON,3415,143,4950,8508,0.40138692994828395,0.581805359661495,0.01680771039022097
2004,UTAH,DAGGETT,108,11,380,499,0.21643286573146292,0.7615230460921844,0.022044088176352707
2004,UTAH,DAVIS,20893,2188,86187,109268,0.19120877109492257,0.7887670681260753,0.020024160779002088
2004,UTAH,DUCHESNE,738,76,4742,5556,0.132829373650108,0.853491720662347,0.013678905687544997
2004,UTAH,EMERY,831,66,3781,4678,0.17764001710132535,0.8082513894826849,0.01410859341598974
2004,UTAH,GARFIELD,264,50,1848,2162,0.12210915818686402,0.8547641073080481,0.02312673450508788
2004,UTAH,GRAND,1858,177,2130,4165,0.4460984393757503,0.5114045618247299,0.042496998799519806
2004,UTAH,IRON,2267,364,12815,15446,0.14676939013336787,0.8296646380940049,0.023565971772627217
2004,UTAH,JUAB,605,131,2681,3417,0.17705589698565993,0.784606379865379,0.03833772314896108
2004,UTAH,KANE,576,61,2414,3051,0.1887905604719764,0.7912159947558177,0.019993444772205833
2004,UTAH,MILLARD,626,167,4084,4877,0.12835759688332993,0.8374000410088169,0.03424236210785319
2004,UTAH,MORGAN,472,68,3301,3841,0.12288466545170529,0.8594116115594898,0.017703722988804998
2004,UTAH,PIUTE,123,4,646,773,0.1591203104786546,0.8357050452781372,0.00517464424320828
2004,UTAH,RICH,109,6,922,1037,0.1051108968177435,0.8891031822565092,0.0057859209257473485
2004,UTAH,SALT LAKE,135949,10461,215728,362138,0.3754066129486549,0.5957066090827253,0.028886777968619697
2004,UTAH,SAN JUAN,1906,73,2971,4950,0.38505050505050503,0.6002020202020202,0.014747474747474747
2004,UTAH,SANPETE,1189,314,7004,8507,0.13976725049958857,0.8233219701422358,0.03691077935817562
2004,UTAH,SEVIER,920,124,6597,7641,0.12040308860096846,0.8633686690223793,0.016228242376652272
2004,UTAH,SUMMIT,6977,399,7936,15312,0.4556556948798328,0.5182863113897597,0.026057993730407524
2004,UTAH,TOOELE,4130,353,12181,16664,0.24783965434469515,0.7309769563130101,0.021183389342294766
2004,UTAH,UINTAH,1266,173,8518,9957,0.12714673094305515,0.8554785577985337,0.01737471125841117
2004,UTAH,UTAH,17357,3547,128269,149173,0.11635483633097142,0.8598674022778922,0.023777761391136465
2004,UTAH,WASATCH,1854,155,5503,7512,0.24680511182108625,0.7325612353567625,0.020633652822151224
2004,UTAH,WASHINGTON,7513,872,35633,44018,0.1706801762915171,0.8095097460129946,0.01981007769548821
2004,UTAH,WAYNE,279,19,1062,1360,0.2051470588235294,0.7808823529411765,0.013970588235294118
2004,UTAH,WEBER,19862,1630,51199,72691,0.2732387778404479,0.7043375383472507,0.022423683812301386
2004,VERMONT,ADDISON,11147,355,7077,18579,0.5999784703159481,0.3809139350880026,0.019107594596049302
2004,VERMONT,BENNINGTON,11069,380,7616,19065,0.580592709152898,0.399475478625754,0.01993181222134802
2004,VERMONT,CALEDONIA,7106,340,6765,14211,0.5000351840123848,0.47603968756597004,0.023925128421645205
2004,VERMONT,CHITTENDEN,49369,1905,26422,77696,0.6354123764415156,0.34006898682042835,0.024518636738056012
2004,VERMONT,ESSEX,1276,70,1591,2937,0.4344569288389513,0.5417092271024855,0.02383384405856316
2004,VERMONT,FRANKLIN,10598,386,8936,19920,0.5320281124497992,0.44859437751004017,0.019377510040160643
2004,VERMONT,GRAND ISLE,2246,77,1754,4077,0.5508952661270542,0.43021829776796666,0.01888643610497915
2004,VERMONT,LAMOILLE,7636,285,4260,12181,0.6268779246367293,0.34972498152861015,0.023397093834660536
2004,VERMONT,ORANGE,8159,315,6421,14895,0.5477677072843236,0.43108425646189996,0.021148036253776436
2004,VERMONT,ORLEANS,6330,246,5666,12242,0.5170723737951315,0.4628328704460056,0.02009475575886293
2004,VERMONT,RUTLAND,15904,631,14440,30975,0.5134463276836159,0.466182405165456,0.020371267150928168
2004,VERMONT,WASHINGTON,19177,810,11461,31448,0.6098003052658356,0.36444288984991097,0.02575680488425337
2004,VERMONT,WINDHAM,15489,547,7280,23316,0.6643077714873906,0.3122319437296277,0.023460284782981643
2004,VERMONT,WINDSOR,18561,715,11491,30767,0.6032762375272207,0.3734845776318783,0.023239184840900966
2004,VIRGINIA,ACCOMACK,5518,112,7726,13356,0.4131476489967056,0.5784666067684936,0.008385744234800839
2004,VIRGINIA,ALBEMARLE,22088,449,21189,43726,0.5051456799158396,0.4845858299409962,0.01026849014316425
2004,VIRGINIA,ALEXANDRIA,41116,555,19844,61515,0.6683898236202552,0.3225879866699179,0.00902218970982687
2004,VIRGINIA,ALLEGHANY,3203,30,3962,7195,0.44517025712300207,0.5506601806810285,0.004169562195969423
2004,VIRGINIA,AMELIA,1862,36,3499,5397,0.3450064850843061,0.6483231424865666,0.006670372429127293
2004,VIRGINIA,AMHERST,4866,71,7758,12695,0.3833005120126034,0.6111067349350138,0.005592753052382828
2004,VIRGINIA,APPOMATTOX,2191,98,4366,6655,0.32922614575507136,0.6560480841472577,0.014725770097670924
2004,VIRGINIA,ARLINGTON,63987,1028,29635,94650,0.6760380348652932,0.3131008980454305,0.010861067089276281
2004,VIRGINIA,AUGUSTA,7019,585,22100,29704,0.2362981416644223,0.7440075410719095,0.019694317263668194
2004,VIRGINIA,BATH,828,22,1432,2282,0.3628396143733567,0.6275197195442594,0.009640666082383873
2004,VIRGINIA,BEDFORD,10144,405,23397,33946,0.29882754963765984,0.6892417368762151,0.011930713486125023
2004,VIRGINIA,BLAND,846,57,1962,2865,0.29528795811518327,0.6848167539267016,0.019895287958115182
2004,VIRGINIA,BOTETOURT,4801,131,10865,15797,0.30391846553143004,0.6877888206621511,0.00829271380641894
2004,VIRGINIA,BRISTOL,2400,49,4275,6724,0.35693039857227843,0.6357822724568709,0.007287328970850684
2004,VIRGINIA,BRUNSWICK,4062,12,2852,6926,0.5864857060352295,0.41178169217441524,0.0017326017903551833
2004,VIRGINIA,BUCHANAN,5275,47,4507,9829,0.5366771797741378,0.4585410519890121,0.004781768236850137
2004,VIRGINIA,BUCKINGHAM,2789,53,3185,6027,0.46275095404015265,0.5284552845528455,0.008793761407001825
2004,VIRGINIA,BUENA VISTA,936,36,1417,2389,0.39179573043114274,0.5931352030138133,0.01506906655504395
2004,VIRGINIA,CAMPBELL,6862,244,15891,22997,0.298386746097317,0.6910031743270861,0.010610079575596816
2004,VIRGINIA,CAROLINE,4878,77,4999,9954,0.49005424954792043,0.5022101667671288,0.007735583684950774
2004,VIRGINIA,CARROLL,3888,67,8173,12128,0.32058047493403696,0.6738951187335093,0.005524406332453826
2004,VIRGINIA,CHARLES CITY,2155,30,1254,3439,0.6266356498982262,0.36464088397790057,0.008723466123873218
2004,VIRGINIA,CHARLOTTE,2223,49,3166,5438,0.4087899963221773,0.5821993379919088,0.00901066568591394
2004,VIRGINIA,CHARLOTTESVILLE,11088,190,4172,15450,0.7176699029126213,0.2700323624595469,0.012297734627831715
2004,VIRGINIA,CHESAPEAKE,38744,514,52283,91541,0.42324204454834446,0.5711429851104969,0.005614970341158607
2004,VIRGINIA,CHESTERFIELD,49346,723,83745,133814,0.3687656000119569,0.6258313778827328,0.005403022105310356
2004,VIRGINIA,CLARKE,2699,65,3741,6505,0.4149116064565719,0.5750960799385089,0.009992313604919293
2004,VIRGINIA,COLONIAL HEIGHTS,2061,41,6129,8231,0.25039484874255863,0.7446239825051634,0.004981168752277974
2004,VIRGINIA,COVINGTON,1179,18,1104,2301,0.5123859191655802,0.47979139504563234,0.007822685788787484
2004,VIRGINIA,CRAIG,901,14,1706,2621,0.3437619229301793,0.6508966043494849,0.00534147272033575
2004,VIRGINIA,CULPEPER,5476,103,10026,15605,0.3509131688561358,0.6424863825696892,0.006600448574174944
2004,VIRGINIA,CUMBERLAND,1721,28,2377,4126,0.4171110033931168,0.5761027629665536,0.0067862336403296175
2004,VIRGINIA,DANVILLE,9436,277,9399,19112,0.49372122226873166,0.4917852658015906,0.01449351192967769
2004,VIRGINIA,DICKENSON,3761,54,3591,7406,0.5078314879827167,0.4848771266540643,0.007291385363219011
2004,VIRGINIA,DINWIDDIE,4569,77,6193,10839,0.42153335178522006,0.5713626718331949,0.007103976381585017
2004,VIRGINIA,EMPORIA,1247,4,970,2221,0.5614588023412878,0.43674020711391265,0.0018009905447996398
2004,VIRGINIA,ESSEX,2007,33,2304,4344,0.4620165745856354,0.5303867403314917,0.007596685082872928
2004,VIRGINIA,FAIRFAX,251066,3834,217025,471925,0.5320040260634634,0.4598718016633999,0.008124172273136622
2004,VIRGINIA,FALLS CHURCH,3944,80,2074,6098,0.6467694326008527,0.3401115119711381,0.013119055428009183
2004,VIRGINIA,FAUQUIER,10712,192,19011,29915,0.3580812301520976,0.6355005849908073,0.006418184857095103
2004,VIRGINIA,FLOYD,2488,84,4162,6734,0.3694683694683695,0.618057618057618,0.012474012474012475
2004,VIRGINIA,FLUVANNA,4415,84,6458,10957,0.40293876060965594,0.5893949073651547,0.007666332025189376
2004,VIRGINIA,FRANKLIN,9912,186,15661,25759,0.3847975464886059,0.60798167630731,0.0072207772040840095
2004,VIRGINIA,FREDERICK,8853,301,19386,28540,0.3101962158374212,0.6792571829011913,0.010546601261387527
2004,VIRGINIA,FREDERICKSBURG,4085,67,3390,7542,0.541633518960488,0.4494828957836118,0.008883585255900292
2004,VIRGINIA,GALAX,987,12,1336,2335,0.4226980728051392,0.5721627408993576,0.005139186295503212
2004,VIRGINIA,GILES,3047,131,4320,7498,0.4063750333422246,0.5761536409709256,0.017471325686849826
2004,VIRGINIA,GLOUCESTER,5105,144,11084,16333,0.3125573991305945,0.67862609441009,0.008816506459315497
2004,VIRGINIA,GOOCHLAND,3583,87,6668,10338,0.3465854130392726,0.644999032694912,0.008415554265815438
2004,VIRGINIA,GRAYSON,2430,52,4655,7137,0.34047919293820933,0.6522348325627014,0.007285974499089253
2004,VIRGINIA,GREENE,2240,129,4570,6939,0.32281308545899984,0.6585963395301917,0.018590575010808474
2004,VIRGINIA,GREENSVILLE,2514,12,1732,4258,0.5904180366369187,0.40676373884452793,0.0028182245185533112
2004,VIRGINIA,HALIFAX,6220,73,8363,14656,0.4243995633187773,0.5706195414847162,0.0049808951965065506
2004,VIRGINIA,HAMPTON,32016,326,23399,55741,0.5743707504350478,0.4197807717837857,0.005848477781166466
2004,VIRGINIA,HANOVER,13941,266,35404,49611,0.2810062284573986,0.7136320574066235,0.005361714135977908
2004,VIRGINIA,HARRISONBURG,4726,139,6165,11030,0.42846781504986403,0.5589301903898459,0.012601994560290118
2004,VIRGINIA,HENRICO,60864,745,71809,133418,0.4561903191473414,0.5382257266635686,0.005583954189089928
2004,VIRGINIA,HENRY,9851,249,13358,23458,0.41994202404297043,0.5694432602949953,0.010614715662034275
2004,VIRGINIA,HIGHLAND,522,16,982,1520,0.34342105263157896,0.6460526315789473,0.010526315789473684
2004,VIRGINIA,HOPEWELL,3573,112,4251,7936,0.45022681451612906,0.5356602822580645,0.014112903225806451
2004,VIRGINIA,ISLE OF WIGHT,5871,71,9929,15871,0.36991997983743935,0.6256064520194065,0.00447356814315418
2004,VIRGINIA,JAMES CITY,11934,207,18949,31090,0.3838533290447089,0.6094885815374719,0.006658089417819235
2004,VIRGINIA,KING AND QUEEN,1506,43,1737,3286,0.45830797321972,0.5286062081558125,0.013085818624467437
2004,VIRGINIA,KING GEORGE,2739,58,5124,7921,0.3457896730210832,0.6468880191894962,0.007322307789420527
2004,VIRGINIA,KING WILLIAM,2436,39,4397,6872,0.35448195576251457,0.6398428405122235,0.005675203725261932
2004,VIRGINIA,LANCASTER,2477,29,3724,6230,0.3975922953451043,0.597752808988764,0.004654895666131621
2004,VIRGINIA,LEE,4005,101,5664,9770,0.40992835209826,0.5797338792221085,0.010337768679631525
2004,VIRGINIA,LEXINGTON,1340,27,982,2349,0.5704555129842486,0.41805023414218817,0.011494252873563218
2004,VIRGINIA,LOUDOUN,47271,777,60382,108430,0.4359586830213041,0.5568754034861201,0.007165913492575855
2004,VIRGINIA,LOUISA,4844,108,7083,12035,0.402492729538845,0.5885334441213128,0.008973826339842127
2004,VIRGINIA,LUNENBURG,2362,25,2858,5245,0.45033365109628215,0.5448999046711154,0.004766444232602479
2004,VIRGINIA,LYNCHBURG,11727,213,14400,26340,0.4452164009111617,0.5466970387243736,0.008086560364464692
2004,VIRGINIA,MADISON,2176,40,3556,5772,0.376992376992377,0.6160776160776161,0.00693000693000693
2004,VIRGINIA,MANASSAS,5562,84,7257,12903,0.4310625435945129,0.5624273424784934,0.006510113926993723
2004,VIRGINIA,MANASSAS PARK,1498,27,1807,3332,0.4495798319327731,0.5423169267707083,0.008103241296518607
2004,VIRGINIA,MARTINSVILLE,3036,29,2538,5603,0.5418525789755488,0.45297162234517224,0.005175798679278957
2004,VIRGINIA,MATHEWS,1589,43,3497,5129,0.3098069799181127,0.6818093195554689,0.008383700526418405
2004,VIRGINIA,MECKLENBURG,5293,168,7319,12780,0.4141627543035994,0.5726917057902974,0.013145539906103286
2004,VIRGINIA,MIDDLESEX,1914,127,3336,5377,0.35596057281011717,0.6204203087223359,0.02361911846754696
2004,VIRGINIA,MONTGOMERY,14128,317,17070,31515,0.4482944629541488,0.5416468348405521,0.010058702205299063
2004,VIRGINIA,NELSON,3543,57,3539,7139,0.4962879955175795,0.4957276929541953,0.007984311528225242
2004,VIRGINIA,NEW KENT,2443,89,5414,7946,0.30745028945381325,0.6813491064686634,0.011200604077523282
2004,VIRGINIA,NEWPORT NEWS,35319,425,32208,67952,0.5197639510242524,0.47398163409465505,0.0062544148810925355
2004,VIRGINIA,NORFOLK,43518,651,26401,70570,0.6166643049454442,0.37411081195975626,0.00922488309479949
2004,VIRGINIA,NORTHAMPTON,2775,55,2669,5499,0.5046372067648663,0.48536097472267686,0.01000181851245681
2004,VIRGINIA,NORTHUMBERLAND,2548,29,3832,6409,0.3975659229208925,0.5979091902012794,0.004524886877828055
2004,VIRGINIA,NORTON,725,11,768,1504,0.4820478723404255,0.5106382978723404,0.007313829787234043
2004,VIRGINIA,NOTTOWAY,2635,92,3303,6030,0.4369817578772803,0.5477611940298508,0.015257048092868989
2004,VIRGINIA,ORANGE,5015,164,7749,12928,0.38791769801980197,0.5993966584158416,0.012685643564356437
2004,VIRGINIA,PAGE,3324,58,6221,9603,0.34614183067791315,0.6478183900864313,0.006039779235655524
2004,VIRGINIA,PATRICK,2572,136,5507,8215,0.31308581862446744,0.6703590992087645,0.01655508216676811
2004,VIRGINIA,PETERSBURG,9682,29,2238,11949,0.8102770106285044,0.18729600803414512,0.002426981337350406
2004,VIRGINIA,PITTSYLVANIA,9274,470,17673,27417,0.33825728562570667,0.6446000656526972,0.01714264872159609
2004,VIRGINIA,POQUOSON,1424,52,5004,6480,0.21975308641975308,0.7722222222222223,0.008024691358024692
2004,VIRGINIA,PORTSMOUTH,24112,210,15212,39534,0.6099053978853645,0.38478271867253505,0.005311883442100471
2004,VIRGINIA,POWHATAN,3112,96,8955,12163,0.2558579297870591,0.7362492806051139,0.007892789607827017
2004,VIRGINIA,PRINCE EDWARD,3632,113,3571,7316,0.49644614543466375,0.4881082558775287,0.015445598687807545
2004,VIRGINIA,PRINCE GEORGE,5066,57,8131,13254,0.38222423419345103,0.6134751773049646,0.004300588501584427
2004,VIRGINIA,PRINCE WILLIAM,61271,1016,69776,132063,0.4639528104010964,0.5283538917032022,0.007693297895701294
2004,VIRGINIA,PULASKI,5310,172,8769,14251,0.3726054311978107,0.6153252403340117,0.012069328468177671
2004,VIRGINIA,RADFORD,2244,37,2564,4845,0.4631578947368421,0.5292053663570692,0.0076367389060887515
2004,VIRGINIA,RAPPAHANNOCK,1837,41,2172,4050,0.45358024691358023,0.5362962962962963,0.010123456790123457
2004,VIRGINIA,RICHMOND,53410,557,23719,77686,0.687511263290683,0.3053188476688206,0.007169889040496357
2004,VIRGINIA,ROANOKE,34944,772,47257,82973,0.42114904848565193,0.5695467200173551,0.009304231496992998
2004,VIRGINIA,ROCKBRIDGE,3627,142,5412,9181,0.39505500490142686,0.5894782703409215,0.015466724757651672
2004,VIRGINIA,ROCKINGHAM,7273,206,21737,29216,0.24893893756845564,0.7440101314348302,0.007050930996714129
2004,VIRGINIA,RUSSELL,5167,179,6077,11423,0.45233301234351747,0.531996848463626,0.01567013919285652
2004,VIRGINIA,SALEM,4254,115,7115,11484,0.3704284221525601,0.6195576454197144,0.010013932427725532
2004,VIRGINIA,SCOTT,3324,164,6479,9967,0.33350055182100935,0.6500451489916725,0.01645429918731815
2004,VIRGINIA,SHENANDOAH,5186,140,11820,17146,0.3024612154438353,0.6893736148372799,0.008165169718884872
2004,VIRGINIA,SMYTH,4143,270,7906,12319,0.336309765403036,0.6417728711746084,0.02191736342235571
2004,VIRGINIA,SOUTHAMPTON,3431,43,4018,7492,0.4579551521623065,0.5363053924185798,0.005739455419113721
2004,VIRGINIA,SPOTSYLVANIA,16623,295,28527,45445,0.3657828143910221,0.6277258224227088,0.0064913631862691164
2004,VIRGINIA,STAFFORD,17208,278,28500,45986,0.3742008437350498,0.6197538381246467,0.006045318140303571
2004,VIRGINIA,STAUNTON,3756,68,5805,9629,0.39007165853151937,0.6028663412607748,0.007062000207705889
2004,VIRGINIA,SUFFOLK,15233,193,16763,32189,0.47323619870141975,0.5207679642113766,0.005995837087203703
2004,VIRGINIA,SURRY,1954,25,1543,3522,0.5547984099943214,0.43810335036910847,0.007098239636570131
2004,VIRGINIA,SUSSEX,2420,35,1890,4345,0.5569620253164557,0.43498273878020716,0.00805523590333717
2004,VIRGINIA,TAZEWELL,7184,257,10039,17480,0.41098398169336386,0.5743135011441648,0.014702517162471396
2004,VIRGINIA,VIRGINIA BEACH,70666,1269,103752,175687,0.40222668723354604,0.590550239915304,0.007223072851150056
2004,VIRGINIA,WARREN,5241,227,8600,14068,0.37254762581745804,0.6113164628945124,0.01613591128802957
2004,VIRGINIA,WASHINGTON,7339,426,14749,22514,0.3259749489206716,0.6551034911610554,0.018921559918273073
2004,VIRGINIA,WAYNESBORO,2792,79,5092,7963,0.3506216250156976,0.6394574908953912,0.009920884088911215
2004,VIRGINIA,WESTMORELAND,3370,45,3433,6848,0.4921144859813084,0.5013142523364486,0.0065712616822429905
2004,VIRGINIA,WILLIAMSBURG,2216,40,2064,4320,0.512962962962963,0.4777777777777778,0.009259259259259259
2004,VIRGINIA,WINCHESTER,3967,93,5283,9343,0.4245959541903029,0.5654500695708017,0.00995397623889543
2004,VIRGINIA,WISE,5802,180,8330,14312,0.40539407490218,0.5820290665176076,0.01257685858021241
2004,VIRGINIA,WYTHE,3581,62,7911,11554,0.3099359529167388,0.6846979401073221,0.005366106975939069
2004,VIRGINIA,YORK,10276,208,19396,29880,0.34390896921017405,0.6491298527443106,0.0069611780455153946
2004,WASHINGTON,ADAMS,1315,61,3751,5127,0.25648527403939925,0.731616929978545,0.011897795982055783
2004,WASHINGTON,ASOTIN,3319,147,5320,8786,0.37776007284315954,0.605508763942636,0.016731163214204415
2004,WASHINGTON,BENTON,21549,987,44350,66886,0.3221750441048949,0.6630685046198008,0.014756451275304248
2004,WASHINGTON,CHELAN,10471,443,18482,29396,0.3562049258402504,0.6287249965981766,0.015070077561573003
2004,WASHINGTON,CLALLAM,17049,846,18871,36766,0.46371647718000325,0.513273132785726,0.023010390034270793
2004,WASHINGTON,CLARK,79538,2255,88646,170439,0.46666549322631556,0.5201039668151068,0.013230539958577555
2004,WASHINGTON,COLUMBIA,605,32,1470,2107,0.28713811105837683,0.6976744186046512,0.015187470336971999
2004,WASHINGTON,COWLITZ,21589,667,20217,42473,0.5082993902008335,0.4759965154333341,0.01570409436583241
2004,WASHINGTON,DOUGLAS,4306,166,8900,13372,0.32201615315584803,0.665569847442417,0.012413999401734968
2004,WASHINGTON,FERRY,1201,121,2019,3341,0.35947321161328943,0.6043100868003591,0.036216701586351395
2004,WASHINGTON,FRANKLIN,5188,214,10757,16159,0.32105947150194936,0.6656971347236834,0.013243393774367226
2004,WASHINGTON,GARFIELD,365,20,935,1320,0.2765151515151515,0.7083333333333334,0.015151515151515152
2004,WASHINGTON,GRANT,7779,417,17799,25995,0.29924985574148877,0.6847085978072707,0.01604154645124062
2004,WASHINGTON,GRAYS HARBOR,14583,499,12871,27953,0.5216971344757271,0.46045147211390547,0.017851393410367403
2004,WASHINGTON,ISLAND,18216,589,19754,38559,0.47241889053139346,0.512305817059571,0.015275292409035504
2004,WASHINGTON,JEFFERSON,11610,356,6650,18616,0.6236570691877954,0.3572195960464117,0.019123334765792865
2004,WASHINGTON,KING,580378,12113,301043,893534,0.649530963567139,0.33691275318006925,0.013556283252791724
2004,WASHINGTON,KITSAP,60796,2049,55608,118453,0.5132499810051244,0.4694520189442226,0.017298000050653
2004,WASHINGTON,KITTITAS,6731,301,9052,16084,0.4184904252673464,0.5627953245461328,0.018714250186520766
2004,WASHINGTON,KLICKITAT,4036,185,5016,9237,0.4369383999133918,0.5430334524196168,0.020028147666991448
2004,WASHINGTON,LEWIS,10726,660,21042,32428,0.33076353768348343,0.6488836807697052,0.0203527815468114
2004,WASHINGTON,LINCOLN,1706,90,4015,5811,0.2935811392187231,0.6909309929444157,0.015487867836861126
2004,WASHINGTON,MASON,12894,513,11987,25394,0.5077577380483579,0.4720406395211467,0.020201622430495392
2004,WASHINGTON,OKANOGAN,6309,397,9636,16342,0.3860604577163138,0.5896463101211602,0.024293232162526008
2004,WASHINGTON,PACIFIC,5570,227,4634,10431,0.5339852363148307,0.4442527082734158,0.02176205541175343
2004,WASHINGTON,PEND OREILLE,2310,195,3693,6198,0.3727008712487899,0.595837366892546,0.03146176185866408
2004,WASHINGTON,PIERCE,158231,4317,150783,313331,0.5049963138023368,0.4812259240228385,0.013777762174824706
2004,WASHINGTON,SAN JUAN,6589,209,3290,10088,0.653152260111023,0.3261300555114988,0.02071768437747819
2004,WASHINGTON,SKAGIT,25131,960,26139,52230,0.4811602527283171,0.5004595060310166,0.018380241240666284
2004,WASHINGTON,SKAMANIA,2374,90,2695,5159,0.4601666989726691,0.5223880597014925,0.01744524132583834
2004,WASHINGTON,SNOHOMISH,156468,4212,134317,294997,0.5304053939531589,0.45531649474401437,0.014278111302826808
2004,WASHINGTON,SPOKANE,87490,3491,111606,202587,0.4318638412138982,0.5509040560351849,0.01723210275091689
2004,WASHINGTON,STEVENS,6822,503,13015,20340,0.33539823008849556,0.6398721730580138,0.02472959685349066
2004,WASHINGTON,THURSTON,62650,2147,47992,112789,0.5554619688090151,0.42550248694464887,0.019035544246336078
2004,WASHINGTON,WAHKIAKUM,1021,43,1171,2235,0.45682326621923935,0.523937360178971,0.01923937360178971
2004,WASHINGTON,WALLA WALLA,8257,345,14323,22925,0.36017448200654306,0.6247764449291167,0.01504907306434024
2004,WASHINGTON,WHATCOM,48268,1830,40296,90394,0.5339734938159613,0.44578179967696974,0.020244706507069055
2004,WASHINGTON,WHITMAN,8287,328,9397,18012,0.46008216744392627,0.5217077503886298,0.018210082167443926
2004,WASHINGTON,YAKIMA,28474,964,43352,72790,0.3911801071575766,0.5955763154279434,0.01324357741448001
2004,WEST VIRGINIA,BARBOUR,2610,41,4004,6655,0.3921863260706236,0.6016528925619835,0.006160781367392938
2004,WEST VIRGINIA,BERKELEY,12244,248,21293,33785,0.3624093532632825,0.6302501109960041,0.007340535740713334
2004,WEST VIRGINIA,BOONE,5933,58,4207,10198,0.5817807413218278,0.41253186899392036,0.005687389684251814
2004,WEST VIRGINIA,BRAXTON,3035,30,2986,6051,0.5015699884316642,0.4934721533630805,0.00495785820525533
2004,WEST VIRGINIA,BROOKE,5493,91,5189,10773,0.5098858256752994,0.4816671307899378,0.008447043534762833
2004,WEST VIRGINIA,CABELL,16583,332,21035,37950,0.43696969696969695,0.5542819499341238,0.008748353096179183
2004,WEST VIRGINIA,CALHOUN,1266,35,1360,2661,0.47576099210823,0.5110860578729801,0.013152950018789928
2004,WEST VIRGINIA,CLAY,1835,39,2198,4072,0.4506385068762279,0.5397838899803536,0.009577603143418467
2004,WEST VIRGINIA,DODDRIDGE,800,17,2362,3179,0.2516514627241271,0.7430009436929852,0.0053475935828877
2004,WEST VIRGINIA,FAYETTE,8971,115,7881,16967,0.5287322449460717,0.46448989214357284,0.006777862910355396
2004,WEST VIRGINIA,GILMER,1159,28,1665,2852,0.4063814866760168,0.5838008415147266,0.009817671809256662
2004,WEST VIRGINIA,GRANT,963,21,4063,5047,0.19080641965524073,0.805032692688726,0.004160887656033287
2004,WEST VIRGINIA,GREENBRIER,6084,111,8358,14553,0.41805813234384664,0.5743145743145743,0.007627293341579056
2004,WEST VIRGINIA,HAMPSHIRE,2455,52,5489,7996,0.30702851425712857,0.6864682341170585,0.0065032516258129065
2004,WEST VIRGINIA,HANCOCK,6906,117,7298,14321,0.48222889463026325,0.5096012848264786,0.008169820543258152
2004,WEST VIRGINIA,HARDY,1617,24,3635,5276,0.30648218347232753,0.6889689158453374,0.004548900682335102
2004,WEST VIRGINIA,HARRISON,13238,239,17111,30588,0.432784098339218,0.5594023800183079,0.007813521642474173
2004,WEST VIRGINIA,JACKSON,5384,88,7686,13158,0.4091807265541876,0.5841313269493844,0.006687946496428028
2004,WEST VIRGINIA,JEFFERSON,9301,153,10539,19993,0.465212824488571,0.5271344970739759,0.007652678437453109
2004,WEST VIRGINIA,KANAWHA,43010,488,44430,87928,0.48915021381130014,0.5052997907378765,0.005549995450823401
2004,WEST VIRGINIA,LEWIS,2475,79,4445,6999,0.35362194599228464,0.6350907272467495,0.011287326760965851
2004,WEST VIRGINIA,LINCOLN,4048,162,4102,8312,0.4870067372473532,0.4935033686236766,0.019489894128970165
2004,WEST VIRGINIA,LOGAN,7877,63,7047,14987,0.5255888436645092,0.4702075131780877,0.004203643157403083
2004,WEST VIRGINIA,MARION,12771,273,12150,25194,0.5069064062872113,0.48225768040009526,0.010835913312693499
2004,WEST VIRGINIA,MARSHALL,6435,121,8516,15072,0.42695063694267515,0.5650212314225053,0.008028131634819533
2004,WEST VIRGINIA,MASON,5408,95,6487,11990,0.45104253544620515,0.5410341951626355,0.0079232693911593
2004,WEST VIRGINIA,MCDOWELL,4501,36,2762,7299,0.6166598164132073,0.37840800109604056,0.004932182490752158
2004,WEST VIRGINIA,MERCER,9178,144,13057,22379,0.4101166271951383,0.5834487689351624,0.0064346038696992715
2004,WEST VIRGINIA,MINERAL,3518,89,7854,11461,0.3069540179739988,0.6852805165343339,0.0077654654916673935
2004,WEST VIRGINIA,MINGO,5983,60,4612,10655,0.5615204129516659,0.4328484279680901,0.005631159080244017
2004,WEST VIRGINIA,MONONGALIA,16313,323,17670,34306,0.4755144872617035,0.515070250102023,0.009415262636273538
2004,WEST VIRGINIA,MONROE,2311,50,3590,5951,0.3883380944379096,0.6032599563098638,0.008401949252226516
2004,WEST VIRGINIA,MORGAN,2272,64,4511,6847,0.3318241565649189,0.6588286840952242,0.00934715933985687
2004,WEST VIRGINIA,NICHOLAS,4788,78,5485,10351,0.4625640034779248,0.5299004927060187,0.007535503816056419
2004,WEST VIRGINIA,OHIO,8543,155,11694,20392,0.41893879952922713,0.5734601804629267,0.007601020007846214
2004,WEST VIRGINIA,PENDLETON,1381,17,2146,3544,0.3896726862302483,0.6055304740406321,0.004796839729119639
2004,WEST VIRGINIA,PLEASANTS,1349,25,2061,3435,0.3927219796215429,0.6,0.00727802037845706
2004,WEST VIRGINIA,POCAHONTAS,1573,50,2295,3918,0.40148034711587544,0.5857580398162328,0.012761613067891782
2004,WEST VIRGINIA,PRESTON,3963,111,7855,11929,0.3322156090200352,0.6584793360717579,0.00930505490820689
2004,WEST VIRGINIA,PUTNAM,9301,134,15716,25151,0.36980636952805057,0.6248658105045525,0.005327819967396922
2004,WEST VIRGINIA,RALEIGH,11815,191,18519,30525,0.38705978705978705,0.6066830466830467,0.006257166257166257
2004,WEST VIRGINIA,RANDOLPH,4892,86,6512,11490,0.4257615317667537,0.5667536988685814,0.007484769364664926
2004,WEST VIRGINIA,RITCHIE,1070,40,3086,4196,0.2550047664442326,0.7354623450905624,0.009532888465204958
2004,WEST VIRGINIA,ROANE,2612,48,3440,6100,0.4281967213114754,0.5639344262295082,0.007868852459016393
2004,WEST VIRGINIA,SUMMERS,2504,42,2978,5524,0.4532947139753802,0.5391020999275887,0.007603186097031137
2004,WEST VIRGINIA,TAYLOR,2617,41,3893,6551,0.39948099526789804,0.5942604182567547,0.0062585864753472754
2004,WEST VIRGINIA,TUCKER,1400,21,2179,3600,0.3888888888888889,0.6052777777777778,0.005833333333333334
2004,WEST VIRGINIA,TYLER,1401,46,2798,4245,0.3300353356890459,0.6591283863368669,0.010836277974087162
2004,WEST VIRGINIA,UPSHUR,3034,68,6191,9293,0.32648229850425053,0.6662003658667814,0.00731733562896804
2004,WEST VIRGINIA,WAYNE,8411,128,10070,18609,0.45198559836638186,0.5411360094577893,0.0068783921758289
2004,WEST VIRGINIA,WEBSTER,1965,25,1724,3714,0.5290791599353797,0.4641895530425417,0.006731287022078622
2004,WEST VIRGINIA,WETZEL,3330,52,3656,7038,0.4731457800511509,0.5194657573174197,0.007388462631429384
2004,WEST VIRGINIA,WIRT,896,31,1727,2654,0.33760361718161264,0.6507159005275056,0.011680482290881688
2004,WEST VIRGINIA,WOOD,14025,254,24948,39227,0.3575343513396385,0.6359905167359217,0.006475131924439799
2004,WEST VIRGINIA,WYOMING,3694,39,4985,8718,0.42372103693507684,0.5718054599678826,0.004473503097040606
2004,WISCONSIN,ADAMS,5447,119,4890,10456,0.5209449120122418,0.4676740627390972,0.011381025248661056
2004,WISCONSIN,ASHLAND,5805,81,3313,9199,0.6310468529187955,0.36014784215675616,0.00880530492444831
2004,WISCONSIN,BARRON,11696,211,12030,23937,0.4886159502026152,0.5025692442661988,0.00881480553118603
2004,WISCONSIN,BAYFIELD,5845,100,3754,9699,0.6026394473657078,0.3870502113619961,0.010310341272296113
2004,WISCONSIN,BROWN,54935,1186,67173,123294,0.4455610167566954,0.5448196992554383,0.0096192839878664
2004,WISCONSIN,BUFFALO,3998,91,3502,7591,0.526676327229614,0.4613357923857199,0.011987880384666052
2004,WISCONSIN,BURNETT,4499,79,4743,9321,0.4826735328827379,0.508850981654329,0.008475485462933162
2004,WISCONSIN,CALUMET,10290,265,14721,25276,0.4071055546763728,0.5824101914859946,0.010484253837632537
2004,WISCONSIN,CHIPPEWA,14751,323,15450,30524,0.48325907482636615,0.5061590879308085,0.010581837242825317
2004,WISCONSIN,CLARK,6966,193,7966,15125,0.46056198347107435,0.5266776859504132,0.012760330578512396
2004,WISCONSIN,COLUMBIA,14300,299,14956,29555,0.48384368127220434,0.5060395872102859,0.010116731517509728
2004,WISCONSIN,CRAWFORD,4656,123,3680,8459,0.5504196713559523,0.43503960278992787,0.014540725854119873
2004,WISCONSIN,DANE,181052,2828,90369,274249,0.6601737836783361,0.3295144193780105,0.010311796943653395
2004,WISCONSIN,DODGE,16690,445,27201,44336,0.3764435221941537,0.613519487549621,0.01003699025622519
2004,WISCONSIN,DOOR,8367,214,8910,17491,0.4783602995826425,0.5094048367731976,0.012234863644159854
2004,WISCONSIN,DOUGLAS,16537,202,8448,25187,0.6565688648906182,0.33541112478659624,0.008020010322785563
2004,WISCONSIN,DUNN,12039,254,10879,23172,0.51954945624029,0.469489038494735,0.01096150526497497
2004,WISCONSIN,EAU CLAIRE,30068,716,24653,55437,0.542381441997222,0.4447029961938777,0.012915561808900192
2004,WISCONSIN,FLORENCE,993,28,1703,2724,0.3645374449339207,0.6251835535976505,0.010279001468428781
2004,WISCONSIN,FOND DU LAC,19216,529,33291,53036,0.36231993362998716,0.6277057093295121,0.009974357040500792
2004,WISCONSIN,FOREST,2509,36,2608,5153,0.48690083446536,0.5061129439161653,0.006986221618474675
2004,WISCONSIN,GRANT,12864,192,12208,25264,0.5091830272324256,0.4832172260924636,0.007599746675110829
2004,WISCONSIN,GREEN,9575,176,8497,18248,0.5247150372643578,0.4656400701446734,0.009644892590968873
2004,WISCONSIN,GREEN LAKE,3605,101,6472,10178,0.35419532324621733,0.6358813126350953,0.009923364118687364
2004,WISCONSIN,IOWA,7122,72,5348,12542,0.5678520172221336,0.4264072715675331,0.00574071121033328
2004,WISCONSIN,IRON,1956,39,1884,3879,0.5042536736272235,0.48569218870843,0.010054137664346482
2004,WISCONSIN,JACKSON,5249,90,4387,9726,0.5396874357392556,0.4510590170676537,0.009253547193090685
2004,WISCONSIN,JEFFERSON,17925,414,23776,42115,0.42562032529977445,0.5645494479401638,0.009830226760061735
2004,WISCONSIN,JUNEAU,5734,172,6473,12379,0.46320381290895873,0.5229016883431618,0.013894498747879474
2004,WISCONSIN,KENOSHA,40107,734,35587,76428,0.5247684094834354,0.4656277803946198,0.009603810121944837
2004,WISCONSIN,KEWAUNEE,5175,128,5970,11273,0.4590614743191697,0.5295839616783465,0.011354564002483811
2004,WISCONSIN,LA CROSSE,33170,677,28289,62136,0.5338290202137247,0.4552755246555942,0.010895455130681086
2004,WISCONSIN,LAFAYETTE,4402,57,3929,8388,0.5247973295183596,0.4684072484501669,0.006795422031473534
2004,WISCONSIN,LANGLADE,4751,88,6235,11074,0.4290229366082716,0.5630305219432906,0.007946541448437781
2004,WISCONSIN,LINCOLN,7484,192,8024,15700,0.476687898089172,0.5110828025477707,0.012229299363057325
2004,WISCONSIN,MANITOWOC,20652,481,23027,44160,0.4676630434782609,0.5214447463768116,0.010892210144927536
2004,WISCONSIN,MARATHON,30899,766,36394,68059,0.4540031443306543,0.5347419151030723,0.01125494056627338
2004,WISCONSIN,MARINETTE,10190,214,11866,22270,0.4575662325999102,0.5328244274809161,0.009609339919173777
2004,WISCONSIN,MARQUETTE,3785,88,4604,8477,0.44650230034210214,0.5431166686327711,0.010381031025126814
2004,WISCONSIN,MENOMINEE,1412,10,288,1710,0.8257309941520468,0.16842105263157894,0.005847953216374269
2004,WISCONSIN,MILWAUKEE,297653,4296,180287,482236,0.6172351296875389,0.3738563690806991,0.008908501231762041
2004,WISCONSIN,MONROE,8973,206,10375,19554,0.4588830929733047,0.5305819781118952,0.01053492891480004
2004,WISCONSIN,OCONTO,8534,217,11043,19794,0.431140749722138,0.5578963322218854,0.010962918055976559
2004,WISCONSIN,ONEIDA,10464,224,11351,22039,0.4747946821543627,0.5150415173102227,0.010163800535414493
2004,WISCONSIN,OUTAGAMIE,40169,978,48903,90050,0.4460744031093837,0.5430649639089394,0.010860632981676846
2004,WISCONSIN,OZAUKEE,17714,414,34904,53032,0.3340247397797556,0.6581686528888219,0.007806607331422537
2004,WISCONSIN,PEPIN,2181,32,1853,4066,0.5363994097393016,0.455730447614363,0.007870142646335464
2004,WISCONSIN,PIERCE,11176,263,10437,21876,0.5108795026513073,0.47709818979703783,0.012022307551654782
2004,WISCONSIN,POLK,11173,235,12095,23503,0.4753861209207335,0.5146151555120623,0.009998723567204187
2004,WISCONSIN,PORTAGE,21861,554,16546,38961,0.561099561099561,0.424681091347758,0.014219347552680886
2004,WISCONSIN,PRICE,4349,102,4312,8763,0.4962912244665069,0.49206892616683784,0.011639849366655255
2004,WISCONSIN,RACINE,48229,884,52456,101569,0.4748397641012514,0.5164567929190993,0.008703442979649303
2004,WISCONSIN,RICHLAND,4501,83,4836,9420,0.4778131634819533,0.513375796178344,0.00881104033970276
2004,WISCONSIN,ROCK,46598,730,33151,80479,0.5790081884715267,0.41192112228034644,0.00907068924812684
2004,WISCONSIN,RUSK,3820,122,3985,7927,0.4818973129809512,0.502712249274631,0.015390437744417812
2004,WISCONSIN,SAUK,15708,294,14415,30417,0.5164217378439688,0.47391261465627776,0.009665647499753427
2004,WISCONSIN,SAWYER,4411,91,4951,9453,0.4666243520575479,0.5237490743679255,0.009626573574526604
2004,WISCONSIN,SHAWANO,8657,192,12150,20999,0.41225772655840753,0.5785989809038525,0.009143292537739892
2004,WISCONSIN,SHEBOYGAN,27608,559,34458,62625,0.44084630738522956,0.5502275449101797,0.008926147704590819
2004,WISCONSIN,ST. CROIX,18784,372,22679,41835,0.44900203179156206,0.5421058921955301,0.008892076012907852
2004,WISCONSIN,TAYLOR,3829,132,5582,9543,0.40123650843550246,0.5849313633029446,0.013832128261552971
2004,WISCONSIN,TREMPEALEAU,8075,109,5878,14062,0.5742426397383018,0.41800597354572605,0.0077513867159721235
2004,WISCONSIN,VERNON,7924,147,6774,14845,0.5337824183226676,0.45631525766251263,0.009902324014819804
2004,WISCONSIN,VILAS,5713,134,8155,14002,0.40801314097986,0.5824167976003428,0.009570061419797172
2004,WISCONSIN,WALWORTH,19177,515,28754,48446,0.3958427940387235,0.5935268133592041,0.01063039260207241
2004,WISCONSIN,WASHBURN,4705,100,4762,9567,0.49179471098567995,0.49775269154384866,0.010452597470471413
2004,WISCONSIN,WASHINGTON,21234,592,50641,72467,0.29301613148053596,0.6988146328673741,0.008169235652089917
2004,WISCONSIN,WAUKESHA,73626,1811,154926,230363,0.3196086177033638,0.6725298767597226,0.00786150553691348
2004,WISCONSIN,WAUPACA,10792,241,15941,26974,0.4000889745681026,0.5909764958849262,0.008934529546971158
2004,WISCONSIN,WAUSHARA,5257,101,6888,12246,0.42928303119385924,0.5624693777560019,0.00824759105013882
2004,WISCONSIN,WINNEBAGO,40943,1111,46542,88596,0.4621314732042079,0.5253284572666937,0.012540069529098379
2004,WISCONSIN,WOOD,18950,529,20592,40071,0.4729105837139078,0.5138878490679045,0.013201567218187717
2004,WYOMING,ALBANY,7117,501,9006,16624,0.4281159769008662,0.5417468719923003,0.030137151106833494
2004,WYOMING,BIG HORN,960,91,4232,5283,0.18171493469619535,0.8010600037857278,0.01722506151807685
2004,WYOMING,CAMPBELL,2464,220,12415,15099,0.16318961520630507,0.8222398834359891,0.014570501357705809
2004,WYOMING,CARBON,2158,161,4758,7077,0.3049314681362159,0.672318779143705,0.02274975272007913
2004,WYOMING,CONVERSE,1184,94,4447,5725,0.2068122270742358,0.7767685589519651,0.016419213973799127
2004,WYOMING,CROOK,501,59,2836,3396,0.14752650176678445,0.8351001177856302,0.017373380447585393
2004,WYOMING,FREMONT,5338,329,11429,17096,0.3122367805334581,0.668518951801591,0.019244267664950864
2004,WYOMING,GOSHEN,1566,99,4114,5779,0.27098113860529505,0.7118878698736806,0.0171309915210244
2004,WYOMING,HOT SPRINGS,623,45,1812,2480,0.25120967741935485,0.7306451612903225,0.018145161290322582
2004,WYOMING,JOHNSON,676,84,3231,3991,0.16938110749185667,0.8095715359559008,0.021047356552242547
2004,WYOMING,LARAMIE,13171,757,25951,39879,0.33027407908924494,0.6507434990847313,0.01898242182602372
2004,WYOMING,LINCOLN,1364,127,6423,7914,0.17235279251958555,0.8115996967399545,0.016047510740459944
2004,WYOMING,NATRONA,9863,693,21512,32068,0.30756517400523886,0.6708244979418735,0.021610328052887613
2004,WYOMING,NIOBRARA,230,20,1064,1314,0.1750380517503805,0.8097412480974124,0.015220700152207
2004,WYOMING,PARK,3007,307,10917,14231,0.21129927622795305,0.7671281006253953,0.021572623146651676
2004,WYOMING,PLATTE,1328,97,3149,4574,0.29033668561434195,0.6884564932225623,0.02120682116309576
2004,WYOMING,SHERIDAN,4066,274,9689,14029,0.28982821298738326,0.690640815453703,0.01953097155891368
2004,WYOMING,SUBLETTE,730,74,2847,3651,0.19994522048753766,0.7797863599013969,0.02026841961106546
2004,WYOMING,SWEETWATER,5208,411,10653,16272,0.3200589970501475,0.6546828908554573,0.02525811209439528
2004,WYOMING,TETON,5972,263,5124,11359,0.5257505062065323,0.4510960471872524,0.023153446606215336
2004,WYOMING,UINTA,1815,185,6081,8081,0.22460091572825144,0.7525058779853978,0.0228932062863507
2004,WYOMING,WASHAKIE,855,59,3200,4114,0.20782693242586292,0.7778317938745746,0.01434127369956247
2004,WYOMING,WESTON,580,73,2739,3392,0.17099056603773585,0.8074882075471698,0.02152122641509434
2008,ALABAMA,AUTAUGA,6093,145,17403,23641,0.25773021445793326,0.7361363732498625,0.006133412292204221
2008,ALABAMA,BALDWIN,19386,756,61271,81413,0.23811921928930269,0.7525947944431479,0.00928598626754941
2008,ALABAMA,BARBOUR,5697,67,5866,11630,0.48985382631126395,0.5043852106620809,0.005760963026655202
2008,ALABAMA,BIBB,2299,83,6262,8644,0.2659648310967145,0.7244331328088848,0.00960203609440074
2008,ALABAMA,BLOUNT,3522,356,20389,24267,0.14513536901965632,0.8401945028227634,0.014670128157580254
2008,ALABAMA,BULLOCK,4011,13,1391,5415,0.7407202216066482,0.25687903970452447,0.0024007386888273315
2008,ALABAMA,BUTLER,4188,36,5485,9709,0.43135235348645584,0.5649397466268411,0.003707899886703059
2008,ALABAMA,CALHOUN,16334,560,32348,49242,0.331708703951911,0.6569188903781324,0.011372405669956542
2008,ALABAMA,CHAMBERS,6799,90,8067,14956,0.4546001604707141,0.5393821877507355,0.006017651778550415
2008,ALABAMA,CHEROKEE,2306,141,7298,9745,0.2366341713699333,0.748896870189841,0.014468958440225757
2008,ALABAMA,CHILTON,3674,151,13960,17785,0.20657857745290975,0.7849311217317965,0.008490300815293787
2008,ALABAMA,CHOCTAW,3636,35,4223,7894,0.46060298961236384,0.5349632632379022,0.004433747149733975
2008,ALABAMA,CLARKE,5914,55,7466,13435,0.44019352437662823,0.5557126907331597,0.004093784890212133
2008,ALABAMA,CLAY,1760,75,4984,6819,0.25810236105000733,0.7308989587916117,0.010998680158380994
2008,ALABAMA,CLEBURNE,1168,108,5216,6492,0.17991373998767715,0.8034504004929144,0.0166358595194085
2008,ALABAMA,COFFEE,5079,130,14919,20128,0.25233505564387915,0.7412062798092209,0.006458664546899841
2008,ALABAMA,COLBERT,9703,401,14739,24843,0.39057279716620374,0.5932858350440768,0.01614136778971944
2008,ALABAMA,CONECUH,3429,44,3470,6943,0.49387872677516925,0.49978395506265305,0.006337318162177733
2008,ALABAMA,COOSA,2273,42,3248,5563,0.408592486068668,0.5838576307747618,0.007549883156570196
2008,ALABAMA,COVINGTON,3240,103,12444,15787,0.20523215303730918,0.7882434914803319,0.006524355482358903
2008,ALABAMA,CRENSHAW,1938,34,4319,6291,0.30805913209346686,0.6865363217294548,0.0054045461770783655
2008,ALABAMA,CULLMAN,5864,545,28896,35305,0.16609545390171362,0.8184676391445971,0.015436906953689279
2008,ALABAMA,DALE,5270,164,13886,19320,0.2727743271221532,0.7187370600414079,0.008488612836438923
2008,ALABAMA,DALLAS,13986,68,6798,20852,0.6707270285823902,0.3260118933435642,0.003261078074045655
2008,ALABAMA,DEKALB,5658,400,17957,24015,0.23560274828232355,0.7477409952113263,0.0166562565063502
2008,ALABAMA,ELMORE,8301,237,25777,34315,0.2419058720676089,0.7511875273204138,0.00690660061197727
2008,ALABAMA,ESCAMBIA,5188,111,9375,14674,0.35355049747853345,0.6388851029030939,0.007564399618372632
2008,ALABAMA,ETOWAH,13497,645,30595,44737,0.3016965822473568,0.6838858215794532,0.014417596173189978
2008,ALABAMA,FAYETTE,1994,80,5883,7957,0.25059695865275855,0.7393490008797285,0.010054040467512881
2008,ALABAMA,FRANKLIN,3469,176,8048,11693,0.29667322329598905,0.6882750363465321,0.015051740357478834
2008,ALABAMA,GENEVA,2134,106,9417,11657,0.18306596894569788,0.807840782362529,0.009093248691773184
2008,ALABAMA,GREENE,4408,21,876,5305,0.830914231856739,0.1651272384542884,0.003958529688972668
2008,ALABAMA,HALE,4982,32,3200,8214,0.6065254443632822,0.38957876795714635,0.0038957876795714633
2008,ALABAMA,HENRY,3018,45,5585,8648,0.3489824236817761,0.6458140610545791,0.005203515263644773
2008,ALABAMA,HOUSTON,12225,256,29254,41735,0.292919611836588,0.700946447825566,0.006133940337845933
2008,ALABAMA,JACKSON,6374,417,14083,20874,0.3053559451949794,0.674667049918559,0.019977004886461626
2008,ALABAMA,JEFFERSON,166121,2482,149921,318524,0.5215336991875024,0.47067410932928133,0.007792191483216335
2008,ALABAMA,LAMAR,1614,42,5419,7075,0.22812720848056536,0.7659363957597173,0.005936395759717315
2008,ALABAMA,LAUDERDALE,13329,707,24068,38104,0.34980579466722656,0.6316397228637414,0.018554482469032123
2008,ALABAMA,LAWRENCE,5164,239,9277,14680,0.3517711171662125,0.6319482288828338,0.01628065395095368
2008,ALABAMA,LEE,21498,597,32230,54325,0.3957294063506673,0.5932811780947999,0.010989415554532905
2008,ALABAMA,LIMESTONE,9536,417,23598,33551,0.28422401716789364,0.7033471431551965,0.012428839676909779
2008,ALABAMA,LOWNDES,5449,20,1809,7278,0.7486946963451497,0.2485572959604287,0.0027480076944215444
2008,ALABAMA,MACON,9450,31,1396,10877,0.8688057368759768,0.12834421255860992,0.0028500505654132573
2008,ALABAMA,MADISON,64117,1817,86965,152899,0.41934218013198254,0.5687741581043696,0.011883661763647899
2008,ALABAMA,MARENGO,5926,29,5516,11471,0.5166070961555226,0.480864789469096,0.0025281143753813967
2008,ALABAMA,MARION,2600,219,9536,12355,0.2104411169566977,0.7718332658842574,0.017725617159044922
2008,ALABAMA,MARSHALL,7038,401,25727,33166,0.21220527045769763,0.7757040342519448,0.012090695290357596
2008,ALABAMA,MOBILE,82181,1194,98049,181424,0.4529775553399771,0.5404411764705882,0.006581268189434694
2008,ALABAMA,MONROE,5025,52,6175,11252,0.4465872733736225,0.5487913259864913,0.004621400639886242
2008,ALABAMA,MONTGOMERY,62166,546,42031,104743,0.5935098288191096,0.40127741233304376,0.0052127588478466345
2008,ALABAMA,MORGAN,13895,633,36014,50542,0.2749198686241146,0.7125558941078707,0.01252423726801472
2008,ALABAMA,PERRY,4457,23,1679,6159,0.7236564377333983,0.27260918980353954,0.0037343724630621855
2008,ALABAMA,PICKENS,4594,39,5434,10067,0.4563425052150591,0.53978345087911,0.0038740439058309326
2008,ALABAMA,PIKE,5879,72,8004,13955,0.42128269437477606,0.5735578645646722,0.0051594410605517735
2008,ALABAMA,RANDOLPH,3064,145,7175,10384,0.2950693374422188,0.6909668721109399,0.013963790446841295
2008,ALABAMA,RUSSELL,10085,125,8705,18915,0.5331747290510177,0.4602167591858313,0.006608511763150938
2008,ALABAMA,SHELBY,20625,958,69060,90643,0.22754101254371545,0.7618900521827389,0.010568935273545669
2008,ALABAMA,ST. CLAIR,6091,348,27649,34088,0.17868458108425253,0.811106547758742,0.010208871157005398
2008,ALABAMA,SUMTER,5264,25,1731,7020,0.7498575498575498,0.2465811965811966,0.0035612535612535613
2008,ALABAMA,TALLADEGA,13779,313,20112,34204,0.40284762016138465,0.588001403344638,0.009150976493977312
2008,ALABAMA,TALLAPOOSA,6063,132,13116,19311,0.31396613329190615,0.6791983843405313,0.006835482367562529
2008,ALABAMA,TUSCALOOSA,32796,711,45405,78912,0.4156021897810219,0.5753877737226277,0.009010036496350364
2008,ALABAMA,WALKER,7420,510,20722,28652,0.2589697054306855,0.7232304900181489,0.017799804551165713
2008,ALABAMA,WASHINGTON,3067,54,5654,8775,0.34951566951566954,0.6443304843304843,0.006153846153846154
2008,ALABAMA,WILCOX,4612,14,1868,6494,0.7101940252540807,0.2876501385894672,0.0021558361564521095
2008,ALABAMA,WINSTON,1757,171,8103,10031,0.17515701325889743,0.8077958329179543,0.01704715382314824
2008,ALASKA,DISTRICT 1,2597,224,4149,6970,0.372596843615495,0.5952654232424677,0.0321377331420373
2008,ALASKA,DISTRICT 10,2074,149,3392,5615,0.3693677649154052,0.6040961709706144,0.02653606411398041
2008,ALASKA,DISTRICT 11,1924,206,7736,9866,0.1950131765659842,0.7841070342590716,0.020879789174944253
2008,ALASKA,DISTRICT 12,1914,208,5467,7589,0.25220714191593097,0.7203847674265385,0.027408090657530637
2008,ALASKA,DISTRICT 13,2800,294,8432,11526,0.24292903001908728,0.7315634218289085,0.025507548152004164
2008,ALASKA,DISTRICT 14,2132,216,8108,10456,0.20390206579954093,0.7754399387911247,0.020657995409334353
2008,ALASKA,DISTRICT 15,2510,349,8227,11086,0.22641169042035,0.7421071621865416,0.03148114739310842
2008,ALASKA,DISTRICT 16,2636,287,7774,10697,0.24642423109282977,0.726745816584089,0.026829952323081236
2008,ALASKA,DISTRICT 17,2645,182,6621,9448,0.27995342929720574,0.7007832345469941,0.01926333615580017
2008,ALASKA,DISTRICT 18,2046,113,4252,6411,0.3191389798783341,0.663235064732491,0.017625955389174854
2008,ALASKA,DISTRICT 19,3095,171,4106,7372,0.41983179598480735,0.5569723277265328,0.023195876288659795
2008,ALASKA,DISTRICT 2,3468,238,4029,7735,0.44835164835164837,0.5208791208791209,0.03076923076923077
2008,ALASKA,DISTRICT 20,2474,128,2536,5138,0.4815103152977812,0.49357726741922925,0.02491241728298949
2008,ALASKA,DISTRICT 21,3647,191,4837,8675,0.4204034582132565,0.5575792507204611,0.022017291066282422
2008,ALASKA,DISTRICT 22,3337,188,3109,6634,0.503014772384685,0.46864636719927644,0.02833886041603859
2008,ALASKA,DISTRICT 23,4075,199,2808,7082,0.5754024286924597,0.3964981643603502,0.02809940694719006
2008,ALASKA,DISTRICT 24,3380,181,4127,7688,0.4396462018730489,0.5368106139438086,0.02354318418314256
2008,ALASKA,DISTRICT 25,3233,168,3042,6443,0.5017848828185628,0.4721403073102592,0.026074809871178023
2008,ALASKA,DISTRICT 26,4472,186,4037,8695,0.514318573893042,0.46428982173663025,0.021391604370327773
2008,ALASKA,DISTRICT 27,3130,209,5159,8498,0.36832195810779006,0.6070840197693574,0.024594022122852437
2008,ALASKA,DISTRICT 28,3642,197,5953,9792,0.37193627450980393,0.6079452614379085,0.020118464052287583
2008,ALASKA,DISTRICT 29,2684,151,4127,6962,0.3855214018960069,0.5927894283251939,0.021689169778799196
2008,ALASKA,DISTRICT 3,5657,281,2829,8767,0.6452606364777005,0.3226873502908635,0.03205201323143607
2008,ALASKA,DISTRICT 30,3486,197,5500,9183,0.3796145050637047,0.5989328106283349,0.02145268430796036
2008,ALASKA,DISTRICT 31,3596,205,6419,10220,0.3518590998043053,0.6280821917808219,0.020058708414872797
2008,ALASKA,DISTRICT 32,5176,264,6867,12307,0.4205736572682213,0.5579751361014057,0.02145120663037296
2008,ALASKA,DISTRICT 33,2089,249,6571,8909,0.234481984510046,0.7375687507015378,0.02794926478841621
2008,ALASKA,DISTRICT 34,1920,270,7358,9548,0.20108923334729786,0.7706325932132384,0.02827817343946376
2008,ALASKA,DISTRICT 35,4254,290,4959,9503,0.44764811112280334,0.5218352099337051,0.03051667894349153
2008,ALASKA,DISTRICT 36,2264,208,4201,6673,0.33927768619811177,0.6295519256706129,0.03117038813127529
2008,ALASKA,DISTRICT 37,1868,136,2661,4665,0.4004287245444802,0.5704180064308682,0.02915326902465166
2008,ALASKA,DISTRICT 38,2549,215,2056,4820,0.5288381742738589,0.42655601659751036,0.044605809128630707
2008,ALASKA,DISTRICT 39,2695,166,2323,5184,0.5198688271604939,0.4481095679012346,0.03202160493827161
2008,ALASKA,DISTRICT 4,4161,273,4302,8736,0.47630494505494503,0.49244505494505497,0.03125
2008,ALASKA,DISTRICT 40,2137,177,2686,5000,0.4274,0.5372,0.0354
2008,ALASKA,DISTRICT 5,3393,304,3426,7123,0.47634423697880107,0.48097711638354623,0.042678646637652674
2008,ALASKA,DISTRICT 6,2351,239,4234,6824,0.3445193434935522,0.6204572098475967,0.03502344665885111
2008,ALASKA,DISTRICT 7,4283,314,6297,10894,0.39315219386818434,0.5780246006976317,0.028823205434183954
2008,ALASKA,DISTRICT 8,4995,342,4983,10320,0.48401162790697677,0.48284883720930233,0.03313953488372093
2008,ALASKA,DISTRICT 9,2805,197,4141,7143,0.39269214615707687,0.5797284054318914,0.02757944841103178
2008,ALASKA,DISTRICT 99,0,0,0,0,,,
2008,ARIZONA,APACHE,15390,321,8551,24262,0.6343252823345149,0.35244415134778667,0.013230566317698459
2008,ARIZONA,COCHISE,18943,851,29026,48820,0.38801720606308887,0.5945514133551824,0.0174313805817288
2008,ARIZONA,COCONINO,31433,725,22186,54344,0.5784079199175622,0.408251140880318,0.013340939202119829
2008,ARIZONA,GILA,7884,354,14095,22333,0.3530201943312587,0.631128822818251,0.015850982850490306
2008,ARIZONA,GRAHAM,3487,144,8376,12007,0.290413925210294,0.6975930707087532,0.011993004080952777
2008,ARIZONA,GREENLEE,1165,36,1712,2913,0.3999313422588397,0.5877102643323034,0.012358393408856848
2008,ARIZONA,LA PAZ,1929,114,3509,5552,0.3474423631123919,0.6320244956772334,0.02053314121037464
2008,ARIZONA,MARICOPA,602166,16348,746448,1364962,0.4411595341115723,0.5468635756892866,0.011976890199141076
2008,ARIZONA,MOHAVE,22092,1180,44333,67605,0.32678056356778346,0.6557651061312033,0.01745433030101324
2008,ARIZONA,NAVAJO,15579,460,19761,35800,0.4351675977653631,0.5519832402234637,0.012849162011173185
2008,ARIZONA,PIMA,206254,4768,182406,393428,0.5242484012322458,0.4636324816739022,0.012119117093851987
2008,ARIZONA,PINAL,44254,1208,59421,104883,0.4219368248429202,0.5665455793598582,0.011517595797221666
2008,ARIZONA,SANTA CRUZ,8683,102,4518,13303,0.6527099150567541,0.33962264150943394,0.0076674434338119225
2008,ARIZONA,YAVAPAI,36889,1567,61192,99648,0.370193079640334,0.6140815671162492,0.015725353243416826
2008,ARIZONA,YUMA,18559,479,24577,43615,0.4255187435515304,0.5634987962856816,0.010982460162788032
2008,ARKANSAS,ARKANSAS,2619,174,4185,6978,0.3753224419604471,0.5997420464316423,0.024935511607910577
2008,ARKANSAS,ASHLEY,2976,260,5406,8642,0.34436473038648463,0.6255496412867392,0.03008562832677621
2008,ARKANSAS,BAXTER,6539,590,12852,19981,0.3272608978529603,0.6432110504979731,0.029528051649066613
2008,ARKANSAS,BENTON,23331,1618,51124,76073,0.30669225612240875,0.6720386996700538,0.0212690442075375
2008,ARKANSAS,BOONE,4435,464,10575,15474,0.28660979707897116,0.6834044203179527,0.029985782603076126
2008,ARKANSAS,BRADLEY,1680,99,2262,4041,0.41573867854491464,0.5597624350408315,0.024498886414253896
2008,ARKANSAS,CALHOUN,691,64,1462,2217,0.3116824537663509,0.6594497068110059,0.02886783942264321
2008,ARKANSAS,CARROLL,4172,324,6083,10579,0.39436619718309857,0.5750070895169676,0.03062671329993383
2008,ARKANSAS,CHICOT,3043,46,2119,5208,0.5842933947772657,0.4068740399385561,0.008832565284178187
2008,ARKANSAS,CLARK,4267,219,4608,9094,0.46921046844073017,0.5067077193754124,0.02408181218385749
2008,ARKANSAS,CLAY,2244,235,3032,5511,0.40718562874251496,0.5501723825077118,0.04264198874977318
2008,ARKANSAS,CLEBURNE,2951,425,7962,11338,0.26027518080790263,0.7022402540130535,0.03748456517904392
2008,ARKANSAS,CLEVELAND,911,143,2451,3505,0.2599144079885877,0.6992867332382311,0.04079885877318117
2008,ARKANSAS,COLUMBIA,3554,143,5861,9558,0.3718351119481063,0.6132035990793053,0.014961288972588407
2008,ARKANSAS,CONWAY,3149,298,4691,8138,0.3869501105922831,0.5764315556647825,0.036618333742934384
2008,ARKANSAS,CRAIGHEAD,11294,793,18881,30968,0.3646990441746319,0.6096938775510204,0.025607078274347713
2008,ARKANSAS,CRAWFORD,5238,606,14688,20532,0.25511396843950906,0.7153711279953243,0.02951490356516657
2008,ARKANSAS,CRITTENDEN,10330,275,7650,18255,0.5658723637359627,0.419063270336894,0.015064365927143249
2008,ARKANSAS,CROSS,2580,157,4393,7130,0.36185133239831696,0.6161290322580645,0.022019635343618515
2008,ARKANSAS,DALLAS,1471,90,1757,3318,0.44333936106088007,0.5295358649789029,0.027124773960216998
2008,ARKANSAS,DESHA,2569,110,1999,4678,0.5491663103890552,0.4273193672509619,0.0235143223599829
2008,ARKANSAS,DREW,2598,152,3860,6610,0.3930408472012103,0.583963691376702,0.022995461422087745
2008,ARKANSAS,FAULKNER,14955,862,25362,41179,0.36317054809490273,0.6158964520750868,0.020932999830010443
2008,ARKANSAS,FRANKLIN,1869,195,4411,6475,0.28864864864864864,0.6812355212355212,0.030115830115830116
2008,ARKANSAS,FULTON,1819,155,2702,4676,0.3890076988879384,0.5778443113772455,0.03314798973481608
2008,ARKANSAS,GARLAND,15899,995,26825,43719,0.36366339577757956,0.613577620714106,0.022758983508314463
2008,ARKANSAS,GRANT,1562,208,5023,6793,0.22994258795819225,0.7394376564110113,0.030619755630796407
2008,ARKANSAS,GREENE,4541,493,8578,13612,0.3336027034969145,0.6301792535997649,0.0362180429033206
2008,ARKANSAS,HEMPSTEAD,2869,207,4273,7349,0.3903932507824194,0.5814396516532861,0.02816709756429446
2008,ARKANSAS,HOT SPRING,4288,458,7209,11955,0.3586783772480134,0.6030112923462986,0.038310330405687994
2008,ARKANSAS,HOWARD,1746,143,2957,4846,0.3602971522905489,0.610193974411886,0.029508873297565002
2008,ARKANSAS,INDEPENDENCE,3688,356,8255,12299,0.2998617773802748,0.671192779900805,0.028945442718920238
2008,ARKANSAS,IZARD,1792,233,3193,5218,0.3434266002299732,0.6119202759678037,0.044653123802223076
2008,ARKANSAS,JACKSON,2207,257,3118,5582,0.395378000716589,0.5585811537083483,0.0460408455750627
2008,ARKANSAS,JEFFERSON,18465,569,10655,29689,0.6219475226514871,0.35888712991343596,0.019165347435076963
2008,ARKANSAS,JOHNSON,3034,224,4922,8180,0.3709046454767726,0.6017114914425428,0.027383863080684596
2008,ARKANSAS,LAFAYETTE,1133,84,1685,2902,0.39042039972432807,0.5806340454858718,0.028945554789800137
2008,ARKANSAS,LAWRENCE,2138,335,3357,5830,0.36672384219554033,0.5758147512864494,0.057461406518010294
2008,ARKANSAS,LEE,2263,46,1454,3763,0.6013818761626362,0.3863938347063513,0.01222428913101249
2008,ARKANSAS,LINCOLN,1710,183,2513,4406,0.3881071266454834,0.5703586019064911,0.04153427144802542
2008,ARKANSAS,LITTLE RIVER,1753,152,3247,5152,0.3402562111801242,0.6302406832298136,0.029503105590062112
2008,ARKANSAS,LOGAN,2286,271,5350,7907,0.2891109143796636,0.6766156570127735,0.03427342860756292
2008,ARKANSAS,LONOKE,5968,531,17242,23741,0.25137947011499095,0.7262541594709574,0.02236637041405164
2008,ARKANSAS,MADISON,2144,212,3972,6328,0.3388116308470291,0.6276864728192162,0.03350189633375474
2008,ARKANSAS,MARION,2384,254,4524,7162,0.33286791399050547,0.6316671320860094,0.03546495392348506
2008,ARKANSAS,MILLER,4869,281,9913,15063,0.3232423819956184,0.6581026355971586,0.018654982407222995
2008,ARKANSAS,MISSISSIPPI,6667,367,6976,14010,0.47587437544610994,0.4979300499643112,0.02619557458957887
2008,ARKANSAS,MONROE,1615,80,1754,3449,0.4682516671498985,0.5085532038271963,0.02319512902290519
2008,ARKANSAS,MONTGOMERY,1092,165,2365,3622,0.3014908890115958,0.6529541689674213,0.04555494202098288
2008,ARKANSAS,NEVADA,1474,99,2062,3635,0.4055020632737277,0.5672627235213205,0.027235213204951855
2008,ARKANSAS,NEWTON,1182,190,2588,3960,0.29848484848484846,0.6535353535353535,0.047979797979797977
2008,ARKANSAS,OUACHITA,4346,187,5427,9960,0.4363453815261044,0.5448795180722892,0.018775100401606425
2008,ARKANSAS,PERRY,1352,184,2743,4279,0.31596167328815145,0.6410376256134611,0.043000701098387474
2008,ARKANSAS,PHILLIPS,5695,177,3097,8969,0.6349648790277623,0.3453004794291448,0.019734641543092877
2008,ARKANSAS,PIKE,1089,150,2727,3966,0.2745839636913767,0.6875945537065052,0.037821482602118005
2008,ARKANSAS,POINSETT,2742,283,4903,7928,0.3458627648839556,0.6184409687184662,0.035696266397578204
2008,ARKANSAS,POLK,1957,251,5473,7681,0.25478453326389794,0.7125374300221325,0.03267803671396954
2008,ARKANSAS,POPE,6002,509,15568,22079,0.27184202183069883,0.7051043978441053,0.023053580325195888
2008,ARKANSAS,PRAIRIE,1048,110,2223,3381,0.30996746524696833,0.6574977817213842,0.03253475303164744
2008,ARKANSAS,PULASKI,88854,2277,70212,161343,0.5507149365017385,0.4351722727357245,0.014112790762536956
2008,ARKANSAS,RANDOLPH,2469,235,3615,6319,0.39072638075644883,0.5720841905364773,0.0371894287070739
2008,ARKANSAS,SALINE,12695,977,30981,44653,0.28430340626609635,0.6938167648310304,0.021879828902873266
2008,ARKANSAS,SCOTT,1053,151,2791,3995,0.26357947434292867,0.6986232790988736,0.037797246558197745
2008,ARKANSAS,SEARCY,961,160,2726,3847,0.24980504289056407,0.7086041070964387,0.041590850012997144
2008,ARKANSAS,SEBASTIAN,13673,902,28637,43212,0.31641673609182636,0.6627094325650282,0.020873831343145424
2008,ARKANSAS,SEVIER,1291,164,3125,4580,0.28187772925764193,0.6823144104803494,0.03580786026200873
2008,ARKANSAS,SHARP,2436,281,4535,7252,0.3359073359073359,0.6253447324875896,0.03874793160507446
2008,ARKANSAS,ST. FRANCIS,5486,102,3917,9505,0.5771699105733824,0.41209889531825356,0.010731194108364019
2008,ARKANSAS,STONE,1598,192,3534,5324,0.3001502629601803,0.663786626596544,0.03606311044327573
2008,ARKANSAS,UNION,6190,312,10677,17179,0.3603236509692066,0.6215146399674021,0.01816170906339135
2008,ARKANSAS,VAN BUREN,2151,276,4276,6703,0.32090108906459797,0.6379233179173505,0.04117559301805162
2008,ARKANSAS,WASHINGTON,29021,1396,37963,68380,0.42440772155601053,0.5551769523252413,0.020415326118748172
2008,ARKANSAS,WHITE,6732,756,19467,26955,0.24974958263772956,0.7222036727879799,0.028046744574290485
2008,ARKANSAS,WOODRUFF,1412,143,1206,2761,0.5114089098152843,0.4367982614994567,0.05179282868525897
2008,ARKANSAS,YELL,2003,225,3808,6036,0.3318422796554009,0.6308813783962889,0.037276341948310136
2008,CALIFORNIA,ALAMEDA,489106,12368,119555,621029,0.7875735271621777,0.1925111387712973,0.019915334066525073
2008,CALIFORNIA,ALPINE,422,18,252,692,0.6098265895953757,0.36416184971098264,0.02601156069364162
2008,CALIFORNIA,AMADOR,7813,436,10561,18810,0.41536416799574694,0.5614566719829878,0.023179160021265285
2008,CALIFORNIA,BUTTE,49013,2606,46706,98325,0.4984795321637427,0.4750165268243071,0.026503941011950166
2008,CALIFORNIA,CALAVERAS,9813,658,12835,23306,0.4210503732944306,0.5507165536771647,0.028233073028404703
2008,CALIFORNIA,COLUSA,2569,127,3733,6429,0.3995955825167211,0.5806501788769638,0.019754238606315134
2008,CALIFORNIA,CONTRA COSTA,306983,8231,136436,451650,0.6796922395660356,0.3020834717148234,0.01822428871914093
2008,CALIFORNIA,DEL NORTE,4323,241,4967,9531,0.45357255272269437,0.5211415381387052,0.025285909138600356
2008,CALIFORNIA,EL DORADO,40529,2083,50314,92926,0.4361427372317758,0.5414415771689302,0.022415685599294063
2008,CALIFORNIA,FRESNO,136706,4568,131015,272289,0.50206214720389,0.48116155996018933,0.016776292835920657
2008,CALIFORNIA,GLENN,3734,235,5910,9879,0.3779734790970746,0.5982386881263285,0.02378783277659682
2008,CALIFORNIA,HUMBOLDT,39692,2322,21713,63727,0.6228443203037959,0.3407190045035856,0.03643667519261851
2008,CALIFORNIA,IMPERIAL,24162,650,14008,38820,0.6224111282843895,0.36084492529623907,0.016743946419371457
2008,CALIFORNIA,INYO,3743,267,4523,8533,0.438649947263565,0.5300597679596859,0.03129028477674909
2008,CALIFORNIA,KERN,93457,4600,134793,232850,0.40136139145372557,0.5788834013313292,0.019755207214945242
2008,CALIFORNIA,KINGS,14747,651,19710,35108,0.42004671299988605,0.561410504728267,0.018542782271846872
2008,CALIFORNIA,LAKE,14854,753,9935,25542,0.5815519536449769,0.3889671912927727,0.02948085506225041
2008,CALIFORNIA,LASSEN,3586,318,7483,11387,0.3149205234038816,0.6571528936506542,0.027926582945464126
2008,CALIFORNIA,LOS ANGELES,2295853,65970,956425,3318248,0.6918871042791256,0.28823192238795897,0.01988097333291544
2008,CALIFORNIA,MADERA,17952,820,23583,42355,0.4238460630386023,0.5567937669696612,0.019360169991736512
2008,CALIFORNIA,MARIN,109320,2493,28384,140197,0.7797599092705265,0.20245796985670164,0.017782120872771884
2008,CALIFORNIA,MARIPOSA,4100,253,5298,9651,0.4248264428556626,0.5489586571339757,0.02621490001036162
2008,CALIFORNIA,MENDOCINO,27843,1452,10721,40016,0.695796681327469,0.2679178328668533,0.03628548580567773
2008,CALIFORNIA,MERCED,34031,1073,28704,63808,0.5333343781344032,0.4498495486459378,0.016816073219658976
2008,CALIFORNIA,MODOC,1313,126,2981,4420,0.29705882352941176,0.6744343891402715,0.02850678733031674
2008,CALIFORNIA,MONO,3093,124,2354,5571,0.5551965535810447,0.422545323999282,0.022258122419673308
2008,CALIFORNIA,MONTEREY,88453,2533,38797,129783,0.6815453487744928,0.2989374571399952,0.01951719408551197
2008,CALIFORNIA,NAPA,38849,1309,19484,59642,0.6513698400456055,0.32668253915026324,0.021947620804131318
2008,CALIFORNIA,NEVADA,28617,1367,25663,55647,0.5142595288155696,0.4611749061045519,0.02456556507987852
2008,CALIFORNIA,ORANGE,549558,25065,579064,1153687,0.47634930444739343,0.5019246988134564,0.02172599673915022
2008,CALIFORNIA,PLACER,75112,3348,94647,173107,0.433905041390585,0.5467543195826858,0.019340639026729133
2008,CALIFORNIA,PLUMAS,4715,278,6035,11028,0.4275480594849474,0.5472433804860355,0.025208560029017047
2008,CALIFORNIA,RIVERSIDE,325017,12241,310041,647299,0.5021126249229491,0.47897648536456877,0.018910889712482178
2008,CALIFORNIA,SACRAMENTO,316506,11012,213583,541101,0.5849296157279325,0.39471928530902733,0.020351098963040173
2008,CALIFORNIA,SAN BENITO,11917,363,7425,19705,0.604770362852068,0.3768079167723928,0.018421720375539203
2008,CALIFORNIA,SAN BERNARDINO,315720,13206,277408,606334,0.5207031108267061,0.4575168141651301,0.021780075008163816
2008,CALIFORNIA,SAN DIEGO,666581,23434,541032,1231047,0.5414748583928964,0.43948931275572745,0.019035828851376106
2008,CALIFORNIA,SAN FRANCISCO,322220,8353,52292,382865,0.8416021312995442,0.13658077912580152,0.021817089574654253
2008,CALIFORNIA,SAN JOAQUIN,113974,3768,91607,209349,0.5444210385528472,0.4375803084800978,0.017998652967055013
2008,CALIFORNIA,SAN LUIS OBISPO,68176,3422,61055,132653,0.5139423910503343,0.4602609816589146,0.025796627290751058
2008,CALIFORNIA,SAN MATEO,222826,5409,75057,303292,0.734691320575551,0.2474743811244609,0.01783429829998813
2008,CALIFORNIA,SANTA BARBARA,105614,3713,65585,174912,0.6038122027076472,0.3749599798755946,0.02122781741675814
2008,CALIFORNIA,SANTA CLARA,462241,13309,190039,665589,0.6944841336019676,0.2855200431497516,0.019995823248280847
2008,CALIFORNIA,SANTA CRUZ,98745,3494,25244,127483,0.7745738647505942,0.1980185593373234,0.027407575912082396
2008,CALIFORNIA,SHASTA,28867,1935,49588,80390,0.35908695111332256,0.6168428909068292,0.02407015797984824
2008,CALIFORNIA,SIERRA,743,90,1158,1991,0.37317930688096435,0.5816172777498745,0.045203415369161226
2008,CALIFORNIA,SISKIYOU,9292,658,11520,21470,0.4327899394503959,0.5365626455519329,0.03064741499767117
2008,CALIFORNIA,SOLANO,102095,2843,56035,160973,0.634236797475353,0.3481018555906891,0.017661346933957867
2008,CALIFORNIA,SONOMA,168888,5336,55127,229351,0.7363735061107212,0.24036084429542492,0.023265649593853962
2008,CALIFORNIA,STANISLAUS,80279,3239,77497,161015,0.49858087755799146,0.4813029841940192,0.02011613824798932
2008,CALIFORNIA,SUTTER,13412,618,18911,32941,0.40715218117239915,0.5740870040375217,0.018760814790079232
2008,CALIFORNIA,TEHAMA,8945,648,14843,24436,0.3660582746767065,0.6074234735635947,0.026518251759698803
2008,CALIFORNIA,TRINITY,3233,201,2940,6374,0.5072168183244431,0.4612488233448384,0.03153435833071854
2008,CALIFORNIA,TULARE,43634,1807,59765,105206,0.41474820827709447,0.5680759652491303,0.01717582647377526
2008,CALIFORNIA,TUOLUMNE,11532,661,14988,27181,0.4242669511791325,0.5514145910746477,0.024318457746219786
2008,CALIFORNIA,VENTURA,187601,6346,145853,339800,0.5520924072984108,0.4292319011183049,0.018675691583284283
2008,CALIFORNIA,YOLO,53488,1669,24592,79749,0.6707043348505938,0.30836750304079047,0.020928162108615783
2008,CALIFORNIA,YUBA,8866,528,12007,21401,0.4142797065557684,0.5610485491332181,0.024671744311013506
2008,COLORADO,ADAMS,93443,3080,63976,160499,0.5822030043800897,0.39860684490246046,0.019190150717449953
2008,COLORADO,ALAMOSA,3521,130,2635,6286,0.5601336302895323,0.41918549156856505,0.020680878141902642
2008,COLORADO,ARAPAHOE,148218,4064,113866,266148,0.5569006718066639,0.4278296286276808,0.0152696995656552
2008,COLORADO,ARCHULETA,2836,151,3638,6625,0.4280754716981132,0.5491320754716981,0.02279245283018868
2008,COLORADO,BACA,536,67,1572,2175,0.2464367816091954,0.7227586206896551,0.030804597701149426
2008,COLORADO,BENT,799,44,1077,1920,0.4161458333333333,0.5609375,0.022916666666666665
2008,COLORADO,BOULDER,124159,2700,44904,171763,0.7228506721470864,0.26142999365404657,0.015719334198867042
2008,COLORADO,BROOMFIELD,16168,528,12757,29453,0.5489423827793434,0.4331307506875361,0.017926866533120565
2008,COLORADO,CHAFFEE,4861,186,4873,9920,0.49002016129032255,0.4912298387096774,0.01875
2008,COLORADO,CHEYENNE,198,23,890,1111,0.1782178217821782,0.8010801080108011,0.020702070207020702
2008,COLORADO,CLEAR CREEK,3332,135,2300,5767,0.5777700710941565,0.3988208774059303,0.0234090514999133
2008,COLORADO,CONEJOS,2154,67,1653,3874,0.5560144553433144,0.426690758905524,0.01729478575116159
2008,COLORADO,COSTILLA,1245,37,415,1697,0.7336476134354744,0.24454920447849146,0.021803182086034177
2008,COLORADO,CROWLEY,552,30,976,1558,0.35430038510911427,0.6264441591784339,0.019255455712451863
2008,COLORADO,CUSTER,912,45,1672,2629,0.3468999619627235,0.6359832635983264,0.017116774438950173
2008,COLORADO,DELTA,5084,283,10067,15434,0.329402617597512,0.6522612414150577,0.01833614098743035
2008,COLORADO,DENVER,204882,4084,62567,271533,0.7545381224381567,0.230421348418056,0.01504052914378731
2008,COLORADO,DOLORES,369,30,818,1217,0.3032046014790468,0.6721446179129006,0.024650780608052588
2008,COLORADO,DOUGLAS,61960,1751,88108,151819,0.4081175610430842,0.5803489681792134,0.011533470777702396
2008,COLORADO,EAGLE,13187,286,8179,21652,0.609043044522446,0.3777480140402734,0.013208941437280622
2008,COLORADO,EL PASO,108899,3958,160318,273175,0.39864189622037155,0.5868692230255331,0.01448888075409536
2008,COLORADO,ELBERT,3819,279,9108,13206,0.28918673330304406,0.6896865061335756,0.02112676056338028
2008,COLORADO,FREMONT,6844,407,12668,19919,0.34359154576032935,0.6359757015914453,0.020432752648225312
2008,COLORADO,GARFIELD,11357,366,11359,23082,0.49202842041417555,0.4921150680183693,0.01585651156745516
2008,COLORADO,GILPIN,1954,94,1253,3301,0.5919418358073311,0.37958194486519237,0.028476219327476522
2008,COLORADO,GRAND,4037,143,4128,8308,0.48591718825228697,0.496870486278286,0.017212325469427057
2008,COLORADO,GUNNISON,5556,183,3131,8870,0.6263810597519729,0.35298759864712514,0.020631341600901916
2008,COLORADO,HINSDALE,240,15,344,599,0.4006677796327212,0.5742904841402338,0.025041736227045076
2008,COLORADO,HUERFANO,1989,74,1580,3643,0.5459785890749382,0.4337084820203129,0.020312928904748832
2008,COLORADO,JACKSON,277,12,624,913,0.30339539978094193,0.683461117196057,0.013143483023001095
2008,COLORADO,JEFFERSON,158153,5282,131627,295062,0.5359992137245732,0.44609946384149773,0.01790132243392914
2008,COLORADO,KIOWA,178,24,650,852,0.20892018779342722,0.7629107981220657,0.028169014084507043
2008,COLORADO,KIT CARSON,912,75,2455,3442,0.26496223126089485,0.7132481115630448,0.02178965717606043
2008,COLORADO,LA PLATA,16057,419,11503,27979,0.573894706744344,0.4111297759033561,0.01497551735229994
2008,COLORADO,LAKE,1859,65,1078,3002,0.6192538307794804,0.35909393737508327,0.021652231845436375
2008,COLORADO,LARIMER,89822,2910,73641,166373,0.5398832743293683,0.44262590684786596,0.01749081882276571
2008,COLORADO,LAS ANIMAS,3562,113,3086,6761,0.5268451412512942,0.45644135482916726,0.01671350391953853
2008,COLORADO,LINCOLN,546,41,1717,2304,0.23697916666666666,0.7452256944444444,0.017795138888888888
2008,COLORADO,LOGAN,2846,129,6002,8977,0.3170324161746686,0.6685975270134789,0.014370056811852511
2008,COLORADO,MESA,24008,1045,44578,69631,0.3447889589407017,0.640203357699875,0.015007683359423245
2008,COLORADO,MINERAL,270,19,334,623,0.4333868378812199,0.536115569823435,0.030497592295345103
2008,COLORADO,MOFFAT,1582,154,4135,5871,0.2694600579117697,0.7043093169817748,0.02623062510645546
2008,COLORADO,MONTEZUMA,4661,203,6961,11825,0.39416490486257927,0.5886680761099365,0.017167019027484142
2008,COLORADO,MONTROSE,6495,459,12199,19153,0.3391113663655824,0.636923719521746,0.023964914112671643
2008,COLORADO,MORGAN,3813,149,6272,10234,0.37258159077584524,0.612859097127223,0.014559312096931796
2008,COLORADO,OTERO,3546,125,4393,8064,0.43973214285714285,0.5447668650793651,0.015500992063492064
2008,COLORADO,OURAY,1636,57,1367,3060,0.534640522875817,0.4467320261437909,0.018627450980392157
2008,COLORADO,PARK,4250,237,4896,9383,0.4529468187146968,0.5217947351593307,0.025258446125972504
2008,COLORADO,PHILLIPS,622,26,1612,2260,0.2752212389380531,0.7132743362831858,0.011504424778761062
2008,COLORADO,PITKIN,7349,133,2484,9966,0.737407184427052,0.24924744130042142,0.01334537427252659
2008,COLORADO,PROWERS,1487,85,3043,4615,0.3222101841820152,0.6593716143011917,0.018418201516793065
2008,COLORADO,PUEBLO,41097,1073,30257,72427,0.5674265122122966,0.41775857069877254,0.014814917088930924
2008,COLORADO,RIO BLANCO,655,55,2437,3147,0.20813473149030823,0.7743883063234827,0.01747696218620909
2008,COLORADO,RIO GRANDE,2448,66,2930,5444,0.449669360764144,0.5382072005878031,0.012123438648052902
2008,COLORADO,ROUTT,8270,204,4725,13199,0.6265626183801803,0.35798166527767256,0.015455716342147133
2008,COLORADO,SAGUACHE,1730,64,953,2747,0.6297779395704405,0.346923917000364,0.023298143429195485
2008,COLORADO,SAN JUAN,264,14,218,496,0.532258064516129,0.43951612903225806,0.028225806451612902
2008,COLORADO,SAN MIGUEL,3349,68,933,4350,0.7698850574712643,0.21448275862068966,0.015632183908045976
2008,COLORADO,SEDGWICK,468,26,857,1351,0.3464100666173205,0.6343449296817173,0.01924500370096225
2008,COLORADO,SUMMIT,9802,214,4883,14899,0.6578965031210149,0.3277401167863615,0.014363380092623666
2008,COLORADO,TELLER,4513,247,8146,12906,0.34968231830156515,0.631179296451263,0.019138385247171857
2008,COLORADO,WASHINGTON,529,35,1949,2513,0.21050537206526065,0.775567051333068,0.013927576601671309
2008,COLORADO,WELD,47292,2048,56526,105866,0.4467156594185102,0.5339391305990592,0.019345209982430618
2008,COLORADO,YUMA,1117,80,3286,4483,0.2491635065804149,0.7329913004684363,0.017845192951148784
2008,CONNECTICUT,FAIRFIELD,241320,2931,166845,411096,0.5870161714052192,0.4058541070698815,0.007129721524899294
2008,CONNECTICUT,HARTFORD,268301,4768,138716,411785,0.6515560304527849,0.33686511164806876,0.0115788578991464
2008,CONNECTICUT,LITCHFIELD,51037,1657,46176,98870,0.5162030949731972,0.4670375240214423,0.016759381005360573
2008,CONNECTICUT,MIDDLESEX,52966,1282,32907,87155,0.6077218748207217,0.3775686994435202,0.014709425735758131
2008,CONNECTICUT,NEW HAVEN,232820,4454,144465,381739,0.609893146888319,0.37843919536646764,0.011667657745213353
2008,CONNECTICUT,NEW LONDON,74745,1560,48460,124765,0.5990862822105558,0.38841021119705044,0.0125035065923937
2008,CONNECTICUT,STATEWIDE WRITEIN,0,0,0,0,,,
2008,CONNECTICUT,TOLLAND,44969,1175,29262,75406,0.5963583799697637,0.388059305625547,0.015582314404689282
2008,CONNECTICUT,WINDHAM,34133,926,21210,56269,0.6066039915406352,0.3769393449323784,0.01645666352698644
2008,DELAWARE,KENT,36392,706,29827,66925,0.5437728800896526,0.4456779977586851,0.010549122151662309
2008,DELAWARE,NEW CASTLE,178768,3041,74608,256417,0.6971768642484703,0.2909635476586966,0.011859588092833159
2008,DELAWARE,SUSSEX,40299,832,47939,89070,0.4524418996295049,0.538217132592343,0.009340967778152015
2008,DISTRICT OF COLUMBIA,DISTRICT OF COLUMBIA,245800,2686,17367,265853,0.9245710975614343,0.06532557465968035,0.010103327778885323
2008,FLORIDA,ALACHUA,75565,1441,48513,125519,0.6020204112524797,0.3864992550928545,0.011480333654665827
2008,FLORIDA,BAKER,2327,60,8672,11059,0.21041685505018537,0.7841576996111764,0.005425445338638213
2008,FLORIDA,BAY,23653,791,56683,81127,0.2915552158960642,0.6986946392692939,0.009750144834641981
2008,FLORIDA,BRADFORD,3430,110,8136,11676,0.29376498800959233,0.696813977389517,0.009421034600890716
2008,FLORIDA,BREVARD,127620,2650,157589,287859,0.44334205288005585,0.5474520511778336,0.009205895942110548
2008,FLORIDA,BROWARD,492640,3530,237729,733899,0.6712640295190483,0.32392604431944994,0.004809926161501787
2008,FLORIDA,CALHOUN,1821,78,4345,6244,0.2916399743754004,0.6958680333119796,0.012491992312620116
2008,FLORIDA,CHARLOTTE,39031,922,45205,85158,0.4583362690528195,0.5308367974823269,0.010826933464853566
2008,FLORIDA,CITRUS,31460,992,43706,76158,0.4130885790068016,0.573885868851598,0.013025552141600357
2008,FLORIDA,CLAY,26697,677,67203,94577,0.2822779322668302,0.7105638791672394,0.007158188565930406
2008,FLORIDA,COLLIER,54450,1159,86379,141988,0.38348311124883794,0.6083542271177846,0.008162661633377468
2008,FLORIDA,COLUMBIA,9171,287,18670,28128,0.3260452218430034,0.6637514220705347,0.010203356086461888
2008,FLORIDA,DESOTO,4383,116,5632,10131,0.4326325140657388,0.5559174809989142,0.011450004935346954
2008,FLORIDA,DIXIE,1925,145,5194,7264,0.26500550660792954,0.7150330396475771,0.01996145374449339
2008,FLORIDA,DUVAL,202618,2606,210537,415761,0.487342487631115,0.5063894881915331,0.006268024177351892
2008,FLORIDA,ESCAMBIA,61572,1464,91411,154447,0.3986610293498741,0.5918599908059076,0.009478979844218405
2008,FLORIDA,FLAGLER,24726,354,23951,49031,0.5042932022597948,0.4884868756500989,0.007219922090106259
2008,FLORIDA,FRANKLIN,2134,77,3818,6029,0.3539558799137502,0.6332725161718361,0.012771603914413667
2008,FLORIDA,GADSDEN,15582,117,6811,22510,0.6922256774766771,0.3025766326077299,0.005197689915593069
2008,FLORIDA,GILCHRIST,1996,167,5656,7819,0.25527561069190435,0.7233661593554163,0.021358229952679372
2008,FLORIDA,GLADES,1674,54,2533,4261,0.3928655245247594,0.594461394038958,0.012673081436282563
2008,FLORIDA,GULF,2149,76,4980,7205,0.29826509368494103,0.6911866759195003,0.01054823039555864
2008,FLORIDA,HAMILTON,2364,44,3179,5587,0.4231251118668337,0.5689994630391981,0.00787542509396814
2008,FLORIDA,HARDEE,2568,81,4763,7412,0.34646519158121963,0.6426065839179709,0.010928224500809498
2008,FLORIDA,HENDRY,4998,101,5780,10879,0.45941722584796396,0.5312988326132917,0.00928394153874437
2008,FLORIDA,HERNANDO,41886,994,45021,87901,0.4765133502462998,0.5121784735099715,0.01130817624372874
2008,FLORIDA,HIGHLANDS,18135,427,26221,44783,0.4049527722573298,0.5855123596007413,0.009534868141928858
2008,FLORIDA,HILLSBOROUGH,272963,3994,236355,513312,0.5317682033539056,0.4604509538058725,0.007780842840221932
2008,FLORIDA,HOLMES,1446,110,7033,8589,0.16835487251135173,0.8188380486668996,0.012807078821748748
2008,FLORIDA,INDIAN RIVER,29710,705,40176,70591,0.42087518238868976,0.569137708773073,0.009987108838237169
2008,FLORIDA,JACKSON,7671,177,13717,21565,0.35571527938789704,0.6360769765824252,0.008207744029677718
2008,FLORIDA,JEFFERSON,4088,72,3797,7957,0.5137614678899083,0.4771898956893301,0.009048636420761593
2008,FLORIDA,LAFAYETTE,642,38,2679,3359,0.19112831199761834,0.7975587972610896,0.011312890741292051
2008,FLORIDA,LAKE,62948,1176,82802,146926,0.42843336101166574,0.5635626097491254,0.008004029239208853
2008,FLORIDA,LEE,119701,1967,147608,269276,0.44452903340810174,0.5481661937937283,0.007304772798169907
2008,FLORIDA,LEON,91747,1156,55705,148608,0.6173759151593454,0.3748452304048234,0.00777885443583118
2008,FLORIDA,LEVY,6711,260,11754,18725,0.3583978638184246,0.627716955941255,0.013885180240320427
2008,FLORIDA,LIBERTY,895,44,2339,3278,0.273032336790726,0.7135448444173277,0.013422818791946308
2008,FLORIDA,MADISON,4270,93,4544,8907,0.4793982261142921,0.510160547883687,0.010441226002020883
2008,FLORIDA,MANATEE,70034,1239,80721,151994,0.46076818821795595,0.5310801742174033,0.008151637564640709
2008,FLORIDA,MARION,70839,1555,89628,162022,0.4372184024391749,0.5531841354877732,0.009597462073051807
2008,FLORIDA,MARTIN,33508,643,44143,78294,0.4279766010166807,0.5638107645541165,0.008212634429202748
2008,FLORIDA,MIAMI-DADE,499831,3104,360551,863486,0.5788524654713568,0.41755280340387685,0.0035947311247663542
2008,FLORIDA,MONROE,20907,432,18933,40272,0.5191448152562574,0.47012812872467225,0.010727056019070322
2008,FLORIDA,NASSAU,10618,283,27403,38304,0.277203425229741,0.7154083124477861,0.007388262322472848
2008,FLORIDA,OKALOOSA,25872,868,68789,95529,0.2708287535722137,0.7200850003663809,0.009086246061405437
2008,FLORIDA,OKEECHOBEE,5108,117,7561,12786,0.3994994525262005,0.591349913968403,0.009150633505396527
2008,FLORIDA,ORANGE,273009,2870,186832,462711,0.590020552785648,0.40377687152455854,0.0062025756897934135
2008,FLORIDA,OSCEOLA,59962,622,40086,100670,0.5956292837985497,0.39819211284394557,0.006178603357504718
2008,FLORIDA,PALM BEACH,361271,3192,226037,590500,0.611805249788315,0.3827891617273497,0.005405588484335309
2008,FLORIDA,PASCO,102417,2345,110104,214866,0.47665521767054814,0.5124310035091638,0.010913778820287993
2008,FLORIDA,PINELLAS,248299,4917,210066,463282,0.5359565016555791,0.45343009225482533,0.010613406089595538
2008,FLORIDA,POLK,113865,2090,128878,244833,0.4650721103772776,0.526391458667745,0.008536430954977475
2008,FLORIDA,PUTNAM,13236,298,19637,33171,0.3990232431943565,0.5919930059389226,0.008983750866720932
2008,FLORIDA,SANTA ROSA,19470,743,55972,76185,0.2555621185272691,0.7346853055063333,0.009752575966397585
2008,FLORIDA,SARASOTA,102686,1770,102897,207353,0.4952231219225186,0.4962407102863233,0.008536167791158074
2008,FLORIDA,SEMINOLE,99335,1490,105070,205895,0.4824546492144054,0.5103086524684912,0.007236698317103378
2008,FLORIDA,ST. JOHNS,35791,831,69222,105844,0.3381485960470126,0.6540002267488001,0.007851177204187295
2008,FLORIDA,ST. LUCIE,67125,942,52512,120579,0.5566889756922847,0.4354987186823576,0.00781230562535765
2008,FLORIDA,SUMTER,17655,347,30866,48868,0.3612793648195138,0.6316198739461406,0.007100761234345584
2008,FLORIDA,SUWANNEE,4916,212,12534,17662,0.27833767410259314,0.7096591552485563,0.01200317064885064
2008,FLORIDA,TAYLOR,2803,106,6457,9366,0.2992739696775571,0.6894084988255392,0.011317531496903694
2008,FLORIDA,UNION,1299,53,3933,5285,0.24578997161778618,0.7441816461684011,0.010028382213812678
2008,FLORIDA,VOLUSIA,127795,2091,113938,243824,0.5241280595839622,0.4672960824201063,0.008575857995931491
2008,FLORIDA,WAKULLA,5311,188,8877,14376,0.3694351697273233,0.6174874791318865,0.013077351140790205
2008,FLORIDA,WALTON,7174,311,19561,27046,0.26525179324114473,0.7232492790061377,0.011498927752717592
2008,FLORIDA,WASHINGTON,2863,90,8178,11131,0.2572095948252628,0.7347048782679004,0.008085526906836763
2008,GEORGIA,APPLING,1846,65,5085,6996,0.2638650657518582,0.7268439108061749,0.009291023441966839
2008,GEORGIA,ATKINSON,938,25,1941,2904,0.32300275482093666,0.6683884297520661,0.008608815426997245
2008,GEORGIA,BACON,817,32,3089,3938,0.207465718638903,0.7844083291010665,0.008125952260030472
2008,GEORGIA,BAKER,846,13,828,1687,0.5014819205690575,0.4908120924718435,0.007705986959098993
2008,GEORGIA,BALDWIN,8587,127,7823,16537,0.5192598415673944,0.47306040998972004,0.00767974844288565
2008,GEORGIA,BANKS,1027,94,5120,6241,0.16455696202531644,0.8203813491427656,0.015061688831917962
2008,GEORGIA,BARROW,6657,300,17625,24582,0.27080790822553086,0.7169880400292897,0.0122040517451794
2008,GEORGIA,BARTOW,9662,455,25976,36093,0.26769733743385143,0.7196963400105284,0.012606322555620204
2008,GEORGIA,BEN HILL,2590,29,3417,6036,0.42909211398277003,0.56610337972167,0.004804506295559973
2008,GEORGIA,BERRIEN,1471,77,4901,6449,0.22809737943867267,0.7599627849278958,0.01193983563343154
2008,GEORGIA,BIBB,38987,344,27037,66368,0.5874367164898746,0.40738006268081,0.005183220829315333
2008,GEORGIA,BLECKLEY,1380,34,3657,5071,0.27213567343719186,0.7211595346085584,0.006704791954249655
2008,GEORGIA,BRANTLEY,1119,78,5080,6277,0.17826987414369921,0.8093038075513781,0.012426318304922733
2008,GEORGIA,BROOKS,2669,25,3507,6201,0.4304144492823738,0.5655539429124334,0.004031607805192711
2008,GEORGIA,BRYAN,3636,97,9112,12845,0.2830673413779681,0.7093810821331258,0.007551576488906189
2008,GEORGIA,BULLOCH,9586,160,14174,23920,0.400752508361204,0.5925585284280936,0.006688963210702341
2008,GEORGIA,BURKE,5233,49,4344,9626,0.5436318304591731,0.4512777893205901,0.0050903802202368585
2008,GEORGIA,BUTTS,3065,79,5947,9091,0.3371466285337147,0.6541634583654163,0.00868991310086899
2008,GEORGIA,CALHOUN,1342,7,862,2211,0.6069651741293532,0.38986883763003166,0.003165988240615106
2008,GEORGIA,CAMDEN,6482,100,10502,17084,0.37941933973308356,0.6147272301568719,0.005853430110044486
2008,GEORGIA,CANDLER,1209,23,2286,3518,0.34366117111995453,0.6498010233086982,0.006537805571347356
2008,GEORGIA,CARROLL,14334,503,28661,43498,0.3295323922938986,0.6589038576486276,0.011563750057473907
2008,GEORGIA,CATOOSA,6025,253,18218,24496,0.24595852384062705,0.7437132593076421,0.010328216851730895
2008,GEORGIA,CHARLTON,1197,22,2466,3685,0.3248303934871099,0.6691994572591587,0.005970149253731343
2008,GEORGIA,CHATHAM,62755,654,46829,110238,0.5692683103829895,0.42479907110070936,0.005932618516301094
2008,GEORGIA,CHATTAHOOCHEE,830,12,811,1653,0.5021173623714459,0.4906231094978826,0.007259528130671506
2008,GEORGIA,CHATTOOGA,2596,139,5572,8307,0.3125075237751294,0.6707596003370652,0.016732875887805466
2008,GEORGIA,CHEROKEE,22350,1143,70279,93772,0.23834406859190377,0.7494667917928592,0.012189139615236958
2008,GEORGIA,CLARKE,29591,586,15333,45510,0.6502087453306965,0.336914963744232,0.012876290925071412
2008,GEORGIA,CLAY,879,3,558,1440,0.6104166666666667,0.3875,0.0020833333333333333
2008,GEORGIA,CLAYTON,82527,405,16506,99438,0.8299342303747058,0.16599287998551862,0.004072889639775539
2008,GEORGIA,CLINCH,989,29,1678,2696,0.366839762611276,0.6224035608308606,0.010756676557863502
2008,GEORGIA,COBB,141216,3271,170957,315444,0.44767375508806634,0.5419567340003297,0.010369510911603961
2008,GEORGIA,COFFEE,4811,64,8872,13747,0.34996726558521857,0.6453771732014257,0.004655561213355641
2008,GEORGIA,COLQUITT,4139,111,9185,13435,0.3080759211016003,0.6836620766654261,0.008262002232973577
2008,GEORGIA,COLUMBIA,15703,326,39322,55351,0.2836985781648028,0.7104117360119961,0.005889685823201026
2008,GEORGIA,COOK,2075,46,3782,5903,0.35151617821446723,0.6406911739793325,0.007792647806200237
2008,GEORGIA,COWETA,15521,457,37571,53549,0.28984668247773065,0.7016190778539282,0.008534239668341145
2008,GEORGIA,CRAWFORD,1832,50,3358,5240,0.34961832061068704,0.6408396946564886,0.009541984732824428
2008,GEORGIA,CRISP,3085,41,4424,7550,0.40860927152317883,0.5859602649006622,0.005430463576158941
2008,GEORGIA,DADE,1612,93,4703,6408,0.2515605493133583,0.7339263420724095,0.01451310861423221
2008,GEORGIA,DAWSON,1632,100,8242,9974,0.1636254261078805,0.8263485061159014,0.010026067776218167
2008,GEORGIA,DECATUR,4424,60,5890,10374,0.42645074224021595,0.5677655677655677,0.00578368999421631
2008,GEORGIA,DEKALB,254594,2126,65581,322301,0.7899261870115203,0.2034774946401035,0.0065963183483762075
2008,GEORGIA,DODGE,2595,74,5543,8212,0.3160009741841208,0.67498782269849,0.009011203117389186
2008,GEORGIA,DOOLY,2138,31,1991,4160,0.5139423076923076,0.47860576923076925,0.007451923076923077
2008,GEORGIA,DOUGHERTY,26135,164,12547,38846,0.6727848427122484,0.3229933583895382,0.004221798898213458
2008,GEORGIA,DOUGLAS,27825,446,26812,55083,0.5051467784979031,0.4867563495089229,0.008096871993173937
2008,GEORGIA,EARLY,2603,21,2711,5335,0.4879100281162137,0.5081537019681349,0.003936269915651359
2008,GEORGIA,ECHOLS,201,5,981,1187,0.16933445661331087,0.8264532434709352,0.004212299915754001
2008,GEORGIA,EFFINGHAM,4936,150,15230,20316,0.24296121283717267,0.7496554439850365,0.007383343177790904
2008,GEORGIA,ELBERT,3366,83,4868,8317,0.40471323794637487,0.5853072021161476,0.009979559937477456
2008,GEORGIA,EMANUEL,3068,64,5110,8242,0.3722397476340694,0.6199951468090269,0.007765105556903664
2008,GEORGIA,EVANS,1374,19,2462,3855,0.35642023346303503,0.638651102464332,0.004928664072632944
2008,GEORGIA,FANNIN,2611,166,7807,10584,0.2466931216931217,0.7376228269085412,0.015684051398337114
2008,GEORGIA,FAYETTE,20313,507,38501,59321,0.34242511083764604,0.6490281687766558,0.008546720385698151
2008,GEORGIA,FLOYD,10691,390,23132,34213,0.31248355888112705,0.6761172653669658,0.01139917575190717
2008,GEORGIA,FORSYTH,15406,804,59166,75376,0.20438866482700063,0.7849448100191042,0.01066652515389514
2008,GEORGIA,FRANKLIN,1914,90,6069,8073,0.23708658491267187,0.7517651430694909,0.011148272017837236
2008,GEORGIA,FULTON,272000,3492,130136,405628,0.6705651483625391,0.32082597848274774,0.008608873154713186
2008,GEORGIA,GILMER,2614,127,8408,11149,0.23446048973002062,0.7541483541124765,0.011391156157502915
2008,GEORGIA,GLASCOCK,210,16,1202,1428,0.14705882352941177,0.8417366946778712,0.011204481792717087
2008,GEORGIA,GLYNN,12676,186,20479,33341,0.3801925557121862,0.6142287273926996,0.0055787168951141235
2008,GEORGIA,GORDON,4268,226,13113,17607,0.24240358948145624,0.7447606065769297,0.01283580394161413
2008,GEORGIA,GRADY,3539,51,5775,9365,0.37789642285104114,0.6166577682861719,0.005445808862786973
2008,GEORGIA,GREENE,3339,48,4532,7919,0.4216441469882561,0.572294481626468,0.006061371385275919
2008,GEORGIA,GWINNETT,129025,2376,158746,290147,0.44468838209597206,0.5471226654075348,0.008188952496493157
2008,GEORGIA,HABERSHAM,2900,142,11766,14808,0.19584008643976228,0.7945705024311183,0.009589411129119395
2008,GEORGIA,HALL,14457,509,44962,59928,0.24123948738486184,0.750266987051128,0.008493525564010146
2008,GEORGIA,HANCOCK,3535,14,795,4344,0.8137661141804788,0.1830110497237569,0.0032228360957642726
2008,GEORGIA,HARALSON,2248,191,8658,11097,0.20257727313688384,0.7802108678021087,0.01721185906100748
2008,GEORGIA,HARRIS,4184,76,10648,14908,0.28065468204990607,0.7142473839549235,0.005097933995170378
2008,GEORGIA,HART,3365,100,6537,10002,0.3364327134573085,0.6535692861427714,0.009998000399920015
2008,GEORGIA,HEARD,1042,50,3133,4225,0.24662721893491124,0.7415384615384616,0.011834319526627219
2008,GEORGIA,HENRY,40527,587,47115,88229,0.45933876616531977,0.5340080925772706,0.0066531412574096956
2008,GEORGIA,HOUSTON,22094,445,33392,55931,0.39502243836155265,0.5970213298528544,0.007956231785592963
2008,GEORGIA,IRWIN,1197,26,2605,3828,0.3126959247648903,0.6805120167189133,0.006792058516196447
2008,GEORGIA,JACKSON,4950,234,17776,22960,0.21559233449477352,0.7742160278745644,0.01019163763066202
2008,GEORGIA,JASPER,1935,53,3916,5904,0.3277439024390244,0.6632791327913279,0.008976964769647697
2008,GEORGIA,JEFF DAVIS,1356,55,3867,5278,0.25691549829480864,0.7326638878363017,0.010420613868889731
2008,GEORGIA,JEFFERSON,4149,24,3061,7234,0.5735416090682887,0.4231407243572021,0.0033176665745092617
2008,GEORGIA,JENKINS,1482,22,1936,3440,0.4308139534883721,0.5627906976744186,0.006395348837209302
2008,GEORGIA,JOHNSON,1198,23,2426,3647,0.3284891691801481,0.6652042774883465,0.006306553331505347
2008,GEORGIA,JONES,4572,84,7782,12438,0.3675832127351664,0.6256632899179932,0.006753497346840328
2008,GEORGIA,LAMAR,2752,63,4873,7688,0.35796045785639957,0.6338449531737773,0.008194588969823101
2008,GEORGIA,LANIER,1062,24,1787,2873,0.3696484510964149,0.6219979115906717,0.008353637312913331
2008,GEORGIA,LAURENS,7769,116,12052,19937,0.3896774840748357,0.6045041881928074,0.005818327732356924
2008,GEORGIA,LEE,3100,62,9925,13087,0.23687628944754335,0.7583861847635057,0.0047375257889508676
2008,GEORGIA,LIBERTY,10474,74,5828,16376,0.6395945285784074,0.3558866634098681,0.004518808011724475
2008,GEORGIA,LINCOLN,1650,35,2731,4416,0.3736413043478261,0.6184329710144928,0.00792572463768116
2008,GEORGIA,LONG,1288,43,2119,3450,0.37333333333333335,0.6142028985507246,0.012463768115942029
2008,GEORGIA,LOWNDES,17651,293,21296,39240,0.4498216106014271,0.5427115188583078,0.007466870540265035
2008,GEORGIA,LUMPKIN,2586,163,8326,11075,0.23349887133182845,0.751783295711061,0.01471783295711061
2008,GEORGIA,MACON,3251,21,1712,4984,0.6522873194221509,0.3434991974317817,0.004213483146067416
2008,GEORGIA,MADISON,2965,174,8226,11365,0.2608886933567972,0.7238011438627364,0.015310162780466345
2008,GEORGIA,MARION,1381,35,1772,3188,0.43318695106649935,0.5558343789209536,0.010978670012547051
2008,GEORGIA,MCDUFFIE,3989,155,5400,9544,0.41795892707460186,0.5658005029337804,0.01624056999161777
2008,GEORGIA,MCINTOSH,2905,49,3282,6236,0.4658434894162925,0.5262989095574085,0.00785760102629891
2008,GEORGIA,MERIWETHER,4465,57,4982,9504,0.4698021885521885,0.5242003367003367,0.005997474747474747
2008,GEORGIA,MILLER,818,21,1899,2738,0.2987582176771366,0.6935719503287071,0.007669831994156318
2008,GEORGIA,MITCHELL,3872,47,4201,8120,0.4768472906403941,0.5173645320197044,0.005788177339901478
2008,GEORGIA,MONROE,4106,92,7933,12131,0.33847168411507705,0.6539444398648092,0.0075838760201137586
2008,GEORGIA,MONTGOMERY,1045,24,2521,3590,0.29108635097493035,0.7022284122562674,0.006685236768802228
2008,GEORGIA,MORGAN,3091,73,5987,9151,0.33777729209922414,0.6542454376570866,0.007977270243689214
2008,GEORGIA,MURRAY,3026,176,8180,11382,0.26585837286944297,0.7186786153575822,0.015463011772974872
2008,GEORGIA,MUSCOGEE,44158,339,29568,74065,0.5962060352393168,0.39921690407074867,0.004577060689934517
2008,GEORGIA,NEWTON,20827,271,20337,41435,0.5026426933751659,0.4908169421986244,0.006540364426209726
2008,GEORGIA,OCONEE,4825,187,12120,17132,0.28163670324538875,0.7074480504319403,0.010915246322671025
2008,GEORGIA,OGLETHORPE,2232,71,4144,6447,0.34620753838994883,0.6427795874049945,0.011012874205056615
2008,GEORGIA,PAULDING,17229,564,39192,56985,0.30234272176888655,0.6877599368254804,0.00989734140563306
2008,GEORGIA,PEACH,5927,65,5173,11165,0.5308553515450067,0.4633228840125392,0.005821764442454098
2008,GEORGIA,PICKENS,2595,187,10004,12786,0.20295635851712812,0.7824182699827937,0.014625371500078211
2008,GEORGIA,PIERCE,1253,38,5500,6791,0.18450890884994847,0.809895449860109,0.005595641289942571
2008,GEORGIA,PIKE,1575,81,6547,8203,0.1920029257588687,0.7981226380592467,0.009874436181884676
2008,GEORGIA,POLK,4052,211,9850,14113,0.2871111740948062,0.697938071281797,0.014950754623396869
2008,GEORGIA,PULASKI,1377,23,2553,3953,0.34834303060966354,0.6458386035922085,0.0058183657981280045
2008,GEORGIA,PUTNAM,3102,64,5966,9132,0.3396846254927727,0.6533070521243978,0.00700832238282961
2008,GEORGIA,QUITMAN,597,8,509,1114,0.5359066427289049,0.45691202872531417,0.00718132854578097
2008,GEORGIA,RABUN,2001,111,5487,7599,0.2633241215949467,0.7220686932491117,0.014607185155941572
2008,GEORGIA,RANDOLPH,1833,12,1370,3215,0.570139968895801,0.4261275272161742,0.0037325038880248835
2008,GEORGIA,RICHMOND,52100,391,26842,79333,0.6567254484262539,0.33834595943680434,0.004928592136941752
2008,GEORGIA,ROCKDALE,20526,259,16921,37706,0.5443695963507135,0.4487614703230255,0.006868933326261073
2008,GEORGIA,SCHLEY,479,7,1252,1738,0.2756041426927503,0.7203682393555811,0.004027617951668585
2008,GEORGIA,SCREVEN,3024,34,3423,6481,0.4665946613176979,0.5281592346860052,0.005246103996296868
2008,GEORGIA,SEMINOLE,1660,21,2315,3996,0.41541541541541543,0.5793293293293293,0.005255255255255256
2008,GEORGIA,SPALDING,10141,229,14885,25255,0.401544248663631,0.5893882399524847,0.00906751138388438
2008,GEORGIA,STEPHENS,2705,123,7689,10517,0.25720262432252544,0.7311020252923838,0.011695350385090805
2008,GEORGIA,STEWART,1305,17,783,2105,0.6199524940617577,0.3719714964370546,0.008076009501187649
2008,GEORGIA,SUMTER,6454,64,5717,12235,0.5275030649775235,0.46726604004903965,0.005230894973436861
2008,GEORGIA,TALBOT,2369,30,1301,3700,0.6402702702702703,0.35162162162162164,0.008108108108108109
2008,GEORGIA,TALIAFERRO,643,8,339,990,0.6494949494949495,0.3424242424242424,0.00808080808080808
2008,GEORGIA,TATTNALL,1932,52,4730,6714,0.2877569258266309,0.7044980637473935,0.0077450104259755735
2008,GEORGIA,TAYLOR,1536,26,2021,3583,0.4286910410270723,0.564052469997209,0.007256488975718672
2008,GEORGIA,TELFAIR,1862,26,2486,4374,0.4256973022405121,0.5683584819387288,0.00594421582075903
2008,GEORGIA,TERRELL,2501,25,1890,4416,0.5663496376811594,0.4279891304347826,0.005661231884057971
2008,GEORGIA,THOMAS,7720,97,10642,18459,0.41822417249038407,0.5765209382956823,0.005254889213933582
2008,GEORGIA,TIFT,4749,77,9431,14257,0.3330995300554114,0.6614996142245915,0.005400855719997194
2008,GEORGIA,TOOMBS,2964,66,6658,9688,0.3059454995871181,0.6872419488026424,0.006812551610239472
2008,GEORGIA,TOWNS,1391,56,4292,5739,0.24237672068304583,0.7478654817912528,0.009757797525701342
2008,GEORGIA,TREUTLEN,1112,16,1826,2954,0.3764387271496276,0.6181448882870684,0.005416384563303994
2008,GEORGIA,TROUP,10455,182,15391,26028,0.4016828031350853,0.5913247272168434,0.006992469648071308
2008,GEORGIA,TURNER,1427,30,2096,3553,0.4016324233042499,0.5899240078806642,0.008443568815085843
2008,GEORGIA,TWIGGS,2402,30,2087,4519,0.5315335251161761,0.46182783801726046,0.006638636866563399
2008,GEORGIA,UNION,2486,135,8013,10634,0.2337784464923829,0.753526424675569,0.012695128832048147
2008,GEORGIA,UPSON,4061,69,7291,11421,0.3555730671569915,0.6383854303476053,0.006041502495403204
2008,GEORGIA,WALKER,6095,337,17110,23542,0.2588989890408631,0.7267861693993714,0.014314841559765526
2008,GEORGIA,WALTON,8469,304,27253,36026,0.2350802198412258,0.7564814300782768,0.008438350080497418
2008,GEORGIA,WARE,4034,71,8311,12416,0.32490335051546393,0.6693782216494846,0.005718427835051546
2008,GEORGIA,WARREN,1554,19,1087,2660,0.5842105263157895,0.40864661654135337,0.007142857142857143
2008,GEORGIA,WASHINGTON,4607,40,4216,8863,0.519801421640528,0.4756854338260183,0.004513144533453684
2008,GEORGIA,WAYNE,2858,101,7601,10560,0.2706439393939394,0.7197916666666667,0.009564393939393939
2008,GEORGIA,WEBSTER,515,8,588,1111,0.46354635463546356,0.5292529252925292,0.0072007200720072
2008,GEORGIA,WHEELER,794,8,1408,2210,0.3592760180995475,0.63710407239819,0.0036199095022624436
2008,GEORGIA,WHITE,2174,120,8467,10761,0.2020258340302946,0.7868227859864325,0.01115137998327293
2008,GEORGIA,WHITFIELD,8167,280,19230,27677,0.2950825595259602,0.6948007370741048,0.010116703399934965
2008,GEORGIA,WILCOX,978,26,2159,3163,0.3092001264622194,0.6825798292760038,0.008220044261776794
2008,GEORGIA,WILKES,2315,32,2705,5052,0.4582343626286619,0.5354315122723674,0.006334125098970704
2008,GEORGIA,WILKINSON,2298,26,2349,4673,0.4917611812540124,0.5026749411512946,0.0055638775946929165
2008,GEORGIA,WORTH,2542,48,5780,8370,0.3037037037037037,0.6905615292712067,0.005734767025089606
2008,HAWAII,HAWAII,50819,1231,14866,66916,0.7594446769083627,0.22215912487297507,0.018396198218662202
2008,HAWAII,HONOLULU,214239,4410,88164,306813,0.6982722374866775,0.28735418642625965,0.014373576087062804
2008,HAWAII,KAUAI,20416,563,6245,27224,0.7499265354099324,0.22939318248604174,0.02068028210402586
2008,HAWAII,MAUI,39727,908,11154,51789,0.7670933982119755,0.2153739211029369,0.01753268068508757
2008,IDAHO,ADA,82236,3838,93328,179402,0.4583895385781652,0.5202171659178827,0.02139329550395202
2008,IDAHO,ADAMS,728,75,1517,2320,0.3137931034482759,0.6538793103448276,0.032327586206896554
2008,IDAHO,BANNOCK,14792,957,19356,35105,0.42136447799458765,0.5513744480843185,0.02726107392109386
2008,IDAHO,BEAR LAKE,502,64,2377,2943,0.17057424396873938,0.8076792388718994,0.021746517159361198
2008,IDAHO,BENEWAH,1407,111,2646,4164,0.33789625360230546,0.6354466858789626,0.026657060518731988
2008,IDAHO,BINGHAM,4424,501,12230,17155,0.25788399883415913,0.7129116875546488,0.029204313611192072
2008,IDAHO,BLAINE,6947,185,3439,10571,0.6571752908901712,0.3253239996216063,0.017500709488222497
2008,IDAHO,BOISE,1240,100,2433,3773,0.32865094089583885,0.6448449509673999,0.026504108136761198
2008,IDAHO,BONNER,7840,562,11145,19547,0.4010845654064562,0.5701642195733361,0.028751215020207704
2008,IDAHO,BONNEVILLE,11417,952,29334,41703,0.27376927319377503,0.7034026329041076,0.022828093902117354
2008,IDAHO,BOUNDARY,1484,171,3078,4733,0.31354320726811746,0.6503274878512572,0.03612930488062539
2008,IDAHO,BUTTE,318,36,1056,1410,0.225531914893617,0.7489361702127659,0.02553191489361702
2008,IDAHO,CAMAS,187,9,422,618,0.30258899676375406,0.6828478964401294,0.014563106796116505
2008,IDAHO,CANYON,20147,1347,42752,64246,0.31359150764249916,0.6654422065186938,0.020966285838807084
2008,IDAHO,CARIBOU,553,93,2656,3302,0.16747425802543914,0.8043609933373713,0.028164748637189582
2008,IDAHO,CASSIA,1332,201,6309,7842,0.16985462892119357,0.8045141545524102,0.025631216526396328
2008,IDAHO,CLARK,64,6,305,375,0.17066666666666666,0.8133333333333334,0.016
2008,IDAHO,CLEARWATER,1211,126,2569,3906,0.3100358422939068,0.6577060931899642,0.03225806451612903
2008,IDAHO,CUSTER,611,47,1694,2352,0.25977891156462585,0.7202380952380952,0.019982993197278913
2008,IDAHO,ELMORE,2591,180,5665,8436,0.30713608345187293,0.6715267899478425,0.021337126600284494
2008,IDAHO,FRANKLIN,600,227,4246,5073,0.11827321111768184,0.8369800906761286,0.04474669820618963
2008,IDAHO,FREMONT,1065,115,4700,5880,0.18112244897959184,0.7993197278911565,0.0195578231292517
2008,IDAHO,GEM,2166,196,5585,7947,0.2725556813892035,0.7027809236189757,0.02466339499182081
2008,IDAHO,GOODING,1489,137,3765,5391,0.27620107586718606,0.6983861992209237,0.025412724911890186
2008,IDAHO,IDAHO,2017,298,5895,8210,0.2456760048721072,0.718026796589525,0.036297198538367846
2008,IDAHO,JEFFERSON,1641,260,8540,10441,0.1571688535580883,0.8179293171152189,0.024901829326692847
2008,IDAHO,JEROME,1794,156,4897,6847,0.26201256024536296,0.7152037388637359,0.022783700890901124
2008,IDAHO,KOOTENAI,22120,1425,38387,61932,0.35716592391655366,0.619824969321191,0.023009106762255378
2008,IDAHO,LATAH,9195,531,7988,17714,0.5190809529185955,0.4509427571412442,0.029976289940160324
2008,IDAHO,LEMHI,1061,106,2938,4105,0.2584652862362972,0.7157125456760048,0.02582216808769793
2008,IDAHO,LEWIS,479,50,1275,1804,0.2655210643015521,0.7067627494456763,0.02771618625277162
2008,IDAHO,LINCOLN,545,93,1232,1870,0.2914438502673797,0.6588235294117647,0.04973262032085562
2008,IDAHO,MADISON,1627,299,11131,13057,0.12460749023512292,0.8524929156774144,0.022899594087462664
2008,IDAHO,MINIDOKA,1630,173,5087,6890,0.2365747460087083,0.7383164005805515,0.025108853410740203
2008,IDAHO,NEZ PERCE,7123,343,10357,17823,0.39965213488189416,0.5811030690680581,0.01924479605004769
2008,IDAHO,ONEIDA,381,57,1724,2162,0.17622571692876965,0.7974098057354302,0.026364477335800184
2008,IDAHO,OWYHEE,944,90,3024,4058,0.23262690980778708,0.7451946771808773,0.022178413011335635
2008,IDAHO,PAYETTE,2415,210,5988,8613,0.28039010797631486,0.6952281435040055,0.024381748519679555
2008,IDAHO,POWER,1027,61,1754,2842,0.3613652357494722,0.6171710063335679,0.021463757916959886
2008,IDAHO,SHOSHONE,2521,192,2953,5666,0.4449346981997882,0.5211789622308507,0.0338863395693611
2008,IDAHO,TETON,2302,93,2263,4658,0.4942035208243882,0.4858308286818377,0.01996565049377415
2008,IDAHO,TWIN FALLS,8621,691,19032,28344,0.3041560824160316,0.6714648602878917,0.02437905729607677
2008,IDAHO,VALLEY,2405,119,2772,5296,0.45411631419939574,0.5234138972809668,0.022469788519637462
2008,IDAHO,WASHINGTON,1241,97,3168,4506,0.275410563692854,0.7030625832223701,0.021526853084775855
2008,ILLINOIS,ADAMS,11794,318,18711,30823,0.3826363429906239,0.6070466859163611,0.010316971093014956
2008,ILLINOIS,ALEXANDER,2189,56,1692,3937,0.556007112014224,0.4297688595377191,0.014224028448056897
2008,ILLINOIS,BOND,3843,134,3947,7924,0.48498233215547704,0.4981070166582534,0.01691065118626956
2008,ILLINOIS,BOONE,11333,421,10403,22157,0.5114862120323148,0.46951302071580087,0.01900076725188428
2008,ILLINOIS,BROWN,986,39,1544,2569,0.3838069287660568,0.6010120669521214,0.01518100428182172
2008,ILLINOIS,BUREAU,8889,313,7911,17113,0.5194296733477474,0.46228013790685446,0.018290188745398235
2008,ILLINOIS,CALHOUN,1423,55,1221,2699,0.5272323082623194,0.4523897739903668,0.02037791774731382
2008,ILLINOIS,CARROLL,3965,113,3596,7674,0.5166796976804795,0.46859525671097213,0.014725045608548345
2008,ILLINOIS,CASS,2690,101,2617,5408,0.4974112426035503,0.4839127218934911,0.01867603550295858
2008,ILLINOIS,CHAMPAIGN,48597,1675,33871,84143,0.577552499910866,0.4025409124942063,0.019906587594927683
2008,ILLINOIS,CHRISTIAN,6918,310,7872,15100,0.45814569536423844,0.5213245033112582,0.02052980132450331
2008,ILLINOIS,CLARK,3742,137,4409,8288,0.451496138996139,0.5319739382239382,0.01652992277992278
2008,ILLINOIS,CLAY,2425,103,3926,6454,0.37573597768825534,0.6083049271769445,0.015959095134800125
2008,ILLINOIS,CLINTON,7657,300,9357,17314,0.44224327134111124,0.5404297100612221,0.017327018597666628
2008,ILLINOIS,COLES,11716,382,10978,23076,0.5077136418790085,0.47573236262783847,0.01655399549315306
2008,ILLINOIS,COOK,1629024,20706,487736,2137466,0.7621286139756142,0.22818421439218214,0.00968717163220374
2008,ILLINOIS,CRAWFORD,3883,176,5070,9129,0.42534779274838425,0.5553729871837003,0.019279220067915433
2008,ILLINOIS,CUMBERLAND,2055,110,3156,5321,0.386205600451043,0.5931215936853975,0.02067280586355948
2008,ILLINOIS,DE WITT,3308,145,4348,7801,0.4240481989488527,0.5573644404563517,0.01858736059479554
2008,ILLINOIS,DEKALB,25784,768,18266,44818,0.5753045651300817,0.40755946271587307,0.017135972154045248
2008,ILLINOIS,DOUGLAS,3228,123,5005,8356,0.38630923887027285,0.5989707994255624,0.014719961704164673
2008,ILLINOIS,DUPAGE,228698,5649,183626,417973,0.5471597447682027,0.4393250281716762,0.013515227060121109
2008,ILLINOIS,EDGAR,3743,114,4398,8255,0.4534221683827983,0.5327680193821926,0.013809812235009085
2008,ILLINOIS,EDWARDS,1140,73,2137,3350,0.3402985074626866,0.637910447761194,0.021791044776119404
2008,ILLINOIS,EFFINGHAM,5262,250,11323,16835,0.3125631125631126,0.6725868725868726,0.01485001485001485
2008,ILLINOIS,FAYETTE,3967,214,5499,9680,0.40981404958677686,0.5680785123966943,0.022107438016528924
2008,ILLINOIS,FORD,2227,80,4079,6386,0.3487316003758221,0.6387409959285938,0.01252740369558409
2008,ILLINOIS,FRANKLIN,8880,357,9404,18641,0.47636929349283835,0.5044793734241725,0.01915133308298911
2008,ILLINOIS,FULTON,9732,340,6251,16323,0.5962139312626356,0.38295656435704223,0.020829504380322245
2008,ILLINOIS,GALLATIN,1587,60,1212,2859,0.5550891920251836,0.42392444910807975,0.02098635886673662
2008,ILLINOIS,GREENE,2619,135,3053,5807,0.45100740485620805,0.5257447907697607,0.02324780437403134
2008,ILLINOIS,GRUNDY,11063,421,10687,22171,0.49898516079563393,0.48202607009156107,0.018988769112805014
2008,ILLINOIS,HAMILTON,1796,115,2353,4264,0.42120075046904315,0.551829268292683,0.026969981238273922
2008,ILLINOIS,HANCOCK,4141,167,5161,9469,0.43732178688351464,0.5450417150702291,0.017636498046256204
2008,ILLINOIS,HARDIN,892,33,1330,2255,0.39556541019955654,0.5898004434589801,0.014634146341463415
2008,ILLINOIS,HENDERSON,2215,58,1541,3814,0.5807551127425276,0.40403775563712635,0.015207131620346093
2008,ILLINOIS,HENRY,13181,341,11263,24785,0.5318135969336292,0.4544280815009078,0.013758321565462982
2008,ILLINOIS,IROQUOIS,4643,258,8695,13596,0.3414974992644896,0.6395263312739041,0.018976169461606355
2008,ILLINOIS,JACKSON,15248,597,9687,25532,0.5972113426288579,0.37940623531254897,0.023382422058593137
2008,ILLINOIS,JASPER,2063,104,2964,5131,0.40206587409861627,0.5776651724809978,0.02026895342038589
2008,ILLINOIS,JEFFERSON,7462,377,9302,17141,0.4353304941368648,0.5426754565077884,0.02199404935534683
2008,ILLINOIS,JERSEY,5042,212,5329,10583,0.4764244543135217,0.5035434186903525,0.020032126996125863
2008,ILLINOIS,JO DAVIESS,6403,177,5170,11750,0.544936170212766,0.44,0.015063829787234043
2008,ILLINOIS,JOHNSON,1871,118,3912,5901,0.31706490425351636,0.6629384850025419,0.019996610743941705
2008,ILLINOIS,KANE,106756,2580,83963,193299,0.5522842849678478,0.4343685171677039,0.013347197864448341
2008,ILLINOIS,KANKAKEE,24750,739,22527,48016,0.5154531822725759,0.4691561146284572,0.01539070309896701
2008,ILLINOIS,KENDALL,24742,509,21380,46631,0.5305912375887285,0.45849327700456777,0.010915485406703694
2008,ILLINOIS,KNOX,14191,378,9419,23988,0.591587460396865,0.39265466066366517,0.015757878939469734
2008,ILLINOIS,LAKE,177242,3318,118545,299105,0.5925745139666673,0.3963323916350445,0.011093094398288227
2008,ILLINOIS,LASALLE,27443,870,21872,50185,0.5468367041944804,0.4358274384776328,0.017335857327886818
2008,ILLINOIS,LAWRENCE,3016,117,3403,6536,0.4614443084455324,0.5206548347613219,0.017900856793145657
2008,ILLINOIS,LEE,7765,295,8258,16318,0.47585488417698246,0.5060669199656821,0.018078195857335458
2008,ILLINOIS,LIVINGSTON,6189,245,9191,15625,0.396096,0.588224,0.01568
2008,ILLINOIS,LOGAN,5250,217,7429,12896,0.4071029776674938,0.5760700992555832,0.016826923076923076
2008,ILLINOIS,MACON,25487,781,24948,51216,0.49763745704467355,0.48711340206185566,0.01524914089347079
2008,ILLINOIS,MACOUPIN,12090,392,9891,22373,0.5403834979662987,0.4420953828275153,0.017521119206186028
2008,ILLINOIS,MADISON,68979,2178,57177,128334,0.5374959091121605,0.4455327504792183,0.016971340408621253
2008,ILLINOIS,MARION,8345,328,8691,17364,0.4805920294862935,0.5005183137525916,0.01888965676111495
2008,ILLINOIS,MARSHALL,3081,107,3145,6333,0.4864992894362861,0.49660508447813045,0.01689562608558345
2008,ILLINOIS,MASON,3542,125,3141,6808,0.5202702702702703,0.4613689776733255,0.01836075205640423
2008,ILLINOIS,MASSAC,2693,122,4371,7186,0.3747564709156694,0.6082660729195658,0.01697745616476482
2008,ILLINOIS,MCDONOUGH,6783,204,6055,13042,0.5200889434135869,0.4642692838521699,0.015641772734243213
2008,ILLINOIS,MCHENRY,72288,2135,64845,139268,0.5190567826061981,0.4656130625843697,0.015330154809432174
2008,ILLINOIS,MCLEAN,37689,1294,36767,75750,0.49754455445544554,0.4853729372937294,0.017082508250825083
2008,ILLINOIS,MENARD,2706,86,3672,6464,0.4186262376237624,0.568069306930693,0.013304455445544554
2008,ILLINOIS,MERCER,4887,128,3833,8848,0.5523282097649186,0.4332052441229656,0.014466546112115732
2008,ILLINOIS,MONROE,7953,249,9881,18083,0.43980534203395455,0.5464248188906708,0.013769839075374662
2008,ILLINOIS,MONTGOMERY,6491,230,6150,12871,0.5043120192681221,0.4778183513324528,0.017869629399425064
2008,ILLINOIS,MORGAN,7467,295,7591,15353,0.4863544584120367,0.49443105581970953,0.019214485768253763
2008,ILLINOIS,MOULTRIE,2668,121,3471,6260,0.42619808306709267,0.5544728434504792,0.019329073482428114
2008,ILLINOIS,OGLE,11253,453,13144,24850,0.4528370221327968,0.528933601609658,0.018229376257545272
2008,ILLINOIS,PEORIA,45906,1219,34579,81704,0.5618574366004112,0.4232228532262802,0.014919710173308528
2008,ILLINOIS,PERRY,4701,208,5086,9995,0.4703351675837919,0.5088544272136069,0.0208104052026013
2008,ILLINOIS,PIATT,3859,149,4991,8999,0.4288254250472275,0.5546171796866318,0.01655739526614068
2008,ILLINOIS,PIKE,3024,135,4457,7616,0.39705882352941174,0.5852153361344538,0.017725840336134453
2008,ILLINOIS,POPE,845,43,1343,2231,0.3787539220080681,0.601972209771403,0.01927386822052891
2008,ILLINOIS,PULASKI,1638,39,1593,3270,0.5009174311926605,0.4871559633027523,0.011926605504587157
2008,ILLINOIS,PUTNAM,1900,59,1378,3337,0.5693736889421637,0.4129457596643692,0.017680551393467185
2008,ILLINOIS,RANDOLPH,7395,269,7538,15202,0.48644915142744377,0.4958558084462571,0.01769504012629917
2008,ILLINOIS,RICHLAND,3181,140,4329,7650,0.41581699346405226,0.5658823529411765,0.018300653594771243
2008,ILLINOIS,ROCK ISLAND,42210,827,25364,68401,0.6170962412830222,0.37081329220333037,0.01209046651364746
2008,ILLINOIS,SALINE,5083,246,6099,11428,0.4447847392369618,0.533689184459223,0.02152607630381519
2008,ILLINOIS,SANGAMON,51300,1583,46945,99828,0.5138838802740714,0.4702588452137677,0.015857274512160915
2008,ILLINOIS,SCHUYLER,1900,90,1833,3823,0.4969918911849333,0.4794663876536751,0.02354172116139158
2008,ILLINOIS,SCOTT,1090,55,1455,2600,0.41923076923076924,0.5596153846153846,0.021153846153846155
2008,ILLINOIS,SHELBY,4245,227,6396,10868,0.3905962458594038,0.5885167464114832,0.02088700772911299
2008,ILLINOIS,ST. CLAIR,76160,1626,47958,125744,0.6056750222674641,0.3813939432497773,0.01293103448275862
2008,ILLINOIS,STARK,1357,37,1513,2907,0.46680426556587545,0.52046783625731,0.012727898176814585
2008,ILLINOIS,STEPHENSON,11349,347,9909,21605,0.5252950705855126,0.458643832446193,0.016061096968294376
2008,ILLINOIS,TAZEWELL,29384,1223,33247,63854,0.46017477370250887,0.5206721583612617,0.019153067936229524
2008,ILLINOIS,UNION,3918,195,5003,9116,0.42979376919701623,0.5488152698551997,0.021390960947784116
2008,ILLINOIS,VERMILION,16246,572,16054,32872,0.49422000486736434,0.4883791676807009,0.01740082745193478
2008,ILLINOIS,WABASH,2462,66,3254,5782,0.425804219993082,0.5627810446212383,0.011414735385679695
2008,ILLINOIS,WARREN,4286,106,3637,8029,0.5338149209116951,0.4529829368539046,0.0132021422344003
2008,ILLINOIS,WASHINGTON,3342,117,4473,7932,0.42133131618759456,0.5639183055975794,0.014750378214826021
2008,ILLINOIS,WAYNE,2547,134,5390,8071,0.3155742782802627,0.6678230702515178,0.016602651468219553
2008,ILLINOIS,WHITE,3315,151,3987,7453,0.4447873339594794,0.5349523681738897,0.02026029786663089
2008,ILLINOIS,WHITESIDE,15607,416,10883,26906,0.5800564929755445,0.4044822716122798,0.015461235412175723
2008,ILLINOIS,WILL,160406,3417,122597,286420,0.5600377068640459,0.42803226031701697,0.011930032818937225
2008,ILLINOIS,WILLIAMSON,12914,520,17387,30821,0.4190000324454106,0.5641283540443204,0.016871613510268973
2008,ILLINOIS,WINNEBAGO,70034,2111,53886,126031,0.5556886797692632,0.4275614729709357,0.01674984725980116
2008,ILLINOIS,WOODFORD,6999,293,12191,19483,0.35923625724991015,0.6257249910178104,0.015038751732279422
2008,INDIANA,ADAMS,4928,181,8404,13513,0.3646858580626064,0.6219196329460519,0.013394508991341671
2008,INDIANA,ALLEN,71263,1268,77793,150324,0.474062691253559,0.5175021952582421,0.008435113488198824
2008,INDIANA,BARTHOLOMEW,13567,409,17067,31043,0.43703894597815934,0.549785781013433,0.013175273008407692
2008,INDIANA,BENTON,1563,68,2183,3814,0.40980597797587837,0.5723649711588883,0.01782905086523335
2008,INDIANA,BLACKFORD,2677,74,2690,5441,0.4920051461128469,0.4943944127917662,0.013600441095386877
2008,INDIANA,BOONE,9752,273,16622,26647,0.3659699028033174,0.6237850414680827,0.010245055728599843
2008,INDIANA,BROWN,3854,141,4060,8055,0.47846058348851644,0.5040347610180013,0.017504655493482308
2008,INDIANA,CARROLL,3736,142,4858,8736,0.42765567765567764,0.5560897435897436,0.016254578754578756
2008,INDIANA,CASS,7011,296,8346,15653,0.4479013607615154,0.5331885261611192,0.01891011307736536
2008,INDIANA,CLARK,21953,446,25326,47725,0.45998952331063386,0.5306652697747511,0.009345206914614981
2008,INDIANA,CLAY,4954,174,6267,11395,0.43475208424747697,0.549978060552874,0.015269855199648968
2008,INDIANA,CLINTON,5307,166,6919,12392,0.42826016785022597,0.5583440929632021,0.013395739186571982
2008,INDIANA,CRAWFORD,2286,65,2393,4744,0.48187183811129847,0.5044266441821248,0.01370151770657673
2008,INDIANA,DAVIESS,3370,118,7098,10586,0.3183449839410542,0.6705082184016625,0.011146797657283204
2008,INDIANA,DEARBORN,7123,208,14886,22217,0.3206103434307062,0.6700274564522662,0.009362200117027502
2008,INDIANA,DECATUR,3892,147,6449,10488,0.3710907704042716,0.6148932112890922,0.014016018306636156
2008,INDIANA,DEKALB,7175,194,9780,17149,0.4183917429587731,0.5702956440608782,0.011312612980348708
2008,INDIANA,DELAWARE,28384,563,20916,49863,0.569239716824098,0.41946934600806207,0.011290937167839882
2008,INDIANA,DUBOIS,8748,291,9526,18565,0.4712092647454888,0.5131160786426071,0.01567465661190412
2008,INDIANA,ELKHART,31398,664,39396,71458,0.43939097091998097,0.5513168574547287,0.00929217162529038
2008,INDIANA,FAYETTE,4389,156,4917,9462,0.463855421686747,0.5196575776791376,0.016487000634115408
2008,INDIANA,FLOYD,16263,317,19957,36537,0.4451104359963872,0.5462134274844678,0.008676136519144976
2008,INDIANA,FOUNTAIN,3094,158,4158,7410,0.41754385964912283,0.5611336032388664,0.021322537112010796
2008,INDIANA,FRANKLIN,3404,188,7018,10610,0.3208294062205467,0.6614514608859566,0.017719132893496702
2008,INDIANA,FULTON,3702,157,5147,9006,0.4110592938041306,0.5715078836331334,0.017432822562735952
2008,INDIANA,GIBSON,6455,191,8449,15095,0.4276250414044386,0.5597217621729049,0.012653196422656509
2008,INDIANA,GRANT,11293,272,14734,26299,0.4294079622799346,0.5602494391421727,0.010342598577892695
2008,INDIANA,GREENE,5709,229,7691,13629,0.4188861985472155,0.5643113948198694,0.016802406632915108
2008,INDIANA,HAMILTON,49704,959,78401,129064,0.38511126262939316,0.6074583152544474,0.007430422116159425
2008,INDIANA,HANCOCK,11874,371,22008,34253,0.3466557673780399,0.6425130645490906,0.01083116807286953
2008,INDIANA,HARRISON,7288,252,10551,18091,0.4028522469736333,0.5832181747830413,0.01392957824332541
2008,INDIANA,HENDRICKS,24548,679,39728,64955,0.3779231775844816,0.6116234316064968,0.01045339080902163
2008,INDIANA,HENRY,10059,364,10896,21319,0.47183263755335614,0.5110933908719921,0.01707397157465172
2008,INDIANA,HOWARD,17871,505,20248,38624,0.46269159072079535,0.5242336371168186,0.01307477216238608
2008,INDIANA,HUNTINGTON,5843,194,10291,16328,0.3578515433610975,0.6302670259676629,0.011881430671239588
2008,INDIANA,JACKSON,7354,294,9726,17374,0.4232761597789801,0.559802002992978,0.016921837228041903
2008,INDIANA,JASPER,5044,162,7669,12875,0.39176699029126216,0.5956504854368933,0.01258252427184466
2008,INDIANA,JAY,3748,166,4401,8315,0.4507516536380036,0.5292844257366206,0.019963920625375827
2008,INDIANA,JEFFERSON,6255,182,7053,13490,0.4636767976278725,0.5228317272053373,0.013491475166790215
2008,INDIANA,JENNINGS,5312,266,6261,11839,0.44868654447166145,0.5288453416673705,0.022468113860967986
2008,INDIANA,JOHNSON,21553,604,36487,58644,0.3675226792169702,0.622177886910852,0.010299433872177887
2008,INDIANA,KNOX,7569,216,8639,16424,0.460849975645397,0.5259985387238189,0.013151485630784217
2008,INDIANA,KOSCIUSKO,9236,410,20488,30134,0.3064976438574368,0.6798964624676446,0.013605893674918696
2008,INDIANA,LAGRANGE,3663,126,5702,9491,0.3859445790749131,0.6007796860183332,0.013275734906753767
2008,INDIANA,LAKE,139301,1714,67742,208757,0.6672878035227561,0.32450169335639045,0.008210503120853432
2008,INDIANA,LAPORTE,28258,743,17918,46919,0.6022720006820265,0.38189219719090345,0.015835802127070055
2008,INDIANA,LAWRENCE,7208,308,11018,18534,0.3889068738534585,0.5944750188842128,0.016618107262328694
2008,INDIANA,MADISON,30152,785,26403,57340,0.525845831880014,0.46046389954656436,0.013690268573421696
2008,INDIANA,MARION,241987,3062,134313,379362,0.6378788597698241,0.3540496939598589,0.008071446270317006
2008,INDIANA,MARSHALL,7889,255,10406,18550,0.4252830188679245,0.5609703504043126,0.013746630727762802
2008,INDIANA,MARTIN,1706,75,3122,4903,0.34795023455027535,0.6367530083622273,0.015296757087497451
2008,INDIANA,MIAMI,5564,237,8312,14113,0.3942464394529866,0.5889605328420605,0.01679302770495288
2008,INDIANA,MONROE,41450,647,21118,63215,0.6556988056632128,0.33406628173692954,0.01023491259985763
2008,INDIANA,MONTGOMERY,6013,212,9060,15285,0.39339221458946677,0.592737978410206,0.013869807000327118
2008,INDIANA,MORGAN,10330,352,18129,28811,0.3585436118149318,0.6292388323904065,0.012217555794661761
2008,INDIANA,NEWTON,2625,119,3301,6045,0.43424317617866004,0.5460711331679073,0.019685690653432588
2008,INDIANA,NOBLE,7064,237,9673,16974,0.41616590078944266,0.5698715682809002,0.013962530929657123
2008,INDIANA,OHIO,1158,47,1713,2918,0.3968471555860178,0.5870459218642906,0.01610692254969157
2008,INDIANA,ORANGE,3390,160,4536,8086,0.4192431362849369,0.5609695770467474,0.01978728666831561
2008,INDIANA,OWEN,3570,185,4415,8170,0.4369645042839657,0.5403916768665851,0.022643818849449205
2008,INDIANA,PARKE,2924,131,3909,6964,0.4198736358414704,0.5613153360137851,0.0188110281447444
2008,INDIANA,PERRY,5141,147,3202,8490,0.6055359246171967,0.37714958775029445,0.017314487632508833
2008,INDIANA,PIKE,2700,107,3221,6028,0.44790975447909753,0.5343397478433974,0.017750497677504976
2008,INDIANA,PORTER,39178,881,33857,73916,0.5300340927539369,0.4580469722387575,0.01191893500730559
2008,INDIANA,POSEY,5828,139,6804,12771,0.4563464098347819,0.53276955602537,0.010884034139848094
2008,INDIANA,PULASKI,2466,110,3388,5964,0.4134808853118712,0.568075117370892,0.018443997317236754
2008,INDIANA,PUTNAM,6334,226,8086,14646,0.43247303017888844,0.5520961354636078,0.015430834357503755
2008,INDIANA,RANDOLPH,4839,181,5788,10808,0.44772390821613617,0.5355292376017765,0.016746854182087344
2008,INDIANA,RIPLEY,4187,207,7794,12188,0.3435346242205448,0.6394814571709878,0.016983918608467347
2008,INDIANA,RUSH,3229,129,4271,7629,0.4232533752785424,0.5598374623148512,0.016909162406606372
2008,INDIANA,SCOTT,4271,161,4445,8877,0.48113101272952574,0.5007322293567646,0.018136757913709587
2008,INDIANA,SHELBY,6987,254,10333,17574,0.39757596449300103,0.5879708660521225,0.014453169454876522
2008,INDIANA,SPENCER,5039,141,5001,10181,0.4949415578037521,0.4912091150181711,0.01384932717807681
2008,INDIANA,ST. JOSEPH,68710,1169,48510,118389,0.5803748659081502,0.4097509059118668,0.009874228179982937
2008,INDIANA,STARKE,4778,215,4473,9466,0.5047538559053455,0.4725332769913374,0.022712867103317134
2008,INDIANA,STEUBEN,6284,188,7674,14146,0.4442245157641736,0.5424855082708893,0.013289975964937084
2008,INDIANA,SULLIVAN,4284,155,4343,8782,0.4878159872466409,0.4945342746526987,0.017649738100660443
2008,INDIANA,SWITZERLAND,1638,62,1940,3640,0.45,0.532967032967033,0.01703296703296703
2008,INDIANA,TIPPECANOE,37781,833,29822,68436,0.552063241568765,0.43576480215091473,0.0121719562803203
2008,INDIANA,TIPTON,3250,125,4452,7827,0.4152293343554363,0.5688003066308931,0.015970359013670627
2008,INDIANA,UNION,1224,63,2061,3348,0.3655913978494624,0.6155913978494624,0.01881720430107527
2008,INDIANA,VANDERBURGH,39423,721,37512,77656,0.507661996497373,0.4830534665705161,0.009284536932110848
2008,INDIANA,VERMILLION,4003,122,3010,7135,0.5610371408549404,0.42186405045550107,0.017098808689558515
2008,INDIANA,VIGO,25040,545,18121,43706,0.5729190500160161,0.41461126618770877,0.01246968379627511
2008,INDIANA,WABASH,5456,177,8238,13871,0.39333862014274384,0.5939009444164083,0.012760435440847812
2008,INDIANA,WARREN,1755,77,2166,3998,0.4389694847423712,0.5417708854427213,0.019259629814907454
2008,INDIANA,WARRICK,12329,323,16013,28665,0.430106401534973,0.5586255014826443,0.011268096982382696
2008,INDIANA,WASHINGTON,4562,224,6519,11305,0.40353825740822646,0.5766475011057054,0.019814241486068113
2008,INDIANA,WAYNE,13459,545,14558,28562,0.47122050276591276,0.509698200406134,0.019081296827953224
2008,INDIANA,WELLS,4403,166,8504,13073,0.3368010403120936,0.65050103266274,0.012697927025166374
2008,INDIANA,WHITE,4839,197,5731,10767,0.4494288102535525,0.5322745425838209,0.018296647162626543
2008,INDIANA,WHITLEY,5862,202,9124,15188,0.38596260205425337,0.6007374242823281,0.013299973663418488
2008,IOWA,ADAIR,1924,69,2060,4053,0.47471009129040215,0.5082654823587466,0.017024426350851222
2008,IOWA,ADAMS,1118,42,1046,2206,0.5067996373526745,0.4741613780598368,0.019038984587488667
2008,IOWA,ALLAMAKEE,3971,123,2965,7059,0.5625442697265902,0.4200311658875195,0.017424564385890354
2008,IOWA,APPANOOSE,2970,120,3086,6176,0.4808937823834197,0.4996761658031088,0.019430051813471502
2008,IOWA,AUDUBON,1739,62,1634,3435,0.506259097525473,0.47569141193595343,0.018049490538573507
2008,IOWA,BENTON,7058,207,6447,13712,0.5147316219369895,0.47017211201866976,0.015096266044340723
2008,IOWA,BLACK HAWK,39184,929,24662,64775,0.6049247394828252,0.380733307603242,0.014341952913932844
2008,IOWA,BOONE,7356,280,6293,13929,0.5281068274822314,0.45179122693660706,0.020101945581161604
2008,IOWA,BREMER,6940,190,5741,12871,0.5391966436174346,0.446041488617823,0.014761867764742444
2008,IOWA,BUCHANAN,6050,149,4139,10338,0.5852195782549816,0.4003675759334494,0.014412845811568969
2008,IOWA,BUENA VISTA,4075,120,4223,8418,0.4840817296269898,0.5016631028747921,0.014255167498218105
2008,IOWA,BUTLER,3364,102,3700,7166,0.46943901758303097,0.516327100195367,0.014233882221602009
2008,IOWA,CALHOUN,2341,113,2741,5195,0.45062560153994224,0.5276227141482195,0.021751684311838305
2008,IOWA,CARROLL,5302,163,4922,10387,0.5104457494945606,0.4738615577163762,0.015692692789063253
2008,IOWA,CASS,3211,133,4006,7350,0.4368707482993197,0.5450340136054421,0.018095238095238095
2008,IOWA,CEDAR,5221,155,4289,9665,0.54019658561821,0.44376616658044493,0.01603724780134506
2008,IOWA,CERRO GORDO,14405,360,9375,24140,0.5967274233637117,0.3883595691797846,0.014913007456503728
2008,IOWA,CHEROKEE,2890,103,3372,6365,0.4540455616653574,0.5297721916732129,0.016182246661429693
2008,IOWA,CHICKASAW,3923,103,2557,6583,0.5959289077927996,0.3884247303660945,0.01564636184110588
2008,IOWA,CLARKE,2218,107,2118,4443,0.49921224397929326,0.47670492910195816,0.024082826918748593
2008,IOWA,CLAY,3925,118,4355,8398,0.46737318409145034,0.5185758513931888,0.0140509645153608
2008,IOWA,CLAYTON,5195,143,3651,8989,0.5779285793747914,0.40616308821893427,0.015908332406274334
2008,IOWA,CLINTON,15018,377,9324,24719,0.6075488490634734,0.37719972490796555,0.015251426028561025
2008,IOWA,CRAWFORD,3715,131,3345,7191,0.5166179947156168,0.4651647893199833,0.018217215964399944
2008,IOWA,DALLAS,15149,537,16954,32640,0.4641237745098039,0.5194240196078431,0.01645220588235294
2008,IOWA,DAVIS,1680,106,2029,3815,0.44036697247706424,0.5318479685452162,0.027785058977719528
2008,IOWA,DECATUR,1986,96,2020,4102,0.4841540711847879,0.492442710872745,0.02340321794246709
2008,IOWA,DELAWARE,4649,139,4113,8901,0.5223008650713403,0.4620829120323559,0.015616222896303785
2008,IOWA,DES MOINES,12462,387,7721,20570,0.6058337384540593,0.3753524550315994,0.018813806514341273
2008,IOWA,DICKINSON,4625,119,5162,9906,0.4668887542903291,0.5210983242479306,0.012012921461740359
2008,IOWA,DUBUQUE,28611,691,18651,47953,0.5966467165766479,0.3889433403540967,0.014409943069255313
2008,IOWA,EMMET,2570,72,2373,5015,0.5124626121635095,0.4731804586241276,0.014356929212362911
2008,IOWA,FAYETTE,5908,146,4205,10259,0.5758845891412419,0.409884004288917,0.014231406569841116
2008,IOWA,FLOYD,4822,218,3051,8091,0.5959708317884068,0.3770856507230256,0.026943517488567544
2008,IOWA,FRANKLIN,2575,72,2501,5148,0.5001942501942502,0.4858197358197358,0.013986013986013986
2008,IOWA,FREMONT,1848,57,1989,3894,0.4745762711864407,0.5107858243451464,0.014637904468412942
2008,IOWA,GREENE,2371,84,2349,4804,0.49354704412989175,0.48896752706078267,0.017485428809325562
2008,IOWA,GRUNDY,2790,93,3945,6828,0.4086115992970123,0.577768014059754,0.013620386643233744
2008,IOWA,GUTHRIE,2625,148,3074,5847,0.44894817855310415,0.5257396955703779,0.025312125876517873
2008,IOWA,HAMILTON,4018,147,3913,8078,0.49740034662045063,0.48440207972270366,0.018197573656845753
2008,IOWA,HANCOCK,2805,109,3016,5930,0.4730185497470489,0.5086003372681281,0.018381112984822933
2008,IOWA,HARDIN,4393,151,4315,8859,0.4958798961508071,0.4870752906648606,0.017044813184332316
2008,IOWA,HARRISON,3555,114,3909,7578,0.4691211401425178,0.5158353127474268,0.015043547110055424
2008,IOWA,HENRY,4349,206,4822,9377,0.46379439053002025,0.5142369627812733,0.02196864668870641
2008,IOWA,HOWARD,2941,65,1722,4728,0.6220389170896785,0.36421319796954316,0.013747884940778343
2008,IOWA,HUMBOLDT,2160,67,2895,5122,0.4217102694260055,0.5652089027723546,0.013080827801639985
2008,IOWA,IDA,1454,57,2036,3547,0.409923879334649,0.5740062024245841,0.016069918240766846
2008,IOWA,IOWA,4202,156,4188,8546,0.49169201965831966,0.49005382635150946,0.01825415399017084
2008,IOWA,JACKSON,6102,180,3673,9955,0.6129583124058262,0.3689603214465093,0.01808136614766449
2008,IOWA,JASPER,10250,377,8794,19421,0.5277792080737346,0.4528088152000412,0.01941197672622419
2008,IOWA,JEFFERSON,5070,237,3324,8631,0.5874174487313173,0.38512339242266247,0.02745915884602016
2008,IOWA,JOHNSON,51027,1216,20732,72975,0.6992394655704008,0.28409729359369645,0.016663240835902707
2008,IOWA,JONES,5446,153,4405,10004,0.5443822471011596,0.44032387045181925,0.01529388244702119
2008,IOWA,KEOKUK,2518,131,2712,5361,0.4696884909531804,0.5058757694459989,0.024435739600820742
2008,IOWA,KOSSUTH,4625,143,4329,9097,0.5084093657249643,0.4758711663185666,0.015719467956469165
2008,IOWA,LEE,9821,341,7062,17224,0.5701927542963307,0.4100092893636786,0.01979795633999071
2008,IOWA,LINN,68037,1692,43626,113355,0.6002117242291914,0.3848617176128093,0.014926558157999205
2008,IOWA,LOUISA,2523,83,2314,4920,0.5128048780487805,0.47032520325203253,0.01686991869918699
2008,IOWA,LUCAS,2029,112,2330,4471,0.4538134645493178,0.5211362111384478,0.0250503243122344
2008,IOWA,LYON,1675,71,4471,6217,0.26942255106964774,0.7191571497506836,0.01142029917966865
2008,IOWA,MADISON,3733,168,4579,8480,0.4402122641509434,0.5399764150943396,0.01981132075471698
2008,IOWA,MAHASKA,4464,197,6271,10932,0.4083424807903403,0.5736370289059641,0.018020490303695572
2008,IOWA,MARION,7421,353,9256,17030,0.43576042278332355,0.5435114503816794,0.020728126834997064
2008,IOWA,MARSHALL,10023,356,8278,18657,0.5372246341855604,0.4436940558503511,0.019081309964088546
2008,IOWA,MILLS,2976,123,4183,7282,0.4086789343586927,0.574430101620434,0.016890964020873388
2008,IOWA,MITCHELL,3179,118,2469,5766,0.551335414498786,0.42819979188345475,0.02046479361775928
2008,IOWA,MONONA,2295,90,2411,4796,0.47852376980817346,0.5027105921601335,0.018765638031693076
2008,IOWA,MONROE,1798,75,2000,3873,0.46423960753937515,0.5163955589981926,0.019364833462432222
2008,IOWA,MONTGOMERY,2326,74,2887,5287,0.43994703990921125,0.5460563646680537,0.01399659542273501
2008,IOWA,MUSCATINE,10920,270,7929,19119,0.571159579475914,0.4147183430095716,0.014122077514514357
2008,IOWA,O'BRIEN,2338,101,4894,7333,0.3188326742124642,0.6673939724532933,0.013773353334242466
2008,IOWA,OSCEOLA,1037,63,2027,3127,0.3316277582347298,0.6482251359130157,0.020147105852254557
2008,IOWA,PAGE,2900,105,4351,7356,0.3942359978249048,0.5914899401848831,0.014274061990212071
2008,IOWA,PALO ALTO,2428,84,2294,4806,0.5052018310445276,0.4773200166458593,0.017478152309612985
2008,IOWA,PLYMOUTH,4629,118,7765,12512,0.36996483375959077,0.6206042199488491,0.009430946291560102
2008,IOWA,POCAHONTAS,1800,73,2138,4011,0.4487658937920718,0.5330341560708053,0.018199950137122913
2008,IOWA,POLK,120984,3734,89668,214386,0.5643278945453528,0.418254923362533,0.017417182092114222
2008,IOWA,POTTAWATTAMIE,20436,647,21237,42320,0.4828922495274102,0.5018194706994329,0.0152882797731569
2008,IOWA,POWESHIEK,5519,172,4340,10031,0.5501943973681587,0.43265875785066293,0.017146844781178346
2008,IOWA,RINGGOLD,1236,52,1401,2689,0.4596504276682782,0.5210115284492376,0.019338043882484196
2008,IOWA,SAC,2256,92,2705,5053,0.44646744508212943,0.5353255491787057,0.018207005739164853
2008,IOWA,SCOTT,48927,1079,36365,86371,0.5664748584594366,0.4210325224901877,0.012492619050375705
2008,IOWA,SHELBY,2863,102,3488,6453,0.4436696110336278,0.540523787385712,0.01580660158066016
2008,IOWA,SIOUX,3030,144,13490,16664,0.18182909265482478,0.8095295247239558,0.008641382621219395
2008,IOWA,STORY,26548,1032,18995,46575,0.5700053676865271,0.40783682232957597,0.02215780998389694
2008,IOWA,TAMA,4899,131,3820,8850,0.5535593220338983,0.43163841807909603,0.01480225988700565
2008,IOWA,TAYLOR,1347,72,1607,3026,0.44514210178453406,0.5310641110376735,0.023793787177792465
2008,IOWA,UNION,3000,128,2781,5909,0.5077001184633609,0.4706380098155356,0.021661871721103402
2008,IOWA,VAN BUREN,1546,76,1986,3608,0.4284922394678492,0.5504434589800443,0.02106430155210643
2008,IOWA,WAPELLO,8820,448,6663,15931,0.553637561986065,0.4182411650241667,0.028121272989768378
2008,IOWA,WARREN,12299,437,12144,24880,0.49433279742765274,0.48810289389067524,0.017564308681672025
2008,IOWA,WASHINGTON,5170,209,5247,10626,0.4865424430641822,0.4937888198757764,0.019668737060041408
2008,IOWA,WAYNE,1357,58,1565,2980,0.45536912751677855,0.5251677852348994,0.019463087248322148
2008,IOWA,WEBSTER,9917,300,8337,18554,0.5344939096690741,0.44933707017354746,0.016169020157378464
2008,IOWA,WINNEBAGO,3254,98,2730,6082,0.5350213745478462,0.4488655047681684,0.01611312068398553
2008,IOWA,WINNESHIEK,6829,178,4273,11280,0.6054078014184398,0.37881205673758866,0.01578014184397163
2008,IOWA,WOODBURY,21983,599,22219,44801,0.49068101158456284,0.49594875114394765,0.013370237271489475
2008,IOWA,WORTH,2567,78,1612,4257,0.6030068123091379,0.37867042518205307,0.018322762508809022
2008,IOWA,WRIGHT,3102,95,3198,6395,0.48506645817044564,0.5000781860828772,0.014855355746677092
2008,KANSAS,ALLEN,2189,114,3552,5855,0.373868488471392,0.6066609735269001,0.019470538001707942
2008,KANSAS,ANDERSON,1175,89,2362,3626,0.3240485383342526,0.6514065085493657,0.024544953116381687
2008,KANSAS,ATCHISON,3241,159,3791,7191,0.45070226672229174,0.5271867612293144,0.022110972048393827
2008,KANSAS,BARBER,598,31,1833,2462,0.24289195775792038,0.7445166531275386,0.012591389114541024
2008,KANSAS,BARTON,3027,228,7802,11057,0.27376322691507643,0.7056163516324501,0.020620421452473545
2008,KANSAS,BOURBON,2394,147,4240,6781,0.3530452735584722,0.6252765078896918,0.021678218551836013
2008,KANSAS,BROWN,1317,74,2985,4376,0.3009597806215722,0.6821297989031079,0.016910420475319928
2008,KANSAS,BUTLER,9159,559,18155,27873,0.3285975675384781,0.6513471818605819,0.02005525060093998
2008,KANSAS,CHASE,383,25,976,1384,0.27673410404624277,0.7052023121387283,0.018063583815028903
2008,KANSAS,CHAUTAUQUA,401,33,1418,1852,0.21652267818574514,0.765658747300216,0.017818574514038878
2008,KANSAS,CHEROKEE,3594,185,5886,9665,0.3718572167615106,0.6090015519917227,0.019141231246766685
2008,KANSAS,CHEYENNE,323,27,1148,1498,0.21562082777036048,0.7663551401869159,0.018024032042723633
2008,KANSAS,CLARK,245,17,897,1159,0.21138912855910266,0.7739430543572045,0.014667817083692839
2008,KANSAS,CLAY,1009,47,2998,4054,0.24888998519980265,0.7395165268870252,0.011593487913172176
2008,KANSAS,CLOUD,1233,97,3121,4451,0.277016400808807,0.7011907436531116,0.02179285553808133
2008,KANSAS,COFFEY,1121,57,3054,4232,0.2648865784499055,0.7216446124763705,0.013468809073724008
2008,KANSAS,COMANCHE,194,15,765,974,0.19917864476386038,0.7854209445585215,0.015400410677618069
2008,KANSAS,COWLEY,5012,283,8492,13787,0.3635308624066149,0.6159425545804018,0.020526583012983244
2008,KANSAS,CRAWFORD,7957,383,7735,16075,0.4949922239502333,0.48118195956454124,0.023825816485225505
2008,KANSAS,DECATUR,343,16,1189,1548,0.22157622739018087,0.7680878552971576,0.0103359173126615
2008,KANSAS,DICKINSON,2422,164,6081,8667,0.27945079035421716,0.7016268605053652,0.018922349140417676
2008,KANSAS,DONIPHAN,1115,77,2372,3564,0.3128507295173962,0.6655443322109988,0.021604938271604937
2008,KANSAS,DOUGLAS,34398,1071,17929,53398,0.6441814300161055,0.3357616390126971,0.02005693097119742
2008,KANSAS,EDWARDS,333,29,995,1357,0.24539425202652912,0.7332350773765659,0.021370670596904937
2008,KANSAS,ELK,363,29,1042,1434,0.25313807531380755,0.7266387726638772,0.020223152022315203
2008,KANSAS,ELLIS,4010,230,8207,12447,0.3221659837711898,0.6593556680324576,0.018478348196352534
2008,KANSAS,ELLSWORTH,851,66,2021,2938,0.28965282505105516,0.6878829135466303,0.0224642614023145
2008,KANSAS,FINNEY,3275,153,6926,10354,0.3163028781147383,0.668920224067993,0.014776897817268689
2008,KANSAS,FORD,2991,143,5730,8864,0.3374323104693141,0.6464350180505415,0.016132671480144405
2008,KANSAS,FRANKLIN,4433,227,7079,11739,0.37763012181616834,0.6030326262884402,0.01933725189539143
2008,KANSAS,GEARY,3491,111,4492,8094,0.43130714109216706,0.554978996787744,0.013713862120088955
2008,KANSAS,GOVE,261,21,1136,1418,0.18406205923836388,0.8011283497884344,0.014809590973201692
2008,KANSAS,GRAHAM,325,38,1060,1423,0.22839072382290934,0.7449051300070274,0.026704146170063246
2008,KANSAS,GRANT,635,31,1995,2661,0.23863209319804585,0.7497181510710259,0.011649755730928222
2008,KANSAS,GRAY,436,40,1643,2119,0.2057574327512978,0.7753657385559226,0.018876828692779613
2008,KANSAS,GREELEY,151,3,591,745,0.20268456375838925,0.7932885906040269,0.004026845637583893
2008,KANSAS,GREENWOOD,622,38,1619,2279,0.27292672224659936,0.710399297937692,0.016673979815708645
2008,KANSAS,HAMILTON,233,19,844,1096,0.2125912408759124,0.7700729927007299,0.017335766423357664
2008,KANSAS,HARPER,736,61,1999,2796,0.2632331902718169,0.7149499284692418,0.021816881258941344
2008,KANSAS,HARVEY,6318,289,9006,15613,0.40466278101582015,0.5768270031384103,0.01851021584576955
2008,KANSAS,HASKELL,278,15,1277,1570,0.1770700636942675,0.813375796178344,0.009554140127388535
2008,KANSAS,HODGEMAN,211,20,865,1096,0.19251824817518248,0.7892335766423357,0.01824817518248175
2008,KANSAS,JACKSON,2308,134,3811,6253,0.3691028306412922,0.6094674556213018,0.021429713737406045
2008,KANSAS,JEFFERSON,3542,188,5220,8950,0.3957541899441341,0.5832402234636872,0.02100558659217877
2008,KANSAS,JEWELL,313,40,1231,1584,0.1976010101010101,0.7771464646464646,0.025252525252525252
2008,KANSAS,JOHNSON,127091,3714,152627,283432,0.44840032177030115,0.5384960060967005,0.01310367213299839
2008,KANSAS,KEARNY,309,14,1159,1482,0.20850202429149797,0.782051282051282,0.009446693657219974
2008,KANSAS,KINGMAN,963,98,2603,3664,0.26282751091703055,0.7104257641921398,0.026746724890829694
2008,KANSAS,KIOWA,200,23,912,1135,0.1762114537444934,0.8035242290748899,0.02026431718061674
2008,KANSAS,LABETTE,3839,191,5001,9031,0.42509135200974424,0.5537592736131104,0.021149374377145386
2008,KANSAS,LANE,193,20,814,1027,0.18792599805258034,0.7925998052580331,0.019474196689386564
2008,KANSAS,LEAVENWORTH,13255,545,16791,30591,0.43329737504494786,0.5488869275277042,0.017815697427347912
2008,KANSAS,LINCOLN,347,35,1204,1586,0.21878940731399749,0.7591424968474149,0.022068095838587643
2008,KANSAS,LINN,1425,106,3086,4617,0.30864197530864196,0.6683993935455924,0.02295863114576565
2008,KANSAS,LOGAN,225,28,1187,1440,0.15625,0.8243055555555555,0.019444444444444445
2008,KANSAS,LYON,5924,289,6698,12911,0.4588335527844474,0.5187824335837657,0.02238401363178685
2008,KANSAS,MARION,1801,99,4159,6059,0.2972437695989437,0.6864169004786268,0.016339329922429445
2008,KANSAS,MARSHALL,1784,95,3157,5036,0.35424940428911833,0.6268864177918984,0.01886417791898332
2008,KANSAS,MCPHERSON,4218,231,8937,13386,0.3151053339309727,0.6676378305692514,0.017256835499775885
2008,KANSAS,MEADE,357,34,1540,1931,0.18487830139823924,0.797514241325738,0.017607457276022784
2008,KANSAS,MIAMI,5742,253,9382,15377,0.3734148403459713,0.6101320153475971,0.016453144306431685
2008,KANSAS,MITCHELL,701,62,2440,3203,0.21885732126131752,0.7617858257883234,0.01935685295035904
2008,KANSAS,MONTGOMERY,4338,260,9309,13907,0.3119292442654778,0.6693751348241893,0.018695620910332927
2008,KANSAS,MORRIS,907,59,1875,2841,0.3192537838789159,0.6599788806758183,0.020767335445265753
2008,KANSAS,MORTON,229,20,1153,1402,0.16333808844507847,0.8223965763195435,0.014265335235378032
2008,KANSAS,NEMAHA,1432,110,3817,5359,0.26721403246874414,0.7122597499533495,0.020526217577906326
2008,KANSAS,NEOSHO,2563,156,4473,7192,0.35636818687430477,0.6219410456062291,0.021690767519466074
2008,KANSAS,NESS,289,29,1207,1525,0.18950819672131147,0.7914754098360656,0.01901639344262295
2008,KANSAS,NORTON,497,40,1878,2415,0.20579710144927535,0.7776397515527951,0.016563146997929608
2008,KANSAS,OSAGE,2534,190,4820,7544,0.33589607635206786,0.6389183457051962,0.02518557794273595
2008,KANSAS,OSBORNE,403,37,1490,1930,0.20880829015544042,0.772020725388601,0.01917098445595855
2008,KANSAS,OTTAWA,704,59,2323,3086,0.22812702527543746,0.7527543745949449,0.01911860012961763
2008,KANSAS,PAWNEE,882,51,1946,2879,0.30635637374088226,0.6759291420632164,0.017714484195901353
2008,KANSAS,PHILLIPS,525,37,2105,2667,0.1968503937007874,0.7892763404574428,0.013873265841769778
2008,KANSAS,POTTAWATOMIE,2599,309,6929,9837,0.2642065670427976,0.7043814170987089,0.031412015858493444
2008,KANSAS,PRATT,1294,74,2822,4190,0.3088305489260143,0.673508353221957,0.01766109785202864
2008,KANSAS,RAWLINS,273,29,1247,1549,0.1762427372498386,0.8050355067785668,0.01872175597159458
2008,KANSAS,RENO,9916,484,16112,26512,0.374019312009656,0.6077248038624019,0.018255884127942063
2008,KANSAS,REPUBLIC,640,53,1978,2671,0.23961063272182703,0.7405466117558966,0.019842755522276302
2008,KANSAS,RICE,1163,78,2780,4021,0.2892315344441681,0.6913703058940562,0.019398159661775678
2008,KANSAS,RILEY,10495,391,12111,22997,0.45636387354872376,0.5266339087707093,0.01700221768056703
2008,KANSAS,ROOKS,468,52,2068,2588,0.18083462132921174,0.7990726429675425,0.02009273570324575
2008,KANSAS,RUSH,504,52,1225,1781,0.28298708590679394,0.6878158338012352,0.029197080291970802
2008,KANSAS,RUSSELL,736,48,2509,3293,0.22350440327968418,0.7619192225933799,0.014576374126935925
2008,KANSAS,SALINE,8186,437,14165,22788,0.35922415306301564,0.6215990872388977,0.01917675969808671
2008,KANSAS,SCOTT,321,35,1823,2179,0.14731528223955942,0.8366223038090868,0.016062413951353834
2008,KANSAS,SEDGWICK,82337,3547,106849,192733,0.42720758769904477,0.5543887139202939,0.01840369838066133
2008,KANSAS,SEWARD,1493,52,3791,5336,0.2797976011994003,0.7104572713643178,0.009745127436281859
2008,KANSAS,SHAWNEE,41235,1466,41476,84177,0.4898606507715884,0.49272366560937075,0.01741568361904083
2008,KANSAS,SHERIDAN,254,14,1108,1376,0.18459302325581395,0.8052325581395349,0.010174418604651164
2008,KANSAS,SHERMAN,688,57,1959,2704,0.25443786982248523,0.7244822485207101,0.021079881656804734
2008,KANSAS,SMITH,446,39,1719,2204,0.20235934664246824,0.77994555353902,0.017695099818511795
2008,KANSAS,STAFFORD,542,37,1495,2074,0.26133076181292186,0.7208293153326905,0.017839922854387655
2008,KANSAS,STANTON,188,11,628,827,0.22732769044740025,0.7593712212817413,0.013301088270858524
2008,KANSAS,STEVENS,283,29,1815,2127,0.13305124588622472,0.8533145275035261,0.013634226610249177
2008,KANSAS,SUMNER,3353,247,6737,10337,0.3243687723710941,0.6517364806036567,0.023894747025249106
2008,KANSAS,THOMAS,787,49,2837,3673,0.21426626735638443,0.7723931391233324,0.013340593520283148
2008,KANSAS,TREGO,420,26,1225,1671,0.2513464991023339,0.7330939557151407,0.015559545182525433
2008,KANSAS,WABAUNSEE,1036,90,2395,3521,0.294234592445328,0.680204487361545,0.025560920193126953
2008,KANSAS,WALLACE,96,18,690,804,0.11940298507462686,0.8582089552238806,0.022388059701492536
2008,KANSAS,WASHINGTON,659,73,2248,2980,0.22114093959731543,0.7543624161073825,0.024496644295302013
2008,KANSAS,WICHITA,163,16,840,1019,0.15996074582924436,0.8243375858684985,0.015701668302257114
2008,KANSAS,WILSON,1170,101,2850,4121,0.28391167192429023,0.6915797136617325,0.02450861441397719
2008,KANSAS,WOODSON,512,32,1055,1599,0.32020012507817386,0.6597873671044403,0.020012507817385866
2008,KANSAS,WYANDOTTE,39865,798,16506,57169,0.6973184767968654,0.28872290926900945,0.013958613934125138
2008,KENTUCKY,ADAIR,1668,118,5512,7298,0.22855576870375446,0.7552754179227186,0.016168813373526995
2008,KENTUCKY,ALLEN,2024,108,5258,7390,0.27388362652232745,0.7115020297699594,0.014614343707713126
2008,KENTUCKY,ANDERSON,3462,205,6885,10552,0.32808946171341924,0.6524829416224412,0.0194275966641395
2008,KENTUCKY,BALLARD,1427,96,2537,4060,0.3514778325123153,0.6248768472906404,0.023645320197044337
2008,KENTUCKY,BARREN,5434,240,11133,16807,0.32331766525852323,0.6624025703575891,0.014279764383887665
2008,KENTUCKY,BATH,2210,99,2234,4543,0.48646268985252034,0.49174554259300024,0.021791767554479417
2008,KENTUCKY,BELL,2782,135,6681,9598,0.28985205251093976,0.6960825171910815,0.014065430297978746
2008,KENTUCKY,BOONE,16292,670,33812,50774,0.3208728876984283,0.66593138220349,0.013195730098081695
2008,KENTUCKY,BOURBON,3385,125,4820,8330,0.4063625450180072,0.5786314525810324,0.015006002400960384
2008,KENTUCKY,BOYD,8886,354,11430,20670,0.42989840348330915,0.5529753265602322,0.017126269956458634
2008,KENTUCKY,BOYLE,4769,165,7701,12635,0.3774436090225564,0.6094974277799763,0.013058963197467353
2008,KENTUCKY,BRACKEN,1241,92,2066,3399,0.36510738452486025,0.607825831126802,0.027066784348337748
2008,KENTUCKY,BREATHITT,2205,154,2671,5030,0.4383697813121272,0.531013916500994,0.03061630218687873
2008,KENTUCKY,BRECKINRIDGE,3110,131,5281,8522,0.3649378080262849,0.6196902135648908,0.015371978408824219
2008,KENTUCKY,BULLITT,10177,447,20102,30726,0.33121786109483825,0.6542341990496647,0.014547939855496973
2008,KENTUCKY,BUTLER,1555,56,3696,5307,0.29300923308837384,0.6964386659129451,0.010552100998680987
2008,KENTUCKY,CALDWELL,2212,121,3866,6199,0.35683174705597676,0.6236489756412325,0.019519277302790773
2008,KENTUCKY,CALLOWAY,6165,248,8991,15404,0.4002207218904181,0.5836795637496754,0.01609971435990652
2008,KENTUCKY,CAMPBELL,15622,629,24046,40297,0.3876715388242301,0.5967193587611981,0.015609102414571804
2008,KENTUCKY,CARLISLE,879,39,1699,2617,0.3358807795185327,0.6492166602980513,0.014902560183416125
2008,KENTUCKY,CARROLL,1716,87,2032,3835,0.44745762711864406,0.5298565840938723,0.0226857887874837
2008,KENTUCKY,CARTER,4316,245,5252,9813,0.4398247223071436,0.5352083970243554,0.024966880668500967
2008,KENTUCKY,CASEY,1219,59,4679,5957,0.20463320463320464,0.785462481114655,0.009904314252140339
2008,KENTUCKY,CHRISTIAN,8880,199,13699,22778,0.3898498551233647,0.6014136447449293,0.008736500131706033
2008,KENTUCKY,CLARK,5749,215,9664,15628,0.367865369848989,0.6183772715638597,0.013757358587151268
2008,KENTUCKY,CLAY,1552,102,5710,7364,0.21075502444323738,0.7753938077131993,0.013851167843563281
2008,KENTUCKY,CLINTON,761,45,3366,4172,0.1824065196548418,0.8068072866730585,0.010786193672099712
2008,KENTUCKY,CRITTENDEN,1254,72,2604,3930,0.3190839694656489,0.6625954198473283,0.0183206106870229
2008,KENTUCKY,CUMBERLAND,697,44,2056,2797,0.2491955666785842,0.735073292813729,0.015731140507686807
2008,KENTUCKY,DAVIESS,19282,648,23692,43622,0.4420246664527073,0.543120443812755,0.014854889734537618
2008,KENTUCKY,EDMONSON,1652,56,3562,5270,0.31347248576850095,0.6759013282732448,0.01062618595825427
2008,KENTUCKY,ELLIOTT,1535,78,902,2515,0.610337972166998,0.35864811133200797,0.031013916500994037
2008,KENTUCKY,ESTILL,1555,74,3685,5314,0.2926232593150169,0.6934512608204743,0.013925479864508844
2008,KENTUCKY,FAYETTE,66042,1713,59884,127639,0.5174123896301287,0.469166947406357,0.013420662963514286
2008,KENTUCKY,FLEMING,2279,121,3432,5832,0.3907750342935528,0.588477366255144,0.020747599451303157
2008,KENTUCKY,FLOYD,7530,388,7741,15659,0.480873619005045,0.49434829810332714,0.024778082891627817
2008,KENTUCKY,FRANKLIN,11767,401,11911,24079,0.4886830848457162,0.4946633996428423,0.016653515511441504
2008,KENTUCKY,FULTON,1238,57,1530,2825,0.4382300884955752,0.5415929203539823,0.020176991150442476
2008,KENTUCKY,GALLATIN,1278,75,1840,3193,0.4002505480739117,0.5762605699968681,0.02348888192922017
2008,KENTUCKY,GARRARD,2012,80,5118,7210,0.27905686546463243,0.7098474341192788,0.011095700416088766
2008,KENTUCKY,GRANT,3112,132,5510,8754,0.35549463102581674,0.6294265478638337,0.015078821110349555
2008,KENTUCKY,GRAVES,5843,256,10056,16155,0.36168368926029093,0.6224698235840297,0.015846487155679358
2008,KENTUCKY,GRAYSON,3154,144,6605,9903,0.31848934666262746,0.6669696051701505,0.014541048167222055
2008,KENTUCKY,GREEN,1204,90,3785,5079,0.23705453829493994,0.7452254380783618,0.01772002362669817
2008,KENTUCKY,GREENUP,6621,328,8849,15798,0.41910368401063425,0.5601341942017977,0.020762121787568047
2008,KENTUCKY,HANCOCK,2135,81,1928,4144,0.5152027027027027,0.46525096525096526,0.019546332046332045
2008,KENTUCKY,HARDIN,15650,444,23896,39990,0.3913478369592398,0.5975493873468367,0.011102775693923482
2008,KENTUCKY,HARLAN,2586,163,7165,9914,0.2608432519669155,0.722715352027436,0.01644139600564858
2008,KENTUCKY,HARRISON,2916,154,4520,7590,0.3841897233201581,0.5955204216073782,0.020289855072463767
2008,KENTUCKY,HART,2290,131,4397,6818,0.335875623349956,0.644910530947492,0.01921384570255207
2008,KENTUCKY,HENDERSON,10049,289,9523,19861,0.5059664669452696,0.47948240269875636,0.01455113035597402
2008,KENTUCKY,HENRY,2725,113,4081,6919,0.39384304090186445,0.589825119236884,0.016331839861251626
2008,KENTUCKY,HICKMAN,812,32,1406,2250,0.36088888888888887,0.6248888888888889,0.014222222222222223
2008,KENTUCKY,HOPKINS,7104,328,11916,19348,0.367169733305768,0.6158776100888981,0.016952656605333884
2008,KENTUCKY,JACKSON,743,74,4407,5224,0.1422281776416539,0.8436064318529862,0.014165390505359877
2008,KENTUCKY,JEFFERSON,196435,3500,153957,353892,0.5550704734777842,0.4350395035773626,0.009890022944853232
2008,KENTUCKY,JESSAMINE,6236,267,13711,20214,0.308499060057386,0.6782922726822994,0.013208667260314633
2008,KENTUCKY,JOHNSON,2407,162,5948,8517,0.2826112480920512,0.698367969942468,0.019020781965480803
2008,KENTUCKY,KENTON,26480,1019,40714,68213,0.38819579845484,0.5968657000864938,0.014938501458666237
2008,KENTUCKY,KNOTT,2612,138,3070,5820,0.44879725085910654,0.5274914089347079,0.023711340206185566
2008,KENTUCKY,KNOX,3074,165,8150,11389,0.2699095618579331,0.715602774607077,0.014487663534989903
2008,KENTUCKY,LARUE,1913,112,4153,6178,0.30964713499514407,0.6722240207186791,0.018128844286176757
2008,KENTUCKY,LAUREL,4618,222,17660,22500,0.20524444444444445,0.7848888888888889,0.009866666666666666
2008,KENTUCKY,LAWRENCE,2036,110,3503,5649,0.36041777305717826,0.6201097539387502,0.019472473004071518
2008,KENTUCKY,LEE,752,43,1978,2773,0.2711864406779661,0.7133068878470971,0.015506671474936892
2008,KENTUCKY,LESLIE,766,57,3574,4397,0.1742096884239254,0.8128269274505344,0.01296338412554014
2008,KENTUCKY,LETCHER,2623,245,5367,8235,0.31851851851851853,0.6517304189435337,0.029751062537947785
2008,KENTUCKY,LEWIS,1510,68,3213,4791,0.31517428511792944,0.6706324358171571,0.01419327906491338
2008,KENTUCKY,LINCOLN,2752,126,6273,9151,0.30073216041962625,0.685498852584417,0.013768986995956725
2008,KENTUCKY,LIVINGSTON,1622,81,2890,4593,0.35314609187894624,0.6292183757892446,0.017635532331809273
2008,KENTUCKY,LOGAN,3811,154,6925,10890,0.3499540863177227,0.6359044995408631,0.014141414141414142
2008,KENTUCKY,LYON,1577,58,2220,3855,0.40907911802853436,0.5758754863813229,0.015045395590142672
2008,KENTUCKY,MADISON,12392,451,19694,32537,0.38085871469404065,0.6052801426068783,0.013861142699081046
2008,KENTUCKY,MAGOFFIN,2105,112,2434,4651,0.4525908406794238,0.5233283164910771,0.024080842829499034
2008,KENTUCKY,MARION,3596,177,3842,7615,0.472225869993434,0.5045305318450427,0.02324359816152331
2008,KENTUCKY,MARSHALL,5683,292,9512,15487,0.36695292826241366,0.6141925485891393,0.018854523148447086
2008,KENTUCKY,MARTIN,808,60,2824,3692,0.218851570964247,0.7648970747562297,0.016251354279523293
2008,KENTUCKY,MASON,2891,128,4102,7121,0.4059823058559191,0.576042690633338,0.017975003510742875
2008,KENTUCKY,MCCRACKEN,11285,426,19043,30754,0.36694413734798725,0.6192040059829615,0.01385185666905118
2008,KENTUCKY,MCCREARY,1258,71,4078,5407,0.23266136489735528,0.7542075087849085,0.013131126317736268
2008,KENTUCKY,MCLEAN,1963,73,2386,4422,0.44391677973767524,0.5395748530076888,0.016508367254635913
2008,KENTUCKY,MEADE,4343,172,6691,11206,0.38756023558807784,0.5970908441906122,0.015348920221310012
2008,KENTUCKY,MENIFEE,1276,58,1155,2489,0.5126556850140619,0.4640417838489353,0.023302531137002813
2008,KENTUCKY,MERCER,3159,120,6781,10060,0.3140159045725646,0.6740556660039762,0.011928429423459244
2008,KENTUCKY,METCALFE,1350,115,2734,4199,0.32150512026673017,0.6511074065253631,0.027387473207906646
2008,KENTUCKY,MONROE,1067,61,3537,4665,0.2287245444801715,0.7581993569131833,0.01307609860664523
2008,KENTUCKY,MONTGOMERY,4234,150,5947,10331,0.40983447875326684,0.5756461136385636,0.014519407608169587
2008,KENTUCKY,MORGAN,1879,104,2396,4379,0.4290934003197077,0.5471568851335922,0.02374971454670016
2008,KENTUCKY,MUHLENBERG,6221,221,6447,12889,0.4826596322445496,0.5001939638451393,0.01714640391031112
2008,KENTUCKY,NELSON,7654,353,10139,18146,0.4218009478672986,0.5587457290863,0.019453323046401412
2008,KENTUCKY,NICHOLAS,1272,64,1634,2970,0.42828282828282827,0.5501683501683502,0.02154882154882155
2008,KENTUCKY,OHIO,4059,192,5687,9938,0.40843228013684846,0.5722479372107063,0.01931978265244516
2008,KENTUCKY,OLDHAM,10000,319,18997,29316,0.34111065629690274,0.6480079137672261,0.010881429935871196
2008,KENTUCKY,OWEN,1694,88,2969,4751,0.3565565144180173,0.6249210692485793,0.018522416333403496
2008,KENTUCKY,OWSLEY,381,26,1279,1686,0.22597864768683273,0.758600237247924,0.01542111506524318
2008,KENTUCKY,PENDLETON,2027,99,3676,5802,0.3493622888659083,0.6335746294381248,0.017063081695966906
2008,KENTUCKY,PERRY,3444,169,6762,10375,0.33195180722891565,0.6517590361445783,0.016289156626506023
2008,KENTUCKY,PIKE,9525,463,12655,22643,0.4206598065627346,0.5588923729187828,0.020447820518482533
2008,KENTUCKY,POWELL,2065,70,2837,4972,0.41532582461786,0.5705953338696702,0.01407884151246983
2008,KENTUCKY,PULASKI,5590,314,19862,25766,0.21695257315842584,0.7708608243421563,0.012186602499417838
2008,KENTUCKY,ROBERTSON,451,31,533,1015,0.44433497536945815,0.5251231527093596,0.030541871921182268
2008,KENTUCKY,ROCKCASTLE,1410,107,4757,6274,0.22473700988205292,0.7582084794389544,0.01705451067899267
2008,KENTUCKY,ROWAN,4074,173,3907,8154,0.49963208241353935,0.4791513367672308,0.021216580819229825
2008,KENTUCKY,RUSSELL,1569,127,5779,7475,0.20989966555183948,0.7731103678929766,0.016989966555183946
2008,KENTUCKY,SCOTT,7712,236,11782,19730,0.39087683730359857,0.5971616827166751,0.011961479979726306
2008,KENTUCKY,SHELBY,6871,218,11451,18540,0.3706040992448759,0.6176375404530744,0.011758360302049622
2008,KENTUCKY,SIMPSON,2775,97,4437,7309,0.37966890135449444,0.6070597893008619,0.01327130934464359
2008,KENTUCKY,SPENCER,2519,152,5378,8049,0.3129581314449,0.6681575350975276,0.01888433345757237
2008,KENTUCKY,TAYLOR,3165,127,7568,10860,0.2914364640883978,0.6968692449355433,0.011694290976058931
2008,KENTUCKY,TODD,1543,62,3336,4941,0.3122849625581866,0.6751669702489375,0.012548067192875935
2008,KENTUCKY,TRIGG,2246,92,4189,6527,0.34410908533782747,0.6417956182013176,0.01409529646085491
2008,KENTUCKY,TRIMBLE,1484,89,2239,3812,0.38929695697796435,0.5873557187827911,0.02334732423924449
2008,KENTUCKY,UNION,2804,110,3120,6034,0.4647000331455088,0.5170699370235333,0.018230029830957905
2008,KENTUCKY,WARREN,17669,483,25993,44145,0.40024917884245104,0.5888096047117454,0.010941216445803603
2008,KENTUCKY,WASHINGTON,1890,80,3305,5275,0.3582938388625592,0.6265402843601896,0.015165876777251185
2008,KENTUCKY,WAYNE,2201,127,4868,7196,0.3058643690939411,0.6764869371873263,0.01764869371873263
2008,KENTUCKY,WEBSTER,2390,113,3037,5540,0.4314079422382672,0.5481949458483755,0.0203971119133574
2008,KENTUCKY,WHITLEY,3484,205,10015,13704,0.2542323409223584,0.7308085230589609,0.014959136018680676
2008,KENTUCKY,WOLFE,1493,67,1408,2968,0.503032345013477,0.4743935309973046,0.02257412398921833
2008,KENTUCKY,WOODFORD,5027,140,7130,12297,0.40879889403919656,0.5798162153370741,0.011384890623729365
2008,LOUISIANA,ACADIA,7028,454,19228,26710,0.2631224260576563,0.7198801946836391,0.016997379258704606
2008,LOUISIANA,ALLEN,2891,243,6333,9467,0.3053765712474913,0.6689553184747016,0.02566811027780712
2008,LOUISIANA,ASCENSION,14625,707,31239,46571,0.314036632238947,0.6707822464623907,0.015181121298662257
2008,LOUISIANA,ASSUMPTION,4756,223,5981,10960,0.43394160583941604,0.5457116788321168,0.020346715328467154
2008,LOUISIANA,AVOYELLES,6327,375,10236,16938,0.37353878852284805,0.6043216436415161,0.022139567835635848
2008,LOUISIANA,BEAUREGARD,3071,285,10718,14074,0.21820378001989485,0.7615461134005969,0.020250106579508313
2008,LOUISIANA,BIENVILLE,3589,65,3776,7430,0.48304172274562585,0.5082099596231494,0.008748317631224764
2008,LOUISIANA,BOSSIER,12701,419,32706,45826,0.277157072404312,0.7136996464888927,0.009143281106795268
2008,LOUISIANA,CADDO,55220,895,52105,108220,0.5102568841249306,0.48147292552208465,0.00827019035298466
2008,LOUISIANA,CALCASIEU,30244,1438,50449,82131,0.3682409808720215,0.6142504048410466,0.017508614286931852
2008,LOUISIANA,CALDWELL,1118,79,3696,4893,0.22848967913345597,0.7553648068669528,0.016145513999591254
2008,LOUISIANA,CAMERON,613,95,3089,3797,0.16144324466684223,0.813537002897024,0.02501975243613379
2008,LOUISIANA,CATAHOULA,1659,80,3486,5225,0.317511961722488,0.667177033492823,0.015311004784688996
2008,LOUISIANA,CLAIBORNE,3025,66,3750,6841,0.4421868147931589,0.5481654728840812,0.00964771232275983
2008,LOUISIANA,CONCORDIA,3766,93,5668,9527,0.3952975753122704,0.5949406948672195,0.009761729820510129
2008,LOUISIANA,DE SOTO,5242,132,6883,12257,0.4276739822142449,0.5615566614995513,0.010769356286203803
2008,LOUISIANA,EAST BATON ROUGE,99652,2307,95390,197349,0.5049531540570259,0.48335689565186546,0.011689950291108645
2008,LOUISIANA,EAST CARROLL,2267,38,1254,3559,0.6369766788423714,0.3523461646529924,0.010677156504636133
2008,LOUISIANA,EAST FELICIANA,4383,132,5432,9947,0.4406353674474716,0.546094299788881,0.01327033276364733
2008,LOUISIANA,EVANGELINE,5853,330,9793,15976,0.3663620430645969,0.6129819729594391,0.020655983975963944
2008,LOUISIANA,FRANKLIN,2959,119,6278,9356,0.31626763574176997,0.6710132535271484,0.01271911073108166
2008,LOUISIANA,GRANT,1474,177,6906,8557,0.1722566319971953,0.8070585485567372,0.020684819446067548
2008,LOUISIANA,IBERIA,12492,549,20127,33168,0.37662807525325614,0.6068198263386396,0.016552098408104197
2008,LOUISIANA,IBERVILLE,9023,213,7185,16421,0.5494793252542476,0.43754947932525423,0.012971195420498143
2008,LOUISIANA,JACKSON,2456,90,5190,7736,0.31747673216132366,0.6708893485005171,0.011633919338159255
2008,LOUISIANA,JEFFERSON,65096,2833,113191,181120,0.3594081272084806,0.6249503091872791,0.015641563604240283
2008,LOUISIANA,JEFFERSON DAVIS,3923,300,9278,13501,0.2905710688097178,0.6872083549366713,0.022220576253610843
2008,LOUISIANA,LA SALLE,860,91,5602,6553,0.1312376010987334,0.8548756294826797,0.013886769418586907
2008,LOUISIANA,LAFAYETTE,32145,1442,62055,95642,0.33609711214738297,0.6488258296564271,0.01507705819618996
2008,LOUISIANA,LAFOURCHE,9662,1142,27089,37893,0.25498113107961895,0.7148813765075344,0.0301374924128467
2008,LOUISIANA,LINCOLN,8267,207,10676,19150,0.43169712793733683,0.5574934725848564,0.010809399477806788
2008,LOUISIANA,LIVINGSTON,6681,942,43269,50892,0.1312780004715869,0.850212214100448,0.0185097854279651
2008,LOUISIANA,MADISON,3100,48,2152,5300,0.5849056603773585,0.4060377358490566,0.009056603773584906
2008,LOUISIANA,MOREHOUSE,5792,150,7258,13200,0.4387878787878788,0.5498484848484848,0.011363636363636364
2008,LOUISIANA,NATCHITOCHES,7801,212,9054,17067,0.4570809163883518,0.5304974512216558,0.012421632389992382
2008,LOUISIANA,ORLEANS,116042,2204,28041,146287,0.79324888746095,0.1916848387074723,0.015066273831577652
2008,LOUISIANA,OUACHITA,24813,690,41741,67244,0.36899946463625005,0.6207393968235084,0.010261138540241509
2008,LOUISIANA,PLAQUEMINES,3380,175,6894,10449,0.32347593071107283,0.6597760551248923,0.016748014164034836
2008,LOUISIANA,POINTE COUPEE,5516,217,6702,12435,0.44358665058303176,0.538962605548854,0.017450743868114193
2008,LOUISIANA,RAPIDES,20127,783,36611,57521,0.34990699049042956,0.6364805896976756,0.013612419811894786
2008,LOUISIANA,RED RIVER,2080,65,2484,4629,0.44934111039101315,0.5366169799092677,0.014041909699719161
2008,LOUISIANA,RICHLAND,3311,119,5751,9181,0.3606360962858077,0.6264023526848927,0.01296155102929964
2008,LOUISIANA,SABINE,2245,181,7226,9652,0.23259428097803564,0.7486531288852052,0.01875259013675922
2008,LOUISIANA,ST. BERNARD,3491,407,9642,13540,0.25782865583456427,0.7121122599704579,0.030059084194977843
2008,LOUISIANA,ST. CHARLES,8522,418,16457,25397,0.3355514430838288,0.6479899200692996,0.01645863684687168
2008,LOUISIANA,ST. HELENA,3567,95,2522,6184,0.5768111254851229,0.4078266494178525,0.01536222509702458
2008,LOUISIANA,ST. JAMES,6994,138,5432,12564,0.5566698503661255,0.4323463865011143,0.010983763132760267
2008,LOUISIANA,ST. JOHN THE BAPTIST,12424,320,8912,21656,0.5736978204654599,0.4115256741780569,0.014776505356483192
2008,LOUISIANA,ST. LANDRY,20268,575,21650,42493,0.4769726778528228,0.5094956816416821,0.013531640505495022
2008,LOUISIANA,ST. MARTIN,9419,390,14443,24252,0.3883803397657925,0.5955385122876464,0.016081147946561108
2008,LOUISIANA,ST. MARY,9345,375,13183,22903,0.40802514954372787,0.5756014495917565,0.016373400864515567
2008,LOUISIANA,ST. TAMMANY,24589,1867,83047,109503,0.22455092554541883,0.7583993132608239,0.01704976119375725
2008,LOUISIANA,TANGIPAHOA,16438,730,31434,48602,0.33821653429900006,0.6467635076745812,0.015019958026418666
2008,LOUISIANA,TENSAS,1646,27,1367,3040,0.5414473684210527,0.44967105263157897,0.008881578947368421
2008,LOUISIANA,TERREBONNE,11579,905,28208,40692,0.2845522461417478,0.6932075100756906,0.022240243782561682
2008,LOUISIANA,UNION,3103,146,7619,10868,0.2855171144644829,0.701048951048951,0.013433934486566065
2008,LOUISIANA,VERMILION,6266,498,18069,24833,0.2523255345709338,0.7276205049732212,0.020053960455845045
2008,LOUISIANA,VERNON,3534,289,11946,15769,0.2241105967404401,0.7575623057898409,0.01832709746971907
2008,LOUISIANA,WASHINGTON,6122,287,12215,18624,0.3287156357388316,0.6558741408934707,0.015410223367697595
2008,LOUISIANA,WEBSTER,6610,243,11417,18270,0.36179529282977557,0.6249042145593869,0.013300492610837438
2008,LOUISIANA,WEST BATON ROUGE,5043,169,6654,11866,0.4249957862801281,0.5607618405528401,0.014242373167031856
2008,LOUISIANA,WEST CARROLL,878,64,4045,4987,0.17605775015039102,0.8111088830960498,0.012833366753559254
2008,LOUISIANA,WEST FELICIANA,2414,55,3149,5618,0.42969028123887504,0.5605197579209683,0.009789960840156639
2008,LOUISIANA,WINN,2047,93,4632,6772,0.3022740696987596,0.6839929119905493,0.01373301831069108
2008,MAINE,ANDROSCOGGIN,31017,1162,22671,54850,0.5654876937101185,0.4133272561531449,0.021185050136736553
2008,MAINE,AROOSTOOK,19345,751,15898,35994,0.537450686225482,0.4416847252319831,0.020864588542534868
2008,MAINE,CUMBERLAND,105218,2747,56186,164151,0.6409829973621848,0.3422824107072147,0.016734591930600482
2008,MAINE,FRANKLIN,10113,438,6627,17178,0.5887181278379322,0.38578414250785886,0.02549772965420887
2008,MAINE,HANCOCK,18895,584,12686,32165,0.5874397637183274,0.394403855122027,0.018156381159645577
2008,MAINE,KENNEBEC,37238,1266,27482,65986,0.5643318279635074,0.4164822841208741,0.019185887915618465
2008,MAINE,KNOX,13728,436,8816,22980,0.5973890339425587,0.3836379460400348,0.01897302001740644
2008,MAINE,LINCOLN,11886,411,9287,21584,0.5506856931060045,0.430272424017791,0.019041882876204595
2008,MAINE,MAINE UOCAVA,0,0,0,0,,,
2008,MAINE,OXFORD,17940,847,12863,31650,0.566824644549763,0.4064139020537125,0.026761453396524488
2008,MAINE,PENOBSCOT,41614,1358,37495,80467,0.5171561012589012,0.46596741521369006,0.01687648352740875
2008,MAINE,PISCATAQUIS,4430,219,4785,9434,0.46957812168751323,0.5072079711681153,0.023213907144371423
2008,MAINE,SAGADAHOC,12152,428,8721,21301,0.5704896483733158,0.40941739824421386,0.020092953382470306
2008,MAINE,SOMERSET,13335,556,11867,25758,0.5177032378290239,0.46071123534435904,0.021585526826616974
2008,MAINE,WALDO,11967,460,9423,21850,0.5476887871853547,0.43125858123569794,0.021052631578947368
2008,MAINE,WASHINGTON,8246,331,8077,16654,0.49513630359072897,0.48498859132941036,0.019875105079860695
2008,MAINE,YORK,64799,1973,42389,109161,0.5936094392686032,0.38831634008482885,0.018074220646567912
2008,MARYLAND,ALLEGANY,10693,644,18405,29742,0.35952525048752604,0.6188218680653621,0.02165288144711183
2008,MARYLAND,ANNE ARUNDEL,125015,4922,129682,259619,0.48153255347258866,0.4995088957279706,0.01895855079944072
2008,MARYLAND,BALTIMORE,214151,8073,158714,380938,0.5621675968267802,0.41663997815917553,0.02119242501404428
2008,MARYLAND,BALTIMORE CITY,214385,2902,28681,245968,0.8715971183243348,0.11660459897222403,0.011798282703441097
2008,MARYLAND,CALVERT,20299,663,23095,44057,0.4607440361350069,0.5242072769366957,0.015048686928297432
2008,MARYLAND,CAROLINE,4971,232,8015,13218,0.376078075351793,0.6063701013769103,0.017551823271296715
2008,MARYLAND,CARROLL,28060,2197,54503,84760,0.3310523831996225,0.6430273714016045,0.025920245398773006
2008,MARYLAND,CECIL,17665,974,23855,42494,0.41570574669365085,0.5613733703581683,0.02292088294818092
2008,MARYLAND,CHARLES,43635,760,25732,70127,0.6222282430447617,0.3669342763842742,0.010837480570964108
2008,MARYLAND,DORCHESTER,6912,194,8168,15274,0.45253371742830956,0.5347649600628519,0.012701322508838549
2008,MARYLAND,FREDERICK,54013,2003,55170,111186,0.48578957782454624,0.4961955641897361,0.018014857985717628
2008,MARYLAND,GARRETT,3736,233,8903,12872,0.29024238657551277,0.6916563082660038,0.01810130515848353
2008,MARYLAND,HARFORD,48552,2992,71751,123295,0.39378725820187355,0.5819457398921286,0.02426700190599781
2008,MARYLAND,HOWARD,87120,2720,55393,145233,0.59986366734833,0.38140780676568,0.0187285258859901
2008,MARYLAND,KENT,4953,162,4905,10020,0.494311377245509,0.48952095808383234,0.016167664670658683
2008,MARYLAND,MONTGOMERY,314444,6209,118608,439261,0.7158477533858002,0.2700171424278504,0.014135104186349346
2008,MARYLAND,PRINCE GEORGE'S,332396,2797,38833,374026,0.8886975771737794,0.10382433306775465,0.007478089758465989
2008,MARYLAND,QUEEN ANNE'S,8575,383,15087,24045,0.35662299854439594,0.6274485339987523,0.015928467456851735
2008,MARYLAND,SOMERSET,4779,108,5037,9924,0.48155985489721886,0.5075574365175333,0.010882708585247884
2008,MARYLAND,ST. MARY'S,19023,681,24705,44409,0.42835911639532526,0.5563061541579409,0.01533472944673377
2008,MARYLAND,TALBOT,9035,298,10995,20328,0.44446084218811494,0.5408795749704841,0.014659582841401023
2008,MARYLAND,WASHINGTON,26245,1186,34169,61600,0.4260551948051948,0.5546915584415585,0.019253246753246755
2008,MARYLAND,WICOMICO,19436,569,21849,41854,0.4643761647632245,0.5220289578057056,0.013594877431069909
2008,MARYLAND,WORCESTER,11374,365,15607,27346,0.415929203539823,0.5707233233379654,0.013347473122211658
2008,MASSACHUSETTS,BARNSTABLE,74264,2312,55694,132270,0.5614576245558328,0.42106297724351704,0.017479398200650184
2008,MASSACHUSETTS,BERKSHIRE,49558,1696,14876,66130,0.7494026916679268,0.22495085437774082,0.025646453954332377
2008,MASSACHUSETTS,BRISTOL,146861,5662,90597,243120,0.6040679499835472,0.3726431391905232,0.02328891082592958
2008,MASSACHUSETTS,DUKES,7913,198,2442,10553,0.7498341703780915,0.23140339240026533,0.018762437221643134
2008,MASSACHUSETTS,ESSEX,208976,7500,137189,353665,0.5908868562057314,0.3879066348097776,0.021206508984490974
2008,MASSACHUSETTS,FRANKLIN,27919,1085,9545,38549,0.7242470621806013,0.24760694181431425,0.02814599600508444
2008,MASSACHUSETTS,HAMPDEN,121454,5037,71350,197841,0.6138970183126854,0.3606431427257242,0.02545983896159037
2008,MASSACHUSETTS,HAMPSHIRE,56869,2083,20618,79570,0.7147040341837376,0.25911775794897574,0.026178207867286665
2008,MASSACHUSETTS,MIDDLESEX,464484,15778,245769,726031,0.639757806484847,0.3385103390902041,0.021731854424948797
2008,MASSACHUSETTS,NANTUCKET,4073,116,1863,6052,0.6730006609385327,0.30783212161269,0.019167217448777262
2008,MASSACHUSETTS,NORFOLK,200675,7500,136741,344916,0.5818083243456378,0.3964472509248629,0.021744424729499355
2008,MASSACHUSETTS,PLYMOUTH,131823,5104,112901,249828,0.527655026658341,0.4519149174632147,0.02043005587844437
2008,MASSACHUSETTS,SUFFOLK,207127,4900,57194,269221,0.7693567738029351,0.21244256577310092,0.018200660423963955
2008,MASSACHUSETTS,WORCESTER,202107,9377,152106,363590,0.5558651228031574,0.4183448389669683,0.02579003822987431
2008,MICHIGAN,ALCONA,2896,120,3404,6420,0.45109034267912773,0.5302180685358255,0.018691588785046728
2008,MICHIGAN,ALGER,2472,90,2188,4750,0.5204210526315789,0.46063157894736845,0.018947368421052633
2008,MICHIGAN,ALLEGAN,24165,1053,30061,55279,0.4371461133522676,0.543805061596628,0.019048825051104397
2008,MICHIGAN,ALPENA,7705,255,7125,15085,0.510772290354657,0.47232350016572755,0.01690420947961551
2008,MICHIGAN,ANTRIM,6079,267,7506,13852,0.43885359514871497,0.5418712099335836,0.019275194917701414
2008,MICHIGAN,ARENAC,4155,166,3807,8128,0.5111958661417323,0.468380905511811,0.02042322834645669
2008,MICHIGAN,BARAGA,1725,73,1846,3644,0.47338090010976946,0.5065861690450055,0.020032930845225026
2008,MICHIGAN,BARRY,13449,685,16431,30565,0.4400130868640602,0.537575658432848,0.02241125470309177
2008,MICHIGAN,BAY,32589,1044,23795,57428,0.5674757957790625,0.414344918854914,0.01817928536602354
2008,MICHIGAN,BENZIE,5451,171,4687,10309,0.5287612765544669,0.4546512755844408,0.016587447861092248
2008,MICHIGAN,BERRIEN,40381,1155,36130,77666,0.5199315015579533,0.46519712615558934,0.014871372286457395
2008,MICHIGAN,BRANCH,8413,338,9534,18285,0.46010391030899644,0.521410992616899,0.018485097074104458
2008,MICHIGAN,CALHOUN,34561,1082,28553,64196,0.5383668764408998,0.4447784908717054,0.016854632687394854
2008,MICHIGAN,CASS,12083,379,11114,23576,0.5125127248048863,0.4714116050220563,0.016075670173057346
2008,MICHIGAN,CHARLEVOIX,6817,244,7306,14367,0.4744901510405791,0.5085264843043085,0.01698336465511241
2008,MICHIGAN,CHEBOYGAN,6720,261,6920,13901,0.4834184591036616,0.49780591324365153,0.018775627652686856
2008,MICHIGAN,CHIPPEWA,8184,257,8267,16708,0.4898252334211156,0.49479291357433564,0.01538185300454872
2008,MICHIGAN,CLARE,7496,278,6793,14567,0.5145877668703234,0.46632800164755955,0.019084231482117114
2008,MICHIGAN,CLINTON,20005,650,19726,40381,0.4954062554171516,0.4884970654515738,0.01609667913127461
2008,MICHIGAN,CRAWFORD,3441,176,3561,7178,0.4793814432989691,0.49609919197548064,0.024519364725550292
2008,MICHIGAN,DELTA,9974,327,8763,19064,0.523185060847671,0.4596621905161561,0.01715274863617289
2008,MICHIGAN,DICKINSON,5995,267,7049,13311,0.45037938547066336,0.5295620163774322,0.02005859815190444
2008,MICHIGAN,EATON,30742,974,25900,57616,0.5335670647042489,0.4495279089141905,0.01690502638156068
2008,MICHIGAN,EMMET,8515,320,9314,18149,0.4691718551986335,0.5131963193564384,0.017631825444928095
2008,MICHIGAN,GENESEE,143927,3518,72451,219896,0.6545230472587041,0.3294784807363481,0.015998472004947792
2008,MICHIGAN,GLADWIN,6590,260,6391,13241,0.4976965485990484,0.4826674722452987,0.019635979155652895
2008,MICHIGAN,GOGEBIC,4757,177,3330,8264,0.5756292352371732,0.40295256534365925,0.021418199419167474
2008,MICHIGAN,GRAND TRAVERSE,23258,759,24716,48733,0.4772536063858166,0.5071717316807912,0.015574661933392157
2008,MICHIGAN,GRATIOT,9105,311,8322,17738,0.5133047694215808,0.46916225053557337,0.01753298004284587
2008,MICHIGAN,HILLSDALE,8765,463,11221,20449,0.42862731673920484,0.5487309892904298,0.0226416939703653
2008,MICHIGAN,HOUGHTON,7476,395,8101,15972,0.46806912096168296,0.5072001001753068,0.02473077886301027
2008,MICHIGAN,HURON,8367,334,8434,17135,0.48829880361832506,0.49220892909250075,0.019492267289174206
2008,MICHIGAN,INGHAM,93994,2252,46483,142729,0.6585487182002256,0.3256731287965305,0.015778153003243908
2008,MICHIGAN,IONIA,12565,598,14156,27319,0.4599363080639848,0.5181741645008968,0.021889527435118416
2008,MICHIGAN,IOSCO,7309,295,6583,14187,0.5151899626418552,0.46401635299922467,0.020793684358920136
2008,MICHIGAN,IRON,3080,135,2947,6162,0.49983771502758845,0.47825381369685166,0.021908471275559883
2008,MICHIGAN,ISABELLA,16679,451,11220,28350,0.5883245149911817,0.39576719576719577,0.015908289241622575
2008,MICHIGAN,JACKSON,37480,1331,35692,74503,0.5030669905909829,0.47906795699502036,0.017865052413996753
2008,MICHIGAN,KALAMAZOO,77051,2176,51554,130781,0.5891605049663178,0.3942009924989104,0.016638502534771872
2008,MICHIGAN,KALKASKA,3780,192,4527,8499,0.44475820684786443,0.5326509001058948,0.022590893046240734
2008,MICHIGAN,KENT,149909,4990,148336,303235,0.49436575593186805,0.48917836001780796,0.016455884050324006
2008,MICHIGAN,KEWEENAW,610,44,756,1410,0.4326241134751773,0.5361702127659574,0.031205673758865248
2008,MICHIGAN,LAKE,2919,104,2269,5292,0.5515873015873016,0.42876039304610736,0.019652305366591082
2008,MICHIGAN,LAPEER,21457,1074,22831,45362,0.4730170627397381,0.503306732507385,0.023676204752876857
2008,MICHIGAN,LEELANAU,7355,171,6938,14464,0.508503871681416,0.47967367256637167,0.011822455752212389
2008,MICHIGAN,LENAWEE,24640,869,22225,47734,0.5161939079063141,0.4656010390916328,0.018205053002053044
2008,MICHIGAN,LIVINGSTON,42349,1697,55592,99638,0.4250286035448323,0.5579397418655533,0.017031654589614403
2008,MICHIGAN,LUCE,1191,59,1490,2740,0.43467153284671534,0.5437956204379562,0.021532846715328468
2008,MICHIGAN,MACKINAC,3027,101,3268,6396,0.4732645403377111,0.5109443402126329,0.015791119449656034
2008,MICHIGAN,MACOMB,223784,7769,187663,419216,0.5338155032250678,0.44765228426395937,0.018532212510972864
2008,MICHIGAN,MANISTEE,7235,264,5510,13009,0.556153432239219,0.42355292489814744,0.020293642862633562
2008,MICHIGAN,MARQUETTE,19635,644,12906,33185,0.5916829893023957,0.3889106524031942,0.019406358294410127
2008,MICHIGAN,MASON,7817,259,7147,15223,0.5134993102542206,0.4694869605202654,0.017013729225514026
2008,MICHIGAN,MECOSTA,9101,325,9238,18664,0.48762323189027,0.49496356622374627,0.017413201885983713
2008,MICHIGAN,MENOMINEE,5981,236,4855,11072,0.5401914739884393,0.4384934971098266,0.021315028901734104
2008,MICHIGAN,MIDLAND,20701,743,22263,43707,0.4736312261193859,0.5093692085935891,0.01699956528702496
2008,MICHIGAN,MISSAUKEE,2898,125,4469,7492,0.3868126001067806,0.5965029364655633,0.016684463427656167
2008,MICHIGAN,MONROE,39180,1384,35858,76422,0.5126795948810552,0.4692104367852189,0.01810996833372589
2008,MICHIGAN,MONTCALM,13208,552,13291,27051,0.48826291079812206,0.4913311892351484,0.02040589996672951
2008,MICHIGAN,MONTMORENCY,2403,116,2841,5360,0.4483208955223881,0.5300373134328358,0.02164179104477612
2008,MICHIGAN,MUSKEGON,53821,1305,29145,84271,0.638665733170367,0.34584851253693444,0.015485754292698556
2008,MICHIGAN,NEWAYGO,10790,453,11862,23105,0.46699848517636877,0.513395368967756,0.01960614585587535
2008,MICHIGAN,OAKLAND,372566,9546,276956,659068,0.565292200501314,0.42022370984481117,0.014484089653874866
2008,MICHIGAN,OCEANA,6405,244,5860,12509,0.5120313374370453,0.4684627068510672,0.01950595571188744
2008,MICHIGAN,OGEMAW,5391,244,5133,10768,0.500650074294205,0.47669019316493316,0.022659732540861812
2008,MICHIGAN,ONTONAGON,1966,96,1823,3885,0.5060489060489061,0.46924066924066926,0.02471042471042471
2008,MICHIGAN,OSCEOLA,4855,198,5973,11026,0.4403228732087793,0.5417195719209142,0.01795755487030655
2008,MICHIGAN,OSCODA,1887,121,2320,4328,0.4359981515711645,0.5360443622920518,0.027957486136783734
2008,MICHIGAN,OTSEGO,5634,230,6752,12616,0.44657577679137606,0.5351934051997463,0.018230818008877617
2008,MICHIGAN,OTTAWA,50828,2110,83330,136268,0.3730002641852819,0.6115155429007544,0.015484192913963659
2008,MICHIGAN,PRESQUE ISLE,3722,177,3606,7505,0.49593604263824115,0.4804796802131912,0.02358427714856762
2008,MICHIGAN,ROSCOMMON,7082,242,6727,14051,0.5040210661162906,0.4787559604298626,0.017222973453846702
2008,MICHIGAN,SAGINAW,60276,1589,42225,104090,0.5790757997886444,0.4056585647036219,0.015265635507733692
2008,MICHIGAN,SANILAC,9047,443,10679,20169,0.448559670781893,0.5294759284049779,0.02196440081312906
2008,MICHIGAN,SCHOOLCRAFT,2184,84,2058,4326,0.5048543689320388,0.47572815533980584,0.019417475728155338
2008,MICHIGAN,SHIAWASSEE,19397,750,16268,36415,0.5326651105313744,0.44673898118907046,0.02059590827955513
2008,MICHIGAN,ST. CLAIR,40677,1687,38536,80900,0.502805933250927,0.47634116192830656,0.020852904820766377
2008,MICHIGAN,ST. JOSEPH,12322,494,12886,25702,0.4794179441288616,0.5013617617306046,0.01922029414053381
2008,MICHIGAN,TUSCOLA,13503,555,13740,27798,0.48575437081804446,0.49428016404057845,0.01996546514137708
2008,MICHIGAN,VAN BUREN,18588,644,15534,34766,0.5346603002933901,0.44681585457055745,0.018523845136052465
2008,MICHIGAN,WASHTENAW,130578,2591,53946,187115,0.6978489164417604,0.28830398418085135,0.013847099377388237
2008,MICHIGAN,WAYNE,660085,10659,219582,890326,0.741396971446414,0.24663100931568885,0.01197201923789713
2008,MICHIGAN,WEXFORD,7379,281,8044,15704,0.46988028527763626,0.5122261844116148,0.017893530310748855
2008,MINNESOTA,AITKIN,4595,226,4589,9410,0.48831030818278426,0.48767268862911795,0.02401700318809777
2008,MINNESOTA,ANOKA,86976,3891,91357,182224,0.47730266046184916,0.5013444990780578,0.021352840460093073
2008,MINNESOTA,BECKER,7687,427,8851,16965,0.4531093427645152,0.521721190686708,0.025169466548776893
2008,MINNESOTA,BELTRAMI,12019,455,9762,22236,0.540519877675841,0.4390178089584458,0.020462313365713258
2008,MINNESOTA,BENTON,8454,547,10338,19339,0.43714773256114586,0.5345674543668235,0.028284813072030613
2008,MINNESOTA,BIG STONE,1552,76,1362,2990,0.5190635451505017,0.45551839464882943,0.025418060200668897
2008,MINNESOTA,BLUE EARTH,19325,963,14782,35070,0.5510407755916737,0.42149985742800117,0.027459366980325063
2008,MINNESOTA,BROWN,5809,355,7456,13620,0.4265051395007342,0.5474302496328928,0.026064610866372982
2008,MINNESOTA,CARLTON,11501,399,6549,18449,0.6233942219090466,0.354978589625454,0.021627188465499485
2008,MINNESOTA,CARVER,20654,873,28156,49683,0.4157156371394642,0.5667129601674618,0.01757140269307409
2008,MINNESOTA,CASS,7276,371,8660,16307,0.4461887532961305,0.5310602808609799,0.022750965842889558
2008,MINNESOTA,CHIPPEWA,3280,169,2907,6356,0.5160478288231592,0.45736312146003777,0.02658904971680302
2008,MINNESOTA,CHISAGO,12783,733,15789,29305,0.4362054256952738,0.5387817778536086,0.025012796451117557
2008,MINNESOTA,CLAY,16666,615,11978,29259,0.5696025154653269,0.409378310947059,0.021019173587614067
2008,MINNESOTA,CLEARWATER,1877,93,2291,4261,0.4405069232574513,0.5376672142689509,0.021825862473597746
2008,MINNESOTA,COOK,2019,89,1240,3348,0.6030465949820788,0.37037037037037035,0.026583034647550775
2008,MINNESOTA,COTTONWOOD,2759,120,3157,6036,0.457090788601723,0.5230284956925116,0.019880715705765408
2008,MINNESOTA,CROW WING,15859,739,18567,35165,0.45098819849281957,0.527996587515996,0.021015213991184417
2008,MINNESOTA,DAKOTA,116778,4330,104364,225472,0.5179268379222254,0.4628690036900369,0.019204158387737723
2008,MINNESOTA,DODGE,4463,282,5468,10213,0.43699206893175363,0.5353960638402037,0.02761186722804269
2008,MINNESOTA,DOUGLAS,9256,421,11241,20918,0.44248972177072377,0.5373840711349077,0.020126207094368485
2008,MINNESOTA,FARIBAULT,3736,220,4196,8152,0.45829244357212956,0.514720314033366,0.026987242394504417
2008,MINNESOTA,FILLMORE,5921,320,4993,11234,0.52706070856329,0.44445433505429943,0.02848495638241054
2008,MINNESOTA,FREEBORN,9915,410,6955,17280,0.5737847222222222,0.40248842592592593,0.023726851851851853
2008,MINNESOTA,GOODHUE,12420,600,12775,25795,0.4814886605931382,0.49525101763907736,0.023260321767784455
2008,MINNESOTA,GRANT,1850,109,1646,3605,0.5131761442441054,0.4565880721220527,0.030235783633841887
2008,MINNESOTA,HENNEPIN,420958,11768,231054,663780,0.634183012443882,0.3480882220012655,0.01772876555485251
2008,MINNESOTA,HOUSTON,5906,234,4743,10883,0.5426812459799688,0.43581732978039145,0.021501424239639806
2008,MINNESOTA,HUBBARD,4872,208,6558,11638,0.41862863034885717,0.5634988829695824,0.017872486681560405
2008,MINNESOTA,ISANTI,8248,481,11324,20053,0.4113100284246746,0.564703535630579,0.02398643594474642
2008,MINNESOTA,ITASCA,13460,626,10309,24395,0.5517524082803853,0.4225865956138553,0.025660996105759375
2008,MINNESOTA,JACKSON,2618,147,2858,5623,0.4655877645385026,0.5082696069713676,0.026142628490129823
2008,MINNESOTA,KANABEC,3743,277,4479,8499,0.4404047535004118,0.5270031768443346,0.03259206965525356
2008,MINNESOTA,KANDIYOHI,10125,451,11319,21895,0.46243434574103676,0.5169673441424983,0.020598310116464947
2008,MINNESOTA,KITTSON,1492,60,1016,2568,0.5809968847352025,0.3956386292834891,0.02336448598130841
2008,MINNESOTA,KOOCHICHING,3649,191,2962,6802,0.5364598647456631,0.43546015877683036,0.028079976477506617
2008,MINNESOTA,LAC QUI PARLE,2160,120,1912,4192,0.5152671755725191,0.45610687022900764,0.02862595419847328
2008,MINNESOTA,LAKE,4174,159,2636,6969,0.5989381546850338,0.37824652030420436,0.022815325010761944
2008,MINNESOTA,LAKE OF THE WOODS,971,64,1278,2313,0.41980112408127973,0.5525291828793775,0.027669693039342844
2008,MINNESOTA,LE SUEUR,6994,379,7636,15009,0.4659870744220135,0.5087614098207742,0.02525151575721234
2008,MINNESOTA,LINCOLN,1517,118,1491,3126,0.48528470889315417,0.47696737044145876,0.037747920665387076
2008,MINNESOTA,LYON,6110,283,6315,12708,0.48079949638023295,0.4969310670443815,0.022269436575385583
2008,MINNESOTA,MAHNOMEN,1436,64,843,2343,0.6128894579598805,0.35979513444302175,0.02731540759709774
2008,MINNESOTA,MARSHALL,2311,143,2285,4739,0.487655623549272,0.4821692340156151,0.030175142435112892
2008,MINNESOTA,MARTIN,4413,288,6053,10754,0.4103589362097824,0.5628603310396132,0.026780732750604427
2008,MINNESOTA,MCLEOD,7505,531,10993,19029,0.394398024068527,0.5776971990120343,0.02790477691943875
2008,MINNESOTA,MEEKER,5380,428,6737,12545,0.42885611797528894,0.5370267038660821,0.034117178158628934
2008,MINNESOTA,MILLE LACS,6072,423,7049,13544,0.4483165977554637,0.5204518606024808,0.03123154164205552
2008,MINNESOTA,MORRISON,6547,461,9735,16743,0.391029086782536,0.5814370184554739,0.027533894761990085
2008,MINNESOTA,MOWER,11605,507,7075,19187,0.6048366081200813,0.36873925053421586,0.02642414134570282
2008,MINNESOTA,MURRAY,2345,148,2320,4813,0.48722210679409933,0.4820278412632454,0.03075005194265531
2008,MINNESOTA,NICOLLET,9887,390,7968,18245,0.5419018909290216,0.43672238969580707,0.02137571937517128
2008,MINNESOTA,NOBLES,4244,201,4368,8813,0.4815613298536253,0.49563145353455124,0.022807216611823444
2008,MINNESOTA,NORMAN,2129,101,1204,3434,0.6199767035527082,0.3506115317414094,0.029411764705882353
2008,MINNESOTA,OLMSTED,38711,1557,36202,76470,0.5062246632666405,0.4734144108800837,0.020360925853275796
2008,MINNESOTA,OTTER TAIL,13856,754,18077,32687,0.4238994095511977,0.5530333159971854,0.02306727445161685
2008,MINNESOTA,PENNINGTON,3394,180,3248,6822,0.4975080621518616,0.476106713573732,0.026385224274406333
2008,MINNESOTA,PINE,7084,437,6862,14383,0.4925258986303275,0.47709101022039907,0.03038309114927345
2008,MINNESOTA,PIPESTONE,2023,126,2652,4801,0.42137054780254113,0.5523849198083732,0.02624453238908561
2008,MINNESOTA,POLK,7850,336,7148,15334,0.511934263727664,0.46615364549367416,0.021912090778661797
2008,MINNESOTA,POPE,3317,150,3069,6536,0.5074969400244798,0.4695532435740514,0.022949816401468787
2008,MINNESOTA,RAMSEY,182974,5470,88942,277386,0.6596367516745618,0.3206434355014312,0.01971981282400698
2008,MINNESOTA,RED LAKE,1120,88,983,2191,0.5111821086261981,0.44865358283888634,0.040164308534915566
2008,MINNESOTA,REDWOOD,3250,248,4308,7806,0.41634640020497055,0.5518831667947732,0.03177043300025621
2008,MINNESOTA,RENVILLE,3904,275,3956,8135,0.47990165949600494,0.4862937922556853,0.03380454824830977
2008,MINNESOTA,RICE,17381,695,13723,31799,0.5465895153935658,0.4315544513978427,0.021856033208591464
2008,MINNESOTA,ROCK,2079,121,2775,4975,0.4178894472361809,0.5577889447236181,0.024321608040201004
2008,MINNESOTA,ROSEAU,3097,165,4438,7700,0.4022077922077922,0.5763636363636364,0.02142857142857143
2008,MINNESOTA,SAINT LOUIS,77351,2721,38742,118814,0.6510259733701416,0.32607268503711684,0.022901341592741598
2008,MINNESOTA,SCOTT,29208,1200,36724,67132,0.43508311982363107,0.5470416492879699,0.017875230888398975
2008,MINNESOTA,SHERBURNE,17957,893,26140,44990,0.3991331406979329,0.5810180040008891,0.01984885530117804
2008,MINNESOTA,SIBLEY,2998,239,4492,7729,0.38788976581705265,0.5811877345064045,0.03092249967654289
2008,MINNESOTA,STEARNS,35690,1872,41194,78756,0.45317182182944793,0.5230585606176037,0.023769617552948347
2008,MINNESOTA,STEELE,9016,572,10068,19656,0.4586894586894587,0.5122100122100122,0.0291005291005291
2008,MINNESOTA,STEVENS,2781,143,2710,5634,0.4936102236421725,0.481008164714235,0.025381611643592473
2008,MINNESOTA,SWIFT,2907,153,2184,5244,0.5543478260869565,0.41647597254004576,0.02917620137299771
2008,MINNESOTA,TODD,5277,343,6637,12257,0.43052949335073837,0.541486497511626,0.027984009137635636
2008,MINNESOTA,TRAVERSE,1043,59,933,2035,0.5125307125307126,0.45847665847665847,0.028992628992628992
2008,MINNESOTA,WABASHA,5646,312,5935,11893,0.47473303623980495,0.4990330446481123,0.026233919112082737
2008,MINNESOTA,WADENA,2882,159,4128,7169,0.4020086483470498,0.5758125261542754,0.02217882549867485
2008,MINNESOTA,WASECA,4401,276,5211,9888,0.44508495145631066,0.527002427184466,0.027912621359223302
2008,MINNESOTA,WASHINGTON,70277,2448,64334,137059,0.5127499835837122,0.46938909520717353,0.01786092120911432
2008,MINNESOTA,WATONWAN,2562,170,2526,5258,0.4872575123621149,0.4804108025865348,0.032331685051350326
2008,MINNESOTA,WILKIN,1550,78,1786,3414,0.45401288810779145,0.5231400117164616,0.022847100175746926
2008,MINNESOTA,WINONA,16308,652,10975,27935,0.5837837837837838,0.3928763200286379,0.023339896187578306
2008,MINNESOTA,WRIGHT,26343,1456,37779,65578,0.40170484003781753,0.5760925920278142,0.02220256793436823
2008,MINNESOTA,YELLOW MEDICINE,2816,174,2579,5569,0.505656311725624,0.46309929969473873,0.031244388579637277
2008,MISSISSIPPI,ADAMS,9021,109,6566,15696,0.5747324159021406,0.4183231396534149,0.006944444444444444
2008,MISSISSIPPI,ALCORN,4130,84,10805,15019,0.2749850189759638,0.7194220653838471,0.005592915640189094
2008,MISSISSIPPI,AMITE,3348,33,4245,7626,0.43902439024390244,0.556648308418568,0.004327301337529505
2008,MISSISSIPPI,ATTALA,3849,40,5273,9162,0.4201047806155861,0.575529360401659,0.004365858982754857
2008,MISSISSIPPI,BENTON,2227,50,2329,4606,0.48349978289188017,0.5056448111159357,0.010855405992184108
2008,MISSISSIPPI,BOLIVAR,10334,107,4891,15332,0.674015131750587,0.3190060005217845,0.006978867727628489
2008,MISSISSIPPI,CALHOUN,2522,22,4467,7011,0.35972043930965625,0.6371416345742404,0.0031379261161032664
2008,MISSISSIPPI,CARROLL,2037,16,3902,5955,0.3420654911838791,0.6552476910159529,0.002686817800167926
2008,MISSISSIPPI,CHICKASAW,4588,37,4395,9020,0.5086474501108648,0.48725055432372505,0.004101995565410199
2008,MISSISSIPPI,CHOCTAW,1459,22,2624,4105,0.35542021924482337,0.6392204628501827,0.00535931790499391
2008,MISSISSIPPI,CLAIBORNE,4682,19,748,5449,0.8592402275646908,0.13727289410901083,0.0034868783262984033
2008,MISSISSIPPI,CLARKE,3121,22,5229,8372,0.37279025322503584,0.6245819397993311,0.0026278069756330625
2008,MISSISSIPPI,CLAY,6558,32,4466,11056,0.5931620839363242,0.4039435600578871,0.002894356005788712
2008,MISSISSIPPI,COAHOMA,7597,37,2917,10551,0.7200265377689319,0.2764666856222159,0.0035067766088522417
2008,MISSISSIPPI,COPIAH,7710,53,6701,14464,0.5330475663716814,0.46328816371681414,0.003664269911504425
2008,MISSISSIPPI,COVINGTON,3852,48,5523,9423,0.4087870105062082,0.5861190703597581,0.005093919134033747
2008,MISSISSIPPI,DESOTO,19627,260,44222,64109,0.30615046249356564,0.6897939446879533,0.0040555928184810245
2008,MISSISSIPPI,FORREST,11622,165,15296,27083,0.4291252815419267,0.5647823357825943,0.006092382675479083
2008,MISSISSIPPI,FRANKLIN,1733,25,2909,4667,0.37133061924148275,0.6233126205271052,0.005356760231412042
2008,MISSISSIPPI,GEORGE,1532,52,7700,9284,0.16501507970702284,0.8293838862559242,0.005601034037052995
2008,MISSISSIPPI,GREENE,1366,39,4361,5766,0.2369060006937218,0.7563302115851543,0.006763787721123829
2008,MISSISSIPPI,GRENADA,5029,41,6234,11304,0.4448867657466384,0.5514861995753716,0.003627034677990092
2008,MISSISSIPPI,HANCOCK,3768,219,13020,17007,0.22155582995237255,0.7655671194214148,0.012877050626212735
2008,MISSISSIPPI,HARRISON,22673,254,38757,61684,0.36756695415342716,0.6283152843525063,0.004117761494066533
2008,MISSISSIPPI,HINDS,75401,312,32949,108662,0.6939040326885204,0.3032246783604204,0.002871288951059248
2008,MISSISSIPPI,HOLMES,7765,44,1714,9523,0.8153943085162239,0.1799852987503938,0.004620392733382338
2008,MISSISSIPPI,HUMPHREYS,3634,18,1462,5114,0.7105983574501369,0.2858818928431756,0.0035197497066875244
2008,MISSISSIPPI,ISSAQUENA,579,3,364,946,0.6120507399577167,0.38477801268498946,0.003171247357293869
2008,MISSISSIPPI,ITAWAMBA,2084,87,7663,9834,0.2119178360789099,0.7792353060809437,0.008846857840146431
2008,MISSISSIPPI,JACKSON,17781,289,35993,54063,0.32889406803174076,0.6657603166675915,0.00534561530066774
2008,MISSISSIPPI,JASPER,5025,27,4135,9187,0.5469685425057146,0.4500925220420159,0.002938935452269511
2008,MISSISSIPPI,JEFFERSON,3883,36,551,4470,0.8686800894854586,0.1232662192393736,0.008053691275167786
2008,MISSISSIPPI,JEFFERSON DAVIS,4454,25,2871,7350,0.6059863945578231,0.3906122448979592,0.003401360544217687
2008,MISSISSIPPI,JONES,8846,158,20157,29161,0.303350365213813,0.6912314392510545,0.00541819553513254
2008,MISSISSIPPI,KEMPER,3256,18,1935,5209,0.6250719907851795,0.37147245152620467,0.003455557688615857
2008,MISSISSIPPI,LAFAYETTE,7997,121,10278,18396,0.43471406827571213,0.5587084148727984,0.006577516851489454
2008,MISSISSIPPI,LAMAR,5159,150,18497,23806,0.21671007309081744,0.776988994371167,0.006300932538015626
2008,MISSISSIPPI,LAUDERDALE,13332,125,19582,33039,0.4035231090529374,0.5926934834589425,0.0037834074881201007
2008,MISSISSIPPI,LAWRENCE,2587,23,4369,6979,0.37068347900845394,0.6260209199025648,0.0032956010889812295
2008,MISSISSIPPI,LEAKE,4151,31,5148,9330,0.44490889603429795,0.5517684887459807,0.003322615219721329
2008,MISSISSIPPI,LEE,12021,126,22694,34841,0.3450245400533854,0.651359031026664,0.0036164289199506327
2008,MISSISSIPPI,LEFLORE,8914,62,4105,13081,0.6814463726014831,0.313813928598731,0.004739698799785949
2008,MISSISSIPPI,LINCOLN,5505,67,10781,16353,0.3366354797284902,0.6592674127071485,0.004097107564361279
2008,MISSISSIPPI,LOWNDES,13209,184,13994,27387,0.4823091247672253,0.5109723591485011,0.00671851608427356
2008,MISSISSIPPI,MADISON,19831,143,27203,47177,0.4203531381817411,0.5766157237636984,0.003031138054560485
2008,MISSISSIPPI,MARION,4422,44,8513,12979,0.3407042145003467,0.6559056938130827,0.003390091686570614
2008,MISSISSIPPI,MARSHALL,9685,77,6683,16445,0.5889328063241107,0.40638491942839766,0.0046822742474916385
2008,MISSISSIPPI,MONROE,7169,69,10184,17422,0.4114912180002296,0.5845482722993915,0.003960509700378831
2008,MISSISSIPPI,MONTGOMERY,2609,19,3071,5699,0.4577996139673627,0.5388664678013687,0.0033339182312686435
2008,MISSISSIPPI,NESHOBA,3114,29,8209,11352,0.27431289640591966,0.7231324876673714,0.00255461592670895
2008,MISSISSIPPI,NEWTON,3218,38,6479,9735,0.3305598356445814,0.6655367231638418,0.003903441191576785
2008,MISSISSIPPI,NOXUBEE,5030,25,1525,6580,0.7644376899696048,0.2317629179331307,0.003799392097264438
2008,MISSISSIPPI,OKTIBBEHA,9326,146,9320,18792,0.49627501064282675,0.4959557258407833,0.007769263516389954
2008,MISSISSIPPI,PANOLA,8690,105,7620,16415,0.5293938470910753,0.46420956442278405,0.006396588486140725
2008,MISSISSIPPI,PEARL RIVER,4320,125,17881,22326,0.19349637194302607,0.800904774702141,0.00559885335483293
2008,MISSISSIPPI,PERRY,1533,40,4067,5640,0.27180851063829786,0.7210992907801419,0.0070921985815602835
2008,MISSISSIPPI,PIKE,9276,65,8651,17992,0.5155624722098711,0.48082481102712316,0.0036127167630057803
2008,MISSISSIPPI,PONTOTOC,2982,82,9727,12791,0.23313267140958485,0.760456571026503,0.006410757563912126
2008,MISSISSIPPI,PRENTISS,3020,72,7703,10795,0.2797591477535896,0.7135710977304307,0.00666975451597962
2008,MISSISSIPPI,QUITMAN,2803,18,1334,4155,0.6746089049338146,0.3210589651022864,0.004332129963898917
2008,MISSISSIPPI,RANKIN,14372,349,48140,62861,0.22863142488983632,0.7658166430696298,0.0055519320405338765
2008,MISSISSIPPI,SCOTT,5025,32,6584,11641,0.4316639463963577,0.565587148870372,0.0027489047332703376
2008,MISSISSIPPI,SHARKEY,1907,10,873,2790,0.6835125448028674,0.31290322580645163,0.0035842293906810036
2008,MISSISSIPPI,SIMPSON,4817,87,7641,12545,0.38397768035073737,0.6090872857712236,0.006935033878039059
2008,MISSISSIPPI,SMITH,1968,44,6265,8277,0.23776730699528814,0.7569167572792075,0.00531593572550441
2008,MISSISSIPPI,STONE,1996,47,5149,7192,0.2775305895439377,0.7159343715239155,0.00653503893214683
2008,MISSISSIPPI,SUNFLOWER,7838,73,3245,11156,0.7025815704553603,0.29087486554320546,0.006543564001434206
2008,MISSISSIPPI,TALLAHATCHIE,4105,32,2786,6923,0.5929510327892532,0.4024266936299292,0.004622273580817565
2008,MISSISSIPPI,TATE,5003,50,7678,12731,0.39297777079569557,0.6030948079491006,0.003927421255203833
2008,MISSISSIPPI,TIPPAH,2623,69,6937,9629,0.2724062727178316,0.7204278741302316,0.007165853151936857
2008,MISSISSIPPI,TISHOMINGO,1962,81,6249,8292,0.2366136034732272,0.7536179450072359,0.009768451519536902
2008,MISSISSIPPI,TUNICA,3279,27,1017,4323,0.758501040943789,0.23525329632199862,0.006245662734212352
2008,MISSISSIPPI,UNION,2985,52,9072,12109,0.2465108596911388,0.7491948137748782,0.004294326533982988
2008,MISSISSIPPI,WALTHALL,3456,40,4253,7749,0.445993031358885,0.5488450122596464,0.005161956381468577
2008,MISSISSIPPI,WARREN,10489,68,11152,21709,0.4831636648394675,0.5137039937353172,0.0031323414252153485
2008,MISSISSIPPI,WASHINGTON,13148,60,6347,19555,0.6723600102275633,0.3245717207875224,0.003068268984914344
2008,MISSISSIPPI,WAYNE,3890,36,6070,9996,0.38915566226490594,0.6072428971588636,0.003601440576230492
2008,MISSISSIPPI,WEBSTER,1349,18,4072,5439,0.24802353373781946,0.7486670343813201,0.003309431880860452
2008,MISSISSIPPI,WILKINSON,3534,28,1560,5122,0.6899648574775479,0.30456852791878175,0.005466614603670442
2008,MISSISSIPPI,WINSTON,4653,40,5497,10190,0.4566241413150147,0.539450441609421,0.003925417075564278
2008,MISSISSIPPI,YALOBUSHA,3151,22,3628,6801,0.46331421849727983,0.5334509630936627,0.0032348184090574914
2008,MISSISSIPPI,YAZOO,6116,46,5290,11452,0.5340551868669228,0.4619280475026196,0.004016765630457562
2008,MISSOURI,ADAIR,5735,245,5891,11871,0.4831101002442928,0.49625136888214977,0.02063853087355741
2008,MISSOURI,ANDREW,3345,166,5279,8790,0.38054607508532423,0.6005688282138794,0.01888509670079636
2008,MISSOURI,ATCHISON,1000,40,1936,2976,0.33602150537634407,0.6505376344086021,0.013440860215053764
2008,MISSOURI,AUDRAIN,4434,180,6167,10781,0.41127910212410723,0.5720248585474446,0.016696039328448195
2008,MISSOURI,BARRY,4630,256,9758,14644,0.31617044523354276,0.6663479923518164,0.017481562414640807
2008,MISSOURI,BARTON,1455,79,4414,5948,0.24462004034969737,0.7420981842636181,0.0132817753866846
2008,MISSOURI,BATES,3271,179,4833,8283,0.39490522757455027,0.5834842448388265,0.021610527586623206
2008,MISSOURI,BENTON,3629,179,5759,9567,0.37932476220340755,0.6019650883244486,0.018710149472143826
2008,MISSOURI,BOLLINGER,1690,122,3972,5784,0.2921853388658368,0.6867219917012448,0.021092669432918397
2008,MISSOURI,BOONE,47062,1340,36849,85251,0.5520404452733693,0.43224126403209345,0.01571829069453731
2008,MISSOURI,BUCHANAN,19164,766,19110,39040,0.4908811475409836,0.4894979508196721,0.01962090163934426
2008,MISSOURI,BUTLER,5316,217,11805,17338,0.3066097589110624,0.6808743799746222,0.012515861114315376
2008,MISSOURI,CALDWELL,1814,96,2654,4564,0.3974583698510079,0.5815074496056091,0.021034180543382998
2008,MISSOURI,CALLAWAY,7580,352,11389,19321,0.3923192381346721,0.5894622431551162,0.018218518710211688
2008,MISSOURI,CAMDEN,7773,286,14074,22133,0.3511950481181946,0.6358830705281706,0.012921881353634843
2008,MISSOURI,CAPE GIRARDEAU,12208,379,24768,37355,0.3268103332887164,0.6630437692410655,0.010145897470218176
2008,MISSOURI,CARROLL,1535,48,2955,4538,0.3382547377699427,0.6511679153812252,0.010577346848832084
2008,MISSOURI,CARTER,984,74,1840,2898,0.33954451345755693,0.6349206349206349,0.025534851621808144
2008,MISSOURI,CASS,19844,640,29695,50179,0.39546423802786024,0.5917814225074234,0.012754339464716316
2008,MISSOURI,CEDAR,2060,100,4194,6354,0.3242052250550834,0.660056657223796,0.015738117721120555
2008,MISSOURI,CHARITON,1799,76,2339,4214,0.4269102990033223,0.5550545799715235,0.018035121025154248
2008,MISSOURI,CHRISTIAN,11883,432,25382,37697,0.3152240231318142,0.6733161790062869,0.011459797861898826
2008,MISSOURI,CLARK,1572,102,1782,3456,0.4548611111111111,0.515625,0.029513888888888888
2008,MISSOURI,CLAY,53761,1329,54516,109606,0.49049322117402333,0.4973815302082003,0.0121252486177764
2008,MISSOURI,CLINTON,4545,200,5709,10454,0.4347618136598431,0.5461067533958294,0.01913143294432753
2008,MISSOURI,COLE,13959,401,24385,38745,0.36027874564459933,0.6293715318105562,0.010349722544844496
2008,MISSOURI,COOPER,2996,128,4902,8026,0.37328681784201345,0.6107650137054572,0.01594816845252928
2008,MISSOURI,CRAWFORD,3911,167,6007,10085,0.3878036688150719,0.5956370847793753,0.016559246405552803
2008,MISSOURI,DADE,1184,64,2864,4112,0.28793774319066145,0.6964980544747081,0.01556420233463035
2008,MISSOURI,DALLAS,2656,132,4895,7683,0.3456982949368736,0.6371209163087336,0.017180788754392814
2008,MISSOURI,DAVIESS,1400,123,2263,3786,0.369783412572636,0.5977284733227681,0.03248811410459588
2008,MISSOURI,DEKALB,1692,102,2889,4683,0.3613068545803972,0.6169122357463165,0.021780909673286355
2008,MISSOURI,DENT,2056,157,4655,6868,0.2993593476994758,0.6777810133954572,0.022859638905066978
2008,MISSOURI,DOUGLAS,2140,167,4405,6712,0.31883194278903454,0.6562872467222884,0.024880810488676998
2008,MISSOURI,DUNKLIN,4540,180,7044,11764,0.38592315538932337,0.5987759265555933,0.015300918055083304
2008,MISSOURI,FRANKLIN,21256,682,27355,49293,0.43121741423731563,0.5549469498711784,0.013835635891505894
2008,MISSOURI,GASCONADE,2899,109,4763,7771,0.3730536610474842,0.6129198301376915,0.014026508814824347
2008,MISSOURI,GENTRY,1235,93,1964,3292,0.37515188335358446,0.5965978128797084,0.028250303766707167
2008,MISSOURI,GREENE,56181,1831,77683,135695,0.4140240981613177,0.5724824053944508,0.013493496444231548
2008,MISSOURI,GRUNDY,1580,154,3006,4740,0.3333333333333333,0.6341772151898735,0.032489451476793246
2008,MISSOURI,HARRISON,1287,116,2512,3915,0.32873563218390806,0.6416347381864623,0.02962962962962963
2008,MISSOURI,HENRY,4869,195,6095,11159,0.43632942019894255,0.5461958956895779,0.017474684111479524
2008,MISSOURI,HICKORY,2171,94,2850,5115,0.4244379276637341,0.5571847507331378,0.018377321603128056
2008,MISSOURI,HOLT,802,37,1794,2633,0.30459551842005317,0.6813520698822636,0.01405241169768325
2008,MISSOURI,HOWARD,2036,111,2708,4855,0.41936148300720905,0.5577754891864057,0.02286302780638517
2008,MISSOURI,HOWELL,5736,311,10982,17029,0.3368371601385871,0.644899876680956,0.01826296318045687
2008,MISSOURI,IRON,2213,111,2090,4414,0.5013593112822836,0.47349342999546895,0.025147258722247396
2008,MISSOURI,JACKSON,90722,2492,92833,186047,0.48762946997264134,0.4989760651878289,0.013394464839529796
2008,MISSOURI,JASPER,15730,628,31667,48025,0.32753774076002085,0.6593857365955231,0.013076522644456013
2008,MISSOURI,JEFFERSON,53467,1433,50804,105704,0.5058181336562476,0.48062514190569894,0.013556724438053433
2008,MISSOURI,JOHNSON,9480,417,12183,22080,0.42934782608695654,0.5517663043478261,0.01888586956521739
2008,MISSOURI,KANSAS CITY,120102,1263,31854,153219,0.7838583987625556,0.20789849822802656,0.008243103009417892
2008,MISSOURI,KNOX,759,53,1212,2024,0.375,0.5988142292490118,0.026185770750988144
2008,MISSOURI,LACLEDE,5218,230,10875,16323,0.31967162898976903,0.6662378239294248,0.014090547080806225
2008,MISSOURI,LAFAYETTE,6902,256,9442,16600,0.4157831325301205,0.5687951807228916,0.015421686746987951
2008,MISSOURI,LAWRENCE,5097,277,11263,16637,0.30636533028791246,0.6769850333593797,0.01664963635270782
2008,MISSOURI,LEWIS,1837,71,2594,4502,0.4080408707241226,0.576188360728565,0.015770768547312304
2008,MISSOURI,LINCOLN,10234,392,12924,23550,0.4345647558386412,0.5487898089171974,0.016645435244161358
2008,MISSOURI,LINN,2638,153,3140,5931,0.4447816557073006,0.5294216826842016,0.025796661608497723
2008,MISSOURI,LIVINGSTON,2435,124,3993,6552,0.37164224664224665,0.6094322344322345,0.018925518925518924
2008,MISSOURI,MACON,2784,104,4586,7474,0.3724913031843725,0.6135937918116136,0.013914905004013914
2008,MISSOURI,MADISON,2042,89,2897,5028,0.40612569610182975,0.5761734287987271,0.01770087509944312
2008,MISSOURI,MARIES,1599,96,2853,4548,0.35158311345646437,0.6273087071240105,0.021108179419525065
2008,MISSOURI,MARION,4703,145,7705,12553,0.3746514777344061,0.6137974986059109,0.011551023659682944
2008,MISSOURI,MCDONALD,2454,182,5499,8135,0.30165949600491704,0.6759680393362016,0.022372464658881378
2008,MISSOURI,MERCER,519,60,1169,1748,0.29691075514874143,0.6687643020594966,0.034324942791762014
2008,MISSOURI,MILLER,3553,185,7797,11535,0.30801907238838316,0.6759427828348504,0.016038144776766364
2008,MISSOURI,MISSISSIPPI,2247,75,3034,5356,0.41952949962658703,0.5664675130694549,0.014002987303958178
2008,MISSOURI,MONITEAU,2084,114,4467,6665,0.3126781695423856,0.6702175543885972,0.017104276069017255
2008,MISSOURI,MONROE,1703,78,2533,4314,0.3947612424663885,0.5871580899397311,0.01808066759388039
2008,MISSOURI,MONTGOMERY,2347,81,3428,5856,0.40078551912568305,0.5853825136612022,0.013831967213114754
2008,MISSOURI,MORGAN,3565,133,5451,9149,0.3896600721390316,0.5958028199803257,0.014537107880642693
2008,MISSOURI,NEW MADRID,3370,129,4593,8092,0.41646070192782997,0.5675976272862086,0.015941670785961443
2008,MISSOURI,NEWTON,7450,319,17637,25406,0.29323781783830594,0.6942060930488861,0.012556089112807998
2008,MISSOURI,NODAWAY,4493,158,5568,10219,0.43967120070456994,0.5448674038555632,0.015461395439866915
2008,MISSOURI,OREGON,1811,128,2652,4591,0.3944674362883903,0.5776519276846003,0.027880636027009367
2008,MISSOURI,OSAGE,1907,110,5062,7079,0.26938833168526627,0.715072750388473,0.01553891792626077
2008,MISSOURI,OZARK,1661,107,2918,4686,0.3544600938967136,0.6227059325650875,0.02283397353819889
2008,MISSOURI,PEMISCOT,3029,64,3954,7047,0.42982829572867887,0.5610898254576415,0.00908187881367958
2008,MISSOURI,PERRY,3005,115,5527,8647,0.347519370880074,0.6391812189198566,0.013299410200069387
2008,MISSOURI,PETTIS,6932,258,11018,18208,0.3807117750439367,0.6051186291739895,0.014169595782073814
2008,MISSOURI,PHELPS,7394,338,11706,19438,0.3803889289021504,0.602222450869431,0.017388620228418562
2008,MISSOURI,PIKE,3487,126,4268,7881,0.44245654104809035,0.5415556401471895,0.01598781880472021
2008,MISSOURI,PLATTE,21459,561,24460,46480,0.4616824440619621,0.5262478485370051,0.012069707401032703
2008,MISSOURI,POLK,4553,188,8956,13697,0.3324085566182376,0.6538658100313938,0.013725633350368693
2008,MISSOURI,PULASKI,5249,199,9552,15000,0.3499333333333333,0.6368,0.013266666666666666
2008,MISSOURI,PUTNAM,695,53,1591,2339,0.29713552800342025,0.6802052159042326,0.022659256092347157
2008,MISSOURI,RALLS,2041,56,2987,5084,0.4014555468135326,0.5875295043273013,0.011014948859166011
2008,MISSOURI,RANDOLPH,3984,183,6457,10624,0.375,0.6077748493975904,0.017225150602409638
2008,MISSOURI,RAY,5241,219,5593,11053,0.47416990862209357,0.506016466117796,0.019813625260110376
2008,MISSOURI,REYNOLDS,1418,87,1782,3287,0.4313964101003955,0.542135686035899,0.026467903863705507
2008,MISSOURI,RIPLEY,1795,161,3407,5363,0.3347007272049226,0.6352787618870035,0.03002051090807384
2008,MISSOURI,SALINE,4712,174,4962,9848,0.4784727863525589,0.5038586515028433,0.017668562144597888
2008,MISSOURI,SCHUYLER,775,69,1139,1983,0.3908219868885527,0.5743822491174987,0.03479576399394856
2008,MISSOURI,SCOTLAND,793,56,1249,2098,0.37797902764537655,0.5953288846520496,0.02669208770257388
2008,MISSOURI,SCOTT,6258,205,11563,18026,0.3471652058138245,0.6414623321868412,0.011372461999334295
2008,MISSOURI,SHANNON,1637,126,2075,3838,0.4265242313705055,0.5406461698801459,0.03282959874934862
2008,MISSOURI,SHELBY,1114,36,2166,3316,0.33594692400482506,0.6531966224366706,0.010856453558504222
2008,MISSOURI,ST. CHARLES,84183,1796,102550,188529,0.44652546823035183,0.543948145908587,0.009526385861061163
2008,MISSOURI,ST. CLAIR,1886,121,2981,4988,0.3781074578989575,0.5976343223736968,0.02425821972734563
2008,MISSOURI,ST. FRANCOIS,11540,350,12660,24550,0.47006109979633404,0.5156822810590631,0.014256619144602852
2008,MISSOURI,ST. LOUIS CITY,132925,1271,24662,158858,0.836753578667741,0.15524556522177038,0.008000856110488612
2008,MISSOURI,ST. LOUIS COUNTY,333123,5026,221705,559854,0.5950176295962876,0.39600502988279085,0.008977340520921527
2008,MISSOURI,STE. GENEVIEVE,4979,114,3732,8825,0.5641926345609065,0.42288951841359773,0.012917847025495751
2008,MISSOURI,STODDARD,3899,191,9172,13262,0.29399788870456944,0.6916000603227266,0.014402050972703966
2008,MISSOURI,STONE,5029,211,11147,16387,0.306889607615793,0.6802343320925124,0.012876060291694635
2008,MISSOURI,SULLIVAN,1173,89,1607,2869,0.4088532589752527,0.5601254792610666,0.031021261763680724
2008,MISSOURI,TANEY,6683,245,14736,21664,0.3084841211225997,0.6802067946824224,0.011309084194977843
2008,MISSOURI,TEXAS,3410,226,7215,10851,0.3142567505299051,0.6649156759745646,0.020827573495530365
2008,MISSOURI,VERNON,3381,163,5334,8878,0.38082901554404147,0.6008109934669971,0.01835999098896148
2008,MISSOURI,WARREN,6705,196,8675,15576,0.4304699537750385,0.5569465844889574,0.012583461736004109
2008,MISSOURI,WASHINGTON,4711,197,4706,9614,0.49001456209694194,0.4894944872061577,0.020490950696900354
2008,MISSOURI,WAYNE,2243,127,3784,6154,0.364478388040299,0.6148846278843029,0.020636984075398115
2008,MISSOURI,WEBSTER,5685,240,10431,16356,0.34757887013939837,0.6377476155539251,0.014673514306676448
2008,MISSOURI,WORTH,427,40,707,1174,0.3637137989778535,0.6022146507666098,0.034071550255536626
2008,MISSOURI,WRIGHT,2557,173,5784,8514,0.300328870096312,0.6793516560958421,0.020319473807845902
2008,MONTANA,BEAVERHEAD,1617,138,3008,4763,0.3394919168591224,0.6315347470081881,0.02897333613268948
2008,MONTANA,BIG HORN,3516,75,1628,5219,0.6736922782142173,0.3119371527112474,0.014370569074535352
2008,MONTANA,BLAINE,1702,173,1139,3014,0.5646980756469807,0.3779031187790312,0.057398805573988056
2008,MONTANA,BROADWATER,854,68,1853,2775,0.30774774774774777,0.6677477477477477,0.024504504504504504
2008,MONTANA,CARBON,2443,199,3108,5750,0.42486956521739133,0.5405217391304348,0.034608695652173914
2008,MONTANA,CARTER,111,182,573,866,0.12817551963048499,0.6616628175519631,0.21016166281755197
2008,MONTANA,CASCADE,17664,875,16857,35396,0.49903943948468754,0.4762402531359476,0.0247203073793649
2008,MONTANA,CHOUTEAU,1122,110,1634,2866,0.39148639218422887,0.5701325889741801,0.03838101884159107
2008,MONTANA,CUSTER,2267,168,3047,5482,0.41353520612914996,0.5558190441444728,0.030645749726377236
2008,MONTANA,DANIELS,343,36,694,1073,0.3196644920782852,0.646784715750233,0.033550792171481825
2008,MONTANA,DAWSON,1593,218,2639,4450,0.35797752808988764,0.5930337078651685,0.048988764044943824
2008,MONTANA,DEER LODGE,3402,170,1502,5074,0.6704769412692156,0.29601891998423335,0.033504138746551046
2008,MONTANA,FALLON,318,157,1064,1539,0.20662768031189083,0.691358024691358,0.10201429499675113
2008,MONTANA,FERGUS,1933,191,4108,6232,0.31017329910141206,0.6591784338896021,0.030648267008985878
2008,MONTANA,FLATHEAD,16138,2047,25559,43744,0.36891916605705927,0.5842858449158742,0.046794989027066566
2008,MONTANA,GALLATIN,24205,1386,22578,48169,0.5025016089185991,0.4687246984575142,0.02877369262388673
2008,MONTANA,GARFIELD,110,19,598,727,0.15130674002751032,0.8225584594222833,0.026134800550206328
2008,MONTANA,GLACIER,3423,97,1451,4971,0.6885938442969222,0.291892979279823,0.01951317642325488
2008,MONTANA,GOLDEN VALLEY,124,25,343,492,0.25203252032520324,0.6971544715447154,0.0508130081300813
2008,MONTANA,GRANITE,601,104,1013,1718,0.349825378346915,0.589639115250291,0.06053550640279395
2008,MONTANA,HILL,3596,278,2787,6661,0.5398588800480408,0.41840564479807835,0.0417354751538808
2008,MONTANA,JEFFERSON,2582,221,3538,6341,0.4071912947484624,0.5579561583346475,0.03485254691689008
2008,MONTANA,JUDITH BASIN,397,38,801,1236,0.32119741100323623,0.6480582524271845,0.030744336569579287
2008,MONTANA,LAKE,6766,655,6498,13919,0.48609813923414036,0.4668438824628206,0.04705797830303901
2008,MONTANA,LEWIS AND CLARK,17114,1353,14966,33433,0.5118894505428768,0.4476415517602369,0.04046899769688631
2008,MONTANA,LIBERTY,367,40,594,1001,0.36663336663336665,0.5934065934065934,0.03996003996003996
2008,MONTANA,LINCOLN,3025,498,5704,9227,0.3278422022325783,0.6181857591850005,0.05397203858242115
2008,MONTANA,MADISON,1607,139,2822,4568,0.3517950963222417,0.6177758318739054,0.03042907180385289
2008,MONTANA,MCCONE,321,59,726,1106,0.29023508137432186,0.6564195298372514,0.05334538878842676
2008,MONTANA,MEAGHER,298,44,624,966,0.3084886128364389,0.6459627329192547,0.045548654244306416
2008,MONTANA,MINERAL,845,123,1053,2021,0.4181098466105888,0.5210291934685799,0.06086095992083127
2008,MONTANA,MISSOULA,36531,1830,20743,59104,0.6180799945858149,0.3509576340010828,0.03096237141310233
2008,MONTANA,MUSSELSHELL,636,89,1581,2306,0.27580225498699046,0.6856027753686036,0.038594969644405897
2008,MONTANA,PARK,4173,1266,4376,9815,0.4251655629139073,0.44584819154355576,0.12898624554253693
2008,MONTANA,PETROLEUM,68,5,227,300,0.22666666666666666,0.7566666666666667,0.016666666666666666
2008,MONTANA,PHILLIPS,638,163,1423,2224,0.2868705035971223,0.6398381294964028,0.07329136690647482
2008,MONTANA,PONDERA,1223,74,1588,2885,0.4239168110918544,0.5504332755632583,0.025649913344887348
2008,MONTANA,POWDER RIVER,208,394,802,1404,0.14814814814814814,0.5712250712250713,0.28062678062678065
2008,MONTANA,POWELL,1021,236,1683,2940,0.34727891156462587,0.5724489795918367,0.08027210884353742
2008,MONTANA,PRAIRIE,211,116,503,830,0.25421686746987954,0.6060240963855422,0.13975903614457832
2008,MONTANA,RAVALLI,8400,699,13002,22101,0.3800732998506855,0.5882991719831682,0.03162752816614633
2008,MONTANA,RICHLAND,1203,129,3184,4516,0.26638618246235607,0.7050487156775908,0.028565101860053146
2008,MONTANA,ROOSEVELT,2564,910,1473,4947,0.5182939155043461,0.2977562158884172,0.18394986860723672
2008,MONTANA,ROSEBUD,1919,123,1768,3810,0.5036745406824147,0.46404199475065616,0.03228346456692913
2008,MONTANA,SANDERS,1970,335,3563,5868,0.33571915473755964,0.6071915473755964,0.0570892978868439
2008,MONTANA,SHERIDAN,953,66,987,2006,0.47507477567298106,0.49202392821535396,0.03290129611166501
2008,MONTANA,SILVER BOW,11676,475,4818,16969,0.6880782603571218,0.28392951853379694,0.027992221109081266
2008,MONTANA,STILLWATER,1512,164,2991,4667,0.3239768587958003,0.6408827940861367,0.03514034711806299
2008,MONTANA,SWEET GRASS,541,264,1494,2299,0.23531970421922574,0.6498477598956068,0.11483253588516747
2008,MONTANA,TETON,1294,104,1874,3272,0.3954767726161369,0.5727383863080685,0.03178484107579462
2008,MONTANA,TOOLE,737,67,1317,2121,0.3474776049033475,0.620933521923621,0.031588873173031586
2008,MONTANA,TREASURE,156,16,314,486,0.32098765432098764,0.6460905349794238,0.03292181069958848
2008,MONTANA,VALLEY,1645,660,2121,4426,0.37166741979213735,0.4792137370085856,0.149118843199277
2008,MONTANA,WHEATLAND,289,37,657,983,0.29399796541200407,0.6683621566632757,0.03763987792472025
2008,MONTANA,WIBAUX,146,38,379,563,0.25932504440497334,0.6731793960923623,0.0674955595026643
2008,MONTANA,YELLOWSTONE,32038,1910,36483,70431,0.45488492283227555,0.5179963368403118,0.027118740327412644
2008,NEBRASKA,ADAMS,4685,273,8252,13210,0.3546555639666919,0.6246782740348221,0.020666161998485994
2008,NEBRASKA,ANTELOPE,757,45,2383,3185,0.23767660910518054,0.7481946624803768,0.0141287284144427
2008,NEBRASKA,ARTHUR,39,7,217,263,0.1482889733840304,0.8250950570342205,0.026615969581749048
2008,NEBRASKA,BANNER,62,6,348,416,0.14903846153846154,0.8365384615384616,0.014423076923076924
2008,NEBRASKA,BLAINE,43,7,266,316,0.1360759493670886,0.8417721518987342,0.022151898734177215
2008,NEBRASKA,BOONE,742,52,2042,2836,0.2616361071932299,0.7200282087447109,0.018335684062059238
2008,NEBRASKA,BOX BUTTE,1886,161,2932,4979,0.3787909218718618,0.5888732677244427,0.03233581040369552
2008,NEBRASKA,BOYD,250,21,839,1110,0.22522522522522523,0.7558558558558559,0.01891891891891892
2008,NEBRASKA,BROWN,311,48,1208,1567,0.198468410976388,0.7708998085513721,0.03063178047223995
2008,NEBRASKA,BUFFALO,5867,329,13097,19293,0.304099932618048,0.6788472502980356,0.017052817083916448
2008,NEBRASKA,BURT,1413,67,1907,3387,0.4171833480956599,0.5630351343371716,0.019781517567168585
2008,NEBRASKA,BUTLER,1190,92,2557,3839,0.3099765563948945,0.6660588694972649,0.023964574107840583
2008,NEBRASKA,CASS,4753,249,7120,12122,0.3920970136941099,0.5873618214816037,0.02054116482428642
2008,NEBRASKA,CEDAR,1190,72,2912,4174,0.28509822712026833,0.6976521322472449,0.017249640632486823
2008,NEBRASKA,CHASE,341,26,1477,1844,0.18492407809110628,0.8009761388286334,0.014099783080260303
2008,NEBRASKA,CHERRY,599,100,2360,3059,0.19581562602157568,0.7714939522719844,0.032690421706440015
2008,NEBRASKA,CHEYENNE,1173,94,3572,4839,0.24240545567265964,0.7381690431907418,0.01942550113659847
2008,NEBRASKA,CLAY,780,76,2177,3033,0.2571711177052423,0.7177711836465546,0.0250576986482031
2008,NEBRASKA,COLFAX,1125,60,2018,3203,0.3512332188573213,0.6300343428036216,0.018732438339057134
2008,NEBRASKA,CUMING,1274,81,2732,4087,0.31172008808416934,0.6684609738194275,0.01981893809640323
2008,NEBRASKA,CUSTER,1192,85,4301,5578,0.21369666547149516,0.7710648978128362,0.015238436715668699
2008,NEBRASKA,DAKOTA,2994,110,3292,6396,0.46810506566604126,0.5146966854283928,0.01719824890556598
2008,NEBRASKA,DAWES,1285,114,2376,3775,0.3403973509933775,0.6294039735099338,0.030198675496688743
2008,NEBRASKA,DAWSON,2399,127,5460,7986,0.3004007012271475,0.6836964688204358,0.01590282995241673
2008,NEBRASKA,DEUEL,243,18,732,993,0.24471299093655588,0.7371601208459214,0.01812688821752266
2008,NEBRASKA,DIXON,946,63,1785,2794,0.33858267716535434,0.6388690050107373,0.022548317823908374
2008,NEBRASKA,DODGE,6689,304,8557,15550,0.43016077170418004,0.5502893890675241,0.01954983922829582
2008,NEBRASKA,DOUGLAS,116810,3600,106291,226701,0.5152601885302668,0.4688598638735603,0.015879947596172932
2008,NEBRASKA,DUNDY,218,18,783,1019,0.2139352306182532,0.7684003925417076,0.017664376840039256
2008,NEBRASKA,FILLMORE,962,72,1913,2947,0.326433661350526,0.6491347132677299,0.024431625381744145
2008,NEBRASKA,FRANKLIN,442,31,1079,1552,0.2847938144329897,0.6952319587628866,0.01997422680412371
2008,NEBRASKA,FRONTIER,349,21,1034,1404,0.24857549857549857,0.7364672364672364,0.014957264957264958
2008,NEBRASKA,FURNAS,556,47,1725,2328,0.23883161512027493,0.740979381443299,0.020189003436426118
2008,NEBRASKA,GAGE,4473,252,5435,10160,0.44025590551181104,0.5349409448818898,0.024803149606299212
2008,NEBRASKA,GARDEN,283,11,844,1138,0.24868189806678384,0.7416520210896309,0.009666080843585237
2008,NEBRASKA,GARFIELD,212,18,800,1030,0.2058252427184466,0.7766990291262136,0.017475728155339806
2008,NEBRASKA,GOSPER,260,12,776,1048,0.2480916030534351,0.7404580152671756,0.011450381679389313
2008,NEBRASKA,GRANT,41,8,318,367,0.11171662125340599,0.8664850136239782,0.021798365122615803
2008,NEBRASKA,GREELEY,458,26,715,1199,0.38198498748957466,0.5963302752293578,0.021684737281067557
2008,NEBRASKA,HALL,7855,439,12977,21271,0.36928212119787507,0.6100794508955856,0.02063842790653942
2008,NEBRASKA,HAMILTON,1332,78,3389,4799,0.2775578245467806,0.7061887893311106,0.016253386122108773
2008,NEBRASKA,HARLAN,402,35,1329,1766,0.2276330690826727,0.7525481313703284,0.019818799546998868
2008,NEBRASKA,HAYES,85,7,461,553,0.15370705244122965,0.833634719710669,0.012658227848101266
2008,NEBRASKA,HITCHCOCK,346,32,1001,1379,0.25090645395213923,0.7258883248730964,0.023205221174764323
2008,NEBRASKA,HOLT,1089,139,3746,4974,0.2189384800965018,0.7531162042621633,0.027945315641334942
2008,NEBRASKA,HOOKER,75,8,355,438,0.17123287671232876,0.8105022831050228,0.0182648401826484
2008,NEBRASKA,HOWARD,1083,66,1847,2996,0.3614819759679573,0.6164886515353805,0.022029372496662217
2008,NEBRASKA,JEFFERSON,1520,74,2103,3697,0.41114417094941846,0.5688395996754125,0.020016229375169056
2008,NEBRASKA,JOHNSON,914,54,1142,2110,0.43317535545023694,0.5412322274881517,0.025592417061611375
2008,NEBRASKA,KEARNEY,876,50,2224,3150,0.2780952380952381,0.706031746031746,0.015873015873015872
2008,NEBRASKA,KEITH,974,52,2942,3968,0.24546370967741934,0.7414314516129032,0.01310483870967742
2008,NEBRASKA,KEYA PAHA,115,9,409,533,0.21575984990619138,0.7673545966228893,0.016885553470919325
2008,NEBRASKA,KIMBALL,439,26,1346,1811,0.2424075096631695,0.7432357813362783,0.01435670900055218
2008,NEBRASKA,KNOX,1255,101,2728,4084,0.3072967678746327,0.6679725759059746,0.02473065621939275
2008,NEBRASKA,LANCASTER,65734,2358,59398,127490,0.5156012236253824,0.46590320809475255,0.018495568279865086
2008,NEBRASKA,LINCOLN,5046,414,10817,16277,0.31000798672974134,0.6645573508631811,0.025434662407077473
2008,NEBRASKA,LOGAN,81,8,327,416,0.19471153846153846,0.7860576923076923,0.019230769230769232
2008,NEBRASKA,LOUP,86,5,302,393,0.21882951653944022,0.7684478371501272,0.01272264631043257
2008,NEBRASKA,MADISON,4142,248,9655,14045,0.29490922036311856,0.687433250266999,0.017657529369882522
2008,NEBRASKA,MCPHERSON,45,8,240,293,0.15358361774744028,0.8191126279863481,0.027303754266211604
2008,NEBRASKA,MERRICK,986,70,2375,3431,0.28737977266103176,0.6922180122413291,0.020402215097639172
2008,NEBRASKA,MORRILL,557,69,1725,2351,0.23692045937898767,0.7337303275202042,0.029349213100808166
2008,NEBRASKA,NANCE,549,42,1116,1707,0.3216168717047452,0.6537785588752196,0.02460456942003515
2008,NEBRASKA,NEMAHA,1240,100,2134,3474,0.356937248128958,0.6142774899251583,0.028785261945883708
2008,NEBRASKA,NUCKOLLS,657,66,1498,2221,0.29581269698334084,0.6744709590274651,0.029716343989194056
2008,NEBRASKA,OTOE,2915,144,4033,7092,0.4110265087422448,0.5686689227298365,0.02030456852791878
2008,NEBRASKA,PAWNEE,483,42,859,1384,0.34898843930635837,0.6206647398843931,0.030346820809248554
2008,NEBRASKA,PERKINS,310,18,1092,1420,0.21830985915492956,0.7690140845070422,0.01267605633802817
2008,NEBRASKA,PHELPS,1050,63,3360,4473,0.2347417840375587,0.7511737089201878,0.014084507042253521
2008,NEBRASKA,PIERCE,783,58,2385,3226,0.24271543707377558,0.7393056416615003,0.017978921264724116
2008,NEBRASKA,PLATTE,3796,251,9373,13420,0.28286140089418776,0.6984351713859911,0.018703427719821163
2008,NEBRASKA,POLK,668,53,1822,2543,0.2626818718049548,0.7164766024380653,0.020841525756979944
2008,NEBRASKA,RED WILLOW,1216,93,3735,5044,0.24107850911974624,0.7404837430610627,0.01843774781919112
2008,NEBRASKA,RICHARDSON,1513,113,2342,3968,0.38130040322580644,0.5902217741935484,0.02847782258064516
2008,NEBRASKA,ROCK,139,22,640,801,0.1735330836454432,0.7990012484394506,0.02746566791510612
2008,NEBRASKA,SALINE,2674,143,2434,5251,0.5092363359360121,0.4635307560464673,0.02723290801752047
2008,NEBRASKA,SARPY,28010,1196,38816,68022,0.4117785422363353,0.5706389109405781,0.01758254682308665
2008,NEBRASKA,SAUNDERS,3767,257,6188,10212,0.36887974931453194,0.6059537798668233,0.02516647081864473
2008,NEBRASKA,SCOTTS BLUFF,4745,277,9708,14730,0.3221317040054311,0.6590631364562118,0.018805159538357093
2008,NEBRASKA,SEWARD,2703,179,4647,7529,0.35901182095895867,0.6172134413600744,0.02377473768096693
2008,NEBRASKA,SHERIDAN,454,67,1941,2462,0.1844029244516653,0.7883834281072299,0.027213647441104792
2008,NEBRASKA,SHERMAN,585,37,950,1572,0.37213740458015265,0.6043256997455471,0.023536895674300253
2008,NEBRASKA,SIOUX,117,12,603,732,0.1598360655737705,0.8237704918032787,0.01639344262295082
2008,NEBRASKA,STANTON,664,50,1781,2495,0.26613226452905814,0.7138276553106212,0.02004008016032064
2008,NEBRASKA,THAYER,860,50,1749,2659,0.3234298608499436,0.6577660774727341,0.018804061677322303
2008,NEBRASKA,THOMAS,51,8,331,390,0.13076923076923078,0.8487179487179487,0.020512820512820513
2008,NEBRASKA,THURSTON,1120,34,972,2126,0.5268109125117592,0.45719661335841955,0.01599247412982126
2008,NEBRASKA,VALLEY,706,60,1657,2423,0.2913743293437887,0.6838629797771357,0.024762690879075525
2008,NEBRASKA,WASHINGTON,3711,184,6425,10320,0.35959302325581394,0.622577519379845,0.017829457364341085
2008,NEBRASKA,WAYNE,1249,56,2503,3808,0.3279936974789916,0.6573004201680672,0.014705882352941176
2008,NEBRASKA,WEBSTER,552,32,1233,1817,0.3037974683544304,0.6785910842047331,0.017611447440836543
2008,NEBRASKA,WHEELER,96,10,334,440,0.21818181818181817,0.759090909090909,0.022727272727272728
2008,NEBRASKA,YORK,1607,113,4848,6568,0.24467113276492083,0.7381242387332522,0.01720462850182704
2008,NEVADA,CARSON CITY,11623,638,11419,23680,0.49083614864864866,0.48222128378378376,0.026942567567567566
2008,NEVADA,CHURCHILL,3494,279,6832,10605,0.32946723243752946,0.6442244224422442,0.02630834512022631
2008,NEVADA,CLARK,380765,13329,257078,651172,0.5847379801342809,0.39479277364505844,0.020469246220660594
2008,NEVADA,DOUGLAS,10672,584,14648,25904,0.4119827053736875,0.5654725138974676,0.022544780728844967
2008,NEVADA,ELKO,4541,509,10969,16019,0.28347587240152317,0.6847493601348399,0.03177476746363693
2008,NEVADA,ESMERALDA,104,32,303,439,0.23690205011389523,0.6902050113895216,0.07289293849658314
2008,NEVADA,EUREKA,144,37,564,745,0.19328859060402684,0.7570469798657719,0.049664429530201344
2008,NEVADA,HUMBOLDT,1909,169,3586,5664,0.3370409604519774,0.6331214689265536,0.029837570621468926
2008,NEVADA,LANDER,577,59,1466,2102,0.27450047573739295,0.6974310180780209,0.028068506184586107
2008,NEVADA,LINCOLN,518,91,1498,2107,0.24584717607973422,0.7109634551495017,0.04318936877076412
2008,NEVADA,LYON,8405,544,12154,21103,0.39828460408472727,0.5759370705586884,0.02577832535658437
2008,NEVADA,MINERAL,1082,94,1131,2307,0.46900736887732986,0.49024707412223667,0.04074555700043346
2008,NEVADA,NYE,7226,728,9537,17491,0.4131267509004631,0.5452518438053856,0.04162140529415128
2008,NEVADA,PERSHING,673,88,1075,1836,0.36655773420479304,0.585511982570806,0.04793028322440087
2008,NEVADA,STOREY,1102,69,1247,2418,0.4557485525227461,0.5157154673283706,0.028535980148883373
2008,NEVADA,WASHOE,99671,3863,76880,180414,0.5524571263870874,0.42613100978859736,0.021411863824315185
2008,NEVADA,WHITE PINE,1230,172,2440,3842,0.32014575741801143,0.6350858927641854,0.04476834981780323
2008,NEW HAMPSHIRE,BELKNAP,16796,416,16402,33614,0.49967275539953593,0.48795144880109476,0.01237579579936931
2008,NEW HAMPSHIRE,CARROLL,15221,448,13387,29056,0.5238504955947136,0.4607310022026432,0.015418502202643172
2008,NEW HAMPSHIRE,CHESHIRE,26971,647,15205,42823,0.6298250939915466,0.3550662027415174,0.015108703266935992
2008,NEW HAMPSHIRE,COOS,9532,258,6558,16348,0.5830682652312209,0.40114998776608757,0.01578174700269146
2008,NEW HAMPSHIRE,GRAFTON,31446,757,17687,49890,0.6303066746843055,0.35451994387652835,0.015173381439166165
2008,NEW HAMPSHIRE,HILLSBOROUGH,104820,2711,97178,204709,0.5120439257677972,0.47471288511985305,0.013243189112349726
2008,NEW HAMPSHIRE,MERRIMACK,45078,1018,34010,80106,0.562729383566774,0.42456245474745963,0.01270816168576636
2008,NEW HAMPSHIRE,ROCKINGHAM,83723,2182,81917,167822,0.49887976546579116,0.48811836350418897,0.013001871030019901
2008,NEW HAMPSHIRE,STRAFFORD,37990,837,25021,63848,0.5950068913669966,0.39188384914171154,0.013109259491291818
2008,NEW HAMPSHIRE,SULLIVAN,13249,336,9169,22754,0.5822712490111629,0.4029621165509361,0.014766634437901029
2008,NEW JERSEY,ATLANTIC,67830,341,49902,118073,0.5744751128539124,0.42263684330880047,0.002888043837287102
2008,NEW JERSEY,BERGEN,225367,1153,186118,412638,0.5461615265680815,0.4510442567092706,0.0027942167226479384
2008,NEW JERSEY,BURLINGTON,131219,569,89626,221414,0.5926409350808892,0.4047892183872745,0.0025698465318362887
2008,NEW JERSEY,CAMDEN,159259,515,73819,233593,0.6817798478550299,0.31601546279212134,0.002204689352848758
2008,NEW JERSEY,CAPE MAY,22893,200,27288,50381,0.45439749111768324,0.5416327583811358,0.0039697505011810005
2008,NEW JERSEY,CUMBERLAND,34919,205,22360,57484,0.6074559877531139,0.3889778025189618,0.003566209727924292
2008,NEW JERSEY,ESSEX,240306,635,74063,315004,0.762866503282498,0.23511764929969142,0.0020158474178105677
2008,NEW JERSEY,GLOUCESTER,77267,400,60315,137982,0.5599788378194257,0.4371222333347828,0.00289892884579148
2008,NEW JERSEY,HUDSON,154140,648,55360,210148,0.7334830690751281,0.26343338980147324,0.0030835411233987474
2008,NEW JERSEY,HUNTERDON,29776,231,39092,69099,0.43091795829172636,0.5657390121419992,0.0033430295662744756
2008,NEW JERSEY,MERCER,107926,400,50223,158549,0.6807106951163363,0.3167664255214476,0.0025228793622160974
2008,NEW JERSEY,MIDDLESEX,193812,872,123695,318379,0.6087461798673908,0.38851494602345005,0.0027388741091592095
2008,NEW JERSEY,MONMOUTH,148737,745,160433,309915,0.47992836745559264,0.5176677476082151,0.0024038849361921817
2008,NEW JERSEY,MORRIS,112275,542,132331,245148,0.4579886435948896,0.5398004470768678,0.002210909328242531
2008,NEW JERSEY,OCEAN,110189,594,160677,271460,0.40591247329256613,0.591899359021587,0.002188167685846902
2008,NEW JERSEY,PASSAIC,113257,387,72552,186196,0.6082676319577219,0.3896539130808395,0.0020784549614384844
2008,NEW JERSEY,SALEM,16044,99,14816,30959,0.5182337930811719,0.4785684292128299,0.0031977777059982557
2008,NEW JERSEY,SOMERSET,79321,357,70085,149763,0.5296435034020419,0.46797273024712377,0.002383766350834318
2008,NEW JERSEY,SUSSEX,28840,316,44184,73340,0.39323697845650396,0.6024543223343333,0.004308699209162803
2008,NEW JERSEY,UNION,141417,465,78768,220650,0.6409109449354181,0.356981645139361,0.0021074099252209383
2008,NEW JERSEY,WARREN,20628,195,27500,48323,0.4268774703557312,0.5690871841566127,0.004035345487655982
2008,NEW MEXICO,BERNALILLO,171556,3701,110521,285778,0.6003121303949219,0.3867372575915571,0.012950612013520985
2008,NEW MEXICO,CATRON,664,50,1398,2112,0.3143939393939394,0.6619318181818182,0.023674242424242424
2008,NEW MEXICO,CHAVES,8197,264,13651,22112,0.3707036903039074,0.6173570911722142,0.011939218523878437
2008,NEW MEXICO,CIBOLA,5827,139,3131,9097,0.640540837638782,0.3441793998021326,0.015279762559085412
2008,NEW MEXICO,COLFAX,3490,89,2805,6384,0.5466791979949874,0.4393796992481203,0.01394110275689223
2008,NEW MEXICO,CURRY,4670,169,9599,14438,0.3234520016622801,0.6648427760077573,0.011705222329962598
2008,NEW MEXICO,DE BACA,359,9,676,1044,0.3438697318007663,0.6475095785440613,0.008620689655172414
2008,NEW MEXICO,DONA ANA,40282,930,28068,69280,0.5814376443418013,0.40513856812933025,0.01342378752886836
2008,NEW MEXICO,EDDY,7351,242,12500,20093,0.3658488030657443,0.6221072015129647,0.012043995421290997
2008,NEW MEXICO,GRANT,8142,207,5406,13755,0.5919302071973828,0.393020719738277,0.01504907306434024
2008,NEW MEXICO,GUADALUPE,1557,19,620,2196,0.7090163934426229,0.28233151183970856,0.008652094717668488
2008,NEW MEXICO,HARDING,260,8,358,626,0.41533546325878595,0.5718849840255591,0.012779552715654952
2008,NEW MEXICO,HIDALGO,993,22,936,1951,0.5089697590978985,0.4797539723218862,0.011276268580215274
2008,NEW MEXICO,LEA,5108,190,13347,18645,0.27396084741217486,0.7158487530168947,0.010190399570930545
2008,NEW MEXICO,LINCOLN,3535,160,6001,9696,0.3645833333333333,0.6189150165016502,0.0165016501650165
2008,NEW MEXICO,LOS ALAMOS,5824,181,5064,11069,0.5261541241304544,0.4574939018881561,0.016351973981389465
2008,NEW MEXICO,LUNA,4311,159,3870,8340,0.5169064748201438,0.46402877697841727,0.019064748201438848
2008,NEW MEXICO,MCKINLEY,16572,253,6382,23207,0.7140948851639591,0.2750032317835136,0.010901883052527254
2008,NEW MEXICO,MORA,2168,23,569,2760,0.7855072463768116,0.20615942028985507,0.008333333333333333
2008,NEW MEXICO,OTERO,8610,350,12806,21766,0.3955710741523477,0.5883488008821097,0.016080124965542588
2008,NEW MEXICO,QUAY,1547,82,2367,3996,0.38713713713713716,0.5923423423423423,0.02052052052052052
2008,NEW MEXICO,RIO ARRIBA,12703,151,4086,16940,0.7498819362455726,0.24120425029515938,0.008913813459268005
2008,NEW MEXICO,ROOSEVELT,2303,106,4311,6720,0.34270833333333334,0.6415178571428571,0.015773809523809523
2008,NEW MEXICO,SAN JUAN,18028,614,27869,46511,0.3876072326976414,0.5991915890864526,0.013201178215905916
2008,NEW MEXICO,SAN MIGUEL,10320,143,2478,12941,0.7974654199829998,0.19148442933312726,0.011050150683872962
2008,NEW MEXICO,SANDOVAL,32669,768,25193,58630,0.5572062084257207,0.4296946955483541,0.013099096025925294
2008,NEW MEXICO,SANTA FE,55567,849,15807,72223,0.7693809451282833,0.21886379685141852,0.011755258020298243
2008,NEW MEXICO,SIERRA,2352,116,3017,5485,0.42880583409298084,0.5500455788514129,0.0211485870556062
2008,NEW MEXICO,SOCORRO,4696,167,3032,7895,0.5948068397720075,0.38404053198226723,0.02115262824572514
2008,NEW MEXICO,TAOS,13816,204,2866,16886,0.8181925855738481,0.1697264005685183,0.012081013857633542
2008,NEW MEXICO,TORRANCE,3087,119,3735,6941,0.44474859530327043,0.5381069010229074,0.017144503673822215
2008,NEW MEXICO,UNION,492,23,1227,1742,0.28243398392652125,0.7043628013777268,0.01320321469575201
2008,NEW MEXICO,VALENCIA,15366,397,13136,28899,0.5317139001349528,0.45454860029758815,0.013737499567459082
2008,NEW YORK,ALBANY,93937,2613,50586,147136,0.6384365484993475,0.34380437146585474,0.017759080034797738
2008,NEW YORK,ALLEGANY,7016,339,11013,18368,0.3819686411149826,0.5995753484320557,0.018456010452961674
2008,NEW YORK,BRONX,338261,1342,41683,381286,0.8871581962096694,0.10932213613927604,0.003519667651054589
2008,NEW YORK,BROOME,47204,1437,40077,88718,0.5320679005387858,0.4517347099799364,0.016197389481277757
2008,NEW YORK,CATTARAUGUS,14307,511,17770,32588,0.43902663557137594,0.5452927457959985,0.015680618632625508
2008,NEW YORK,CAYUGA,18128,621,15243,33992,0.5333019534008002,0.4484290421275594,0.018269004471640385
2008,NEW YORK,CHAUTAUQUA,29129,1064,28579,58772,0.49562716940039475,0.48626897161913835,0.01810385898046689
2008,NEW YORK,CHEMUNG,18888,443,19364,38695,0.4881250807597881,0.5004264116810957,0.011448507559116165
2008,NEW YORK,CHENANGO,10100,410,10337,20847,0.4844821796901233,0.49585072192641627,0.01966709838346045
2008,NEW YORK,CLINTON,20216,519,12579,33314,0.6068319625382722,0.37758900162094017,0.015579035840787656
2008,NEW YORK,COLUMBIA,17556,515,13337,31408,0.5589658685685176,0.4246370351502802,0.016397096281202242
2008,NEW YORK,CORTLAND,11861,361,9678,21900,0.5415981735159817,0.4419178082191781,0.016484018264840184
2008,NEW YORK,DELAWARE,9462,403,10524,20389,0.46407376526558436,0.5161606748737064,0.019765559860709207
2008,NEW YORK,DUTCHESS,71060,1566,59628,132254,0.537299438958368,0.4508597093471653,0.011840851694466708
2008,NEW YORK,ERIE,256299,6871,178815,441985,0.5798816701924273,0.4045725533671957,0.015545776440376935
2008,NEW YORK,ESSEX,10390,288,7913,18591,0.5588725727502555,0.42563606045936203,0.015491366790382443
2008,NEW YORK,FRANKLIN,10571,249,6676,17496,0.6041952446273434,0.381572930955647,0.014231824417009603
2008,NEW YORK,FULTON,9695,401,11709,21805,0.4446227929373997,0.536986929603302,0.018390277459298325
2008,NEW YORK,GENESEE,10762,399,15705,26866,0.4005806595697164,0.5845678552817688,0.01485148514851485
2008,NEW YORK,GREENE,9850,406,12059,22315,0.4414071252520726,0.540398834864441,0.018194039883486442
2008,NEW YORK,HAMILTON,1225,45,2141,3411,0.35913221929053063,0.6276751685722662,0.013192612137203167
2008,NEW YORK,HERKIMER,12094,471,14619,27184,0.44489405532666276,0.5377795762213067,0.017326368452030606
2008,NEW YORK,JEFFERSON,18166,462,20219,38847,0.46762941797307384,0.5204777717713079,0.011892810255618195
2008,NEW YORK,KINGS,603525,4274,151872,759671,0.794455757821478,0.19991812245037655,0.005626119728145473
2008,NEW YORK,LEWIS,4986,174,5969,11129,0.4480186899092461,0.5363464821637164,0.015634827927037468
2008,NEW YORK,LIVINGSTON,13655,442,16030,30127,0.4532479171507286,0.5320808577023932,0.014671225146878216
2008,NEW YORK,MADISON,14692,652,14434,29778,0.4933843777285244,0.4847202632816173,0.021895358989858286
2008,NEW YORK,MONROE,207225,4347,144153,355725,0.5825426944971537,0.40523719165085387,0.01222011385199241
2008,NEW YORK,MONTGOMERY,9080,384,10711,20175,0.45006195786864933,0.5309045848822801,0.019033457249070632
2008,NEW YORK,NASSAU,342067,4589,288758,635414,0.5383372100709144,0.45444072683321424,0.007222063095871353
2008,NEW YORK,NEW YORK,572126,5239,89906,667271,0.8574117562429657,0.13473686103547133,0.007851382721562904
2008,NEW YORK,NIAGARA,47303,1556,46348,95207,0.4968437194744084,0.4868129444263552,0.0163433360992364
2008,NEW YORK,ONEIDA,43506,1551,49256,94313,0.46129377710389874,0.5222609820491343,0.016445240846967014
2008,NEW YORK,ONONDAGA,129317,3905,84972,218194,0.5926698259347186,0.38943325664317074,0.017896917422110598
2008,NEW YORK,ONTARIO,25103,746,25171,51020,0.49202273618188946,0.49335554684437477,0.01462171697373579
2008,NEW YORK,ORANGE,78326,1550,72042,151918,0.5155807738385182,0.4742163535591569,0.010202872602324938
2008,NEW YORK,ORLEANS,6614,252,9708,16574,0.3990587667430916,0.5857366960299264,0.01520453722698202
2008,NEW YORK,OSWEGO,24777,907,23571,49255,0.503035224850269,0.47855040097452034,0.01841437417521064
2008,NEW YORK,OTSEGO,13570,505,12026,26101,0.5199034519750201,0.46074863032067737,0.01934791770430252
2008,NEW YORK,PUTNAM,21613,455,25145,47213,0.45777645987334,0.5325863639251901,0.009637176201469934
2008,NEW YORK,QUEENS,447906,3794,145898,597598,0.7495105405305909,0.24414070997560233,0.006348749493806874
2008,NEW YORK,RENSSELAER,39753,1393,32840,73986,0.5373043548779499,0.4438677587651718,0.018827886356878328
2008,NEW YORK,RICHMOND,79311,1107,86062,166480,0.4763995675156175,0.5169509851033157,0.006649447381066795
2008,NEW YORK,ROCKLAND,69543,841,61752,132136,0.5262986619846219,0.46733668341708545,0.006364654598292668
2008,NEW YORK,SARATOGA,56645,1755,52855,111255,0.5091456563749944,0.47507977169565413,0.01577457192935149
2008,NEW YORK,SCHENECTADY,38611,1409,29758,69778,0.5533405944567056,0.42646679469173665,0.020192610851557796
2008,NEW YORK,SCHOHARIE,6009,301,8071,14381,0.41784298727487656,0.5612266184549057,0.02093039427021765
2008,NEW YORK,SCHUYLER,3933,125,4542,8600,0.45732558139534885,0.5281395348837209,0.014534883720930232
2008,NEW YORK,SENECA,7422,265,7038,14725,0.5040407470288625,0.47796264855687604,0.01799660441426146
2008,NEW YORK,ST. LAWRENCE,23706,580,16956,41242,0.5748023859172688,0.41113428058775037,0.014063333494980845
2008,NEW YORK,STEUBEN,17148,540,24203,41891,0.4093480699911676,0.5777613329832183,0.012890597025614094
2008,NEW YORK,SUFFOLK,346379,5833,306815,659027,0.5255915159773423,0.46555755682240635,0.008850927200251279
2008,NEW YORK,SULLIVAN,16850,403,13900,31153,0.5408788880685649,0.4461849581099734,0.012936153821461818
2008,NEW YORK,TIOGA,10172,382,12536,23090,0.4405370290168904,0.5429190125595496,0.016543958423559983
2008,NEW YORK,TOMPKINS,29826,732,11927,42485,0.7020360127103684,0.2807343768388843,0.017229610450747324
2008,NEW YORK,ULSTER,52539,1395,32527,86461,0.6076612576768716,0.37620430020471657,0.01613444211841177
2008,NEW YORK,WARREN,16281,496,15429,32206,0.5055269204496057,0.4790722225672235,0.015400856983170837
2008,NEW YORK,WASHINGTON,12741,442,12533,25716,0.49545030331311246,0.4873619536475346,0.017187743039352932
2008,NEW YORK,WAYNE,18184,579,22239,41002,0.4434905614360275,0.5423881761865275,0.014121262377445003
2008,NEW YORK,WESTCHESTER,261810,3213,147824,412847,0.634157448158761,0.35806000770261137,0.007782544138627627
2008,NEW YORK,WYOMING,6379,281,10998,17658,0.3612526899988674,0.6228338430173292,0.015913466983803377
2008,NEW YORK,YATES,4890,105,5269,10264,0.4764224473889322,0.5133476227591582,0.010229929851909587
2008,NORTH CAROLINA,ALAMANCE,28918,576,34859,64353,0.44936521995866546,0.5416841483691514,0.008950631672183115
2008,NORTH CAROLINA,ALEXANDER,5167,297,11790,17254,0.29946679030949347,0.6833198098991539,0.01721339979135273
2008,NORTH CAROLINA,ALLEGHANY,2021,118,3124,5263,0.38400152004560134,0.59357780733422,0.022420672620178606
2008,NORTH CAROLINA,ANSON,6456,70,4207,10733,0.6015093636448337,0.391968694679959,0.006521941675207305
2008,NORTH CAROLINA,ASHE,4872,281,7916,13069,0.3727905731119443,0.6057081643584054,0.021501262529650317
2008,NORTH CAROLINA,AVERY,2178,84,5681,7943,0.27420370137227745,0.7152209492635024,0.010575349364220069
2008,NORTH CAROLINA,BEAUFORT,9454,96,13460,23010,0.41086484137331597,0.5849630595393307,0.0041720990873533245
2008,NORTH CAROLINA,BERTIE,6365,22,3376,9763,0.6519512444945201,0.3457953497900236,0.002253405715456315
2008,NORTH CAROLINA,BLADEN,7853,95,7532,15480,0.5072997416020671,0.48656330749354004,0.006136950904392765
2008,NORTH CAROLINA,BRUNSWICK,21331,524,30753,52608,0.4054706508515815,0.5845688868613139,0.009960462287104623
2008,NORTH CAROLINA,BUNCOMBE,69716,1585,52494,123795,0.5631568318591219,0.42403974312371256,0.012803425017165476
2008,NORTH CAROLINA,BURKE,14901,440,22102,37443,0.39796490665812034,0.5902838981919184,0.011751195149961275
2008,NORTH CAROLINA,CABARRUS,31546,524,45924,77994,0.40446701028284227,0.5888145241941688,0.006718465522988948
2008,NORTH CAROLINA,CALDWELL,12081,548,22526,35155,0.34364955198407054,0.6407623382164699,0.015588109799459536
2008,NORTH CAROLINA,CAMDEN,1597,84,3140,4821,0.33125907488073014,0.651317154117403,0.017423771001866834
2008,NORTH CAROLINA,CARTERET,11130,336,23131,34597,0.32170419400526057,0.6685839812700524,0.009711824724687112
2008,NORTH CAROLINA,CASWELL,5545,109,5208,10862,0.5104953047320936,0.4794697109187995,0.010034984349106978
2008,NORTH CAROLINA,CATAWBA,25656,802,42993,69451,0.3694115275517991,0.6190407625520151,0.0115477098961858
2008,NORTH CAROLINA,CHATHAM,17862,350,14668,32880,0.5432481751824818,0.4461070559610706,0.010644768856447688
2008,NORTH CAROLINA,CHEROKEE,3785,158,8643,12586,0.3007309709200699,0.686715398061338,0.012553631018592087
2008,NORTH CAROLINA,CHOWAN,3688,51,3773,7512,0.4909478168264111,0.5022630457933972,0.006789137380191693
2008,NORTH CAROLINA,CLAY,1734,102,3707,5543,0.312826988995129,0.6687714234169222,0.018401587587948763
2008,NORTH CAROLINA,CLEVELAND,17363,394,26078,43835,0.39609900764229494,0.5949127409604198,0.008988251397285275
2008,NORTH CAROLINA,COLUMBUS,11076,212,12994,24282,0.45614035087719296,0.535128902067375,0.008730747055432007
2008,NORTH CAROLINA,CRAVEN,19352,345,24901,44598,0.4339208036234809,0.5583434234719046,0.007735772904614557
2008,NORTH CAROLINA,CUMBERLAND,74693,731,52151,127575,0.5854830491867529,0.4087869880462473,0.005729962766999804
2008,NORTH CAROLINA,CURRITUCK,3737,131,7234,11102,0.3366060169338858,0.6515943073320123,0.011799675734101964
2008,NORTH CAROLINA,DARE,8074,229,9745,18048,0.4473625886524823,0.539949024822695,0.012688386524822695
2008,NORTH CAROLINA,DAVIDSON,22433,729,45419,68581,0.3271022586430644,0.662267975095143,0.010629766261792625
2008,NORTH CAROLINA,DAVIE,6178,209,13981,20368,0.30331893165750196,0.6864198743126473,0.010261194029850746
2008,NORTH CAROLINA,DUPLIN,8958,112,10834,19904,0.4500602893890675,0.5443127009646302,0.005627009646302251
2008,NORTH CAROLINA,DURHAM,103456,1088,32353,136897,0.7557214548163949,0.23633096415553298,0.0079475810280722
2008,NORTH CAROLINA,EDGECOMBE,17403,82,8445,25930,0.671153104512148,0.325684535287312,0.0031623602005399153
2008,NORTH CAROLINA,FORSYTH,91085,1374,73674,166133,0.548265546279186,0.44346397163718226,0.008270482083631788
2008,NORTH CAROLINA,FRANKLIN,13085,281,13273,26639,0.49119711700889673,0.4982544389804422,0.010548444010661061
2008,NORTH CAROLINA,GASTON,31384,511,52507,84402,0.37183952986896046,0.6221061112295917,0.006054358901447833
2008,NORTH CAROLINA,GATES,2830,43,2547,5420,0.522140221402214,0.46992619926199264,0.007933579335793358
2008,NORTH CAROLINA,GRAHAM,1265,82,2824,4171,0.3032845840326061,0.6770558619036202,0.019659554063773677
2008,NORTH CAROLINA,GRANVILLE,13074,204,11447,24725,0.5287765419615773,0.46297269969666327,0.008250758341759352
2008,NORTH CAROLINA,GREENE,3796,35,4272,8103,0.46846846846846846,0.5272121436504998,0.004319387881031716
2008,NORTH CAROLINA,GUILFORD,142101,1952,97718,241771,0.587750391899773,0.4041758523561552,0.00807375574407187
2008,NORTH CAROLINA,HALIFAX,16047,83,8961,25091,0.6395520306085848,0.3571400103622813,0.0033079590291339523
2008,NORTH CAROLINA,HARNETT,16785,341,23579,40705,0.4123572042746591,0.5792654465053433,0.008377349219997544
2008,NORTH CAROLINA,HAYWOOD,12730,427,14910,28067,0.4535575586988278,0.5312288452631204,0.015213596038051804
2008,NORTH CAROLINA,HENDERSON,20082,602,30930,51614,0.38908048203975665,0.599256015809664,0.0116635021505793
2008,NORTH CAROLINA,HERTFORD,7513,48,3089,10650,0.7054460093896714,0.2900469483568075,0.004507042253521127
2008,NORTH CAROLINA,HOKE,9227,107,6293,15627,0.5904524220899725,0.40270045434184426,0.006847123568183272
2008,NORTH CAROLINA,HYDE,1241,16,1212,2469,0.5026326447954638,0.4908869987849332,0.0064803564196030785
2008,NORTH CAROLINA,IREDELL,27318,696,45148,73162,0.37339055793991416,0.6170963068259478,0.00951313523413794
2008,NORTH CAROLINA,JACKSON,8766,246,7854,16866,0.5197438633938101,0.4656705798648168,0.014585556741373178
2008,NORTH CAROLINA,JOHNSTON,26795,600,43622,71017,0.37730402579664024,0.6142472929016995,0.008448681301660165
2008,NORTH CAROLINA,JONES,2378,32,2817,5227,0.4549454754161087,0.5389324660417065,0.00612205854218481
2008,NORTH CAROLINA,LEE,10784,229,12775,23788,0.45333781738691775,0.5370354800739869,0.009626702539095342
2008,NORTH CAROLINA,LENOIR,13378,118,13401,26897,0.4973788898390155,0.4982340037922445,0.004387106368740008
2008,NORTH CAROLINA,LINCOLN,11713,454,23631,35798,0.32719705011453154,0.6601206771328008,0.012682272752667747
2008,NORTH CAROLINA,MACON,6620,301,10317,17238,0.38403527091309897,0.598503306648103,0.017461422438798006
2008,NORTH CAROLINA,MADISON,5026,161,5192,10379,0.48424703728682916,0.500240870989498,0.015512091723672801
2008,NORTH CAROLINA,MARTIN,6539,45,5957,12541,0.5214097759349334,0.47500199346144645,0.003588230603620126
2008,NORTH CAROLINA,MCDOWELL,6571,281,11534,18386,0.3573914935276841,0.6273251386924834,0.01528336777983248
2008,NORTH CAROLINA,MECKLENBURG,253958,3011,153848,410817,0.6181779235036525,0.3744927790232634,0.0073292974730841225
2008,NORTH CAROLINA,MITCHELL,2238,109,5499,7846,0.2852408870762172,0.7008666836604639,0.013892429263318889
2008,NORTH CAROLINA,MONTGOMERY,4926,129,6155,11210,0.43942908117752005,0.5490633363068689,0.011507582515611061
2008,NORTH CAROLINA,MOORE,17624,390,27314,45328,0.3888104482880339,0.602585598305683,0.008603953406283091
2008,NORTH CAROLINA,NASH,23099,291,23728,47118,0.4902372766246445,0.5035867396748589,0.0061759837004966255
2008,NORTH CAROLINA,NEW HANOVER,49145,976,50544,100665,0.48820344707693836,0.502101028162718,0.009695524760343714
2008,NORTH CAROLINA,NORTHAMPTON,6903,44,3671,10618,0.6501224336033151,0.3457336598229422,0.004143906573742701
2008,NORTH CAROLINA,ONSLOW,19499,426,30278,50203,0.3884030834810669,0.6031113678465431,0.008485548672390096
2008,NORTH CAROLINA,ORANGE,53806,838,20266,74910,0.718275263649713,0.27053797890802295,0.01118675744226405
2008,NORTH CAROLINA,PAMLICO,2838,51,3823,6712,0.42282479141835516,0.5695768772348033,0.007598331346841478
2008,NORTH CAROLINA,PASQUOTANK,10272,130,7778,18180,0.565016501650165,0.42783278327832786,0.007150715071507151
2008,NORTH CAROLINA,PENDER,9907,224,13618,23749,0.41715440650132635,0.5734136174154701,0.009431976083203503
2008,NORTH CAROLINA,PERQUIMANS,2772,51,3678,6501,0.4263959390862944,0.5657591139824643,0.007844946931241348
2008,NORTH CAROLINA,PERSON,8446,156,10030,18632,0.45330613997423785,0.5383211678832117,0.008372692142550452
2008,NORTH CAROLINA,PITT,40501,456,33927,74884,0.5408498477645425,0.45306073393515306,0.006089418300304471
2008,NORTH CAROLINA,POLK,4396,176,5990,10562,0.41620905131603864,0.56712743798523,0.0166635106987313
2008,NORTH CAROLINA,RANDOLPH,16414,735,40998,58147,0.28228455466318125,0.7050750683612225,0.012640376975596333
2008,NORTH CAROLINA,RICHMOND,9713,190,9424,19327,0.5025611838360843,0.4876080095203601,0.009830806643555647
2008,NORTH CAROLINA,ROBESON,23058,343,17433,40834,0.5646764950776314,0.4269236420629867,0.008399862859381888
2008,NORTH CAROLINA,ROCKINGHAM,17255,458,23899,41612,0.41466403921945594,0.5743295203306739,0.011006440449870229
2008,NORTH CAROLINA,ROWAN,23391,718,37451,61560,0.3799707602339181,0.6083658219623131,0.01166341780376868
2008,NORTH CAROLINA,RUTHERFORD,9641,310,18769,28720,0.33568941504178273,0.653516713091922,0.010793871866295265
2008,NORTH CAROLINA,SAMPSON,11836,164,14038,26038,0.4545664029495353,0.5391351102235195,0.0062984868269452335
2008,NORTH CAROLINA,SCOTLAND,8151,61,6005,14217,0.573327706267145,0.4223816557642259,0.004290637968629106
2008,NORTH CAROLINA,STANLY,8878,299,19329,28506,0.31144320493931105,0.67806777520522,0.010489019855469024
2008,NORTH CAROLINA,STOKES,6875,380,14488,21743,0.31619371751828174,0.6663293933679805,0.017476889113737754
2008,NORTH CAROLINA,SURRY,10475,320,18730,29525,0.35478408128704486,0.6343776460626588,0.01083827265029636
2008,NORTH CAROLINA,SWAIN,2806,92,2900,5798,0.48395998620213865,0.5001724732666437,0.01586754053121766
2008,NORTH CAROLINA,TRANSYLVANIA,7275,233,9401,16909,0.4302442486249926,0.5559761073984268,0.013779643976580519
2008,NORTH CAROLINA,TYRRELL,933,17,960,1910,0.4884816753926702,0.5026178010471204,0.008900523560209424
2008,NORTH CAROLINA,UNION,31189,777,54123,86089,0.3622878648840154,0.6286865917829223,0.009025543333062295
2008,NORTH CAROLINA,VANCE,13166,99,7606,20871,0.6308274639451871,0.3644291121652053,0.004743423889607589
2008,NORTH CAROLINA,WAKE,250891,4353,187001,442245,0.5673122364300331,0.4228448032199347,0.009842960350032222
2008,NORTH CAROLINA,WARREN,7086,46,3063,10195,0.6950465914664051,0.3004413928396273,0.004512015693967631
2008,NORTH CAROLINA,WASHINGTON,3748,36,2670,6454,0.5807251317012705,0.41369693213511,0.005577936163619461
2008,NORTH CAROLINA,WATAUGA,14558,470,13344,28372,0.513111518398421,0.47032285351755254,0.016565628084026503
2008,NORTH CAROLINA,WAYNE,22671,259,26952,49882,0.45449260254199914,0.5403151437392246,0.005192253718776312
2008,NORTH CAROLINA,WILKES,8934,502,20288,29724,0.3005651998385143,0.6825460907011169,0.016888709460368724
2008,NORTH CAROLINA,WILSON,19652,164,17375,37191,0.5284074103949881,0.4671829205990697,0.004409669005942298
2008,NORTH CAROLINA,YADKIN,4527,211,12409,17147,0.2640111972939873,0.7236834431679011,0.012305359538111623
2008,NORTH CAROLINA,YANCEY,4486,186,5045,9717,0.46166512298034373,0.5191931666152104,0.019141710404445816
2008,NORTH DAKOTA,ADAMS,435,48,788,1271,0.3422501966955153,0.6199842643587726,0.03776553894571204
2008,NORTH DAKOTA,BARNES,2741,127,2826,5694,0.4813839128907622,0.49631190727081137,0.022304179838426415
2008,NORTH DAKOTA,BENSON,1569,32,773,2374,0.6609098567818029,0.3256107834877843,0.013479359730412805
2008,NORTH DAKOTA,BILLINGS,114,10,375,499,0.22845691382765532,0.751503006012024,0.02004008016032064
2008,NORTH DAKOTA,BOTTINEAU,1387,70,2059,3516,0.39448236632536976,0.585608646188851,0.019908987485779295
2008,NORTH DAKOTA,BOWMAN,478,55,1107,1640,0.2914634146341463,0.675,0.03353658536585366
2008,NORTH DAKOTA,BURKE,286,17,640,943,0.30328738069989397,0.6786850477200425,0.018027571580063628
2008,NORTH DAKOTA,BURLEIGH,15600,729,25443,41772,0.37345590347601265,0.6090922148807814,0.017451881643205977
2008,NORTH DAKOTA,CASS,37622,1231,32566,71419,0.5267785883308364,0.4559851020036685,0.017236309665495178
2008,NORTH DAKOTA,CAVALIER,930,72,1128,2130,0.43661971830985913,0.5295774647887324,0.03380281690140845
2008,NORTH DAKOTA,DICKEY,1044,51,1525,2620,0.3984732824427481,0.5820610687022901,0.019465648854961833
2008,NORTH DAKOTA,DIVIDE,464,37,630,1131,0.41025641025641024,0.5570291777188329,0.032714412024756855
2008,NORTH DAKOTA,DUNN,527,37,1080,1644,0.32055961070559613,0.656934306569343,0.022506082725060828
2008,NORTH DAKOTA,EDDY,583,34,548,1165,0.5004291845493563,0.4703862660944206,0.029184549356223177
2008,NORTH DAKOTA,EMMONS,546,61,1230,1837,0.29722373434948285,0.6695699510070767,0.03320631464344039
2008,NORTH DAKOTA,FOSTER,687,50,914,1651,0.4161114476075106,0.5536038764385222,0.03028467595396729
2008,NORTH DAKOTA,GOLDEN VALLEY,210,23,642,875,0.24,0.7337142857142858,0.026285714285714287
2008,NORTH DAKOTA,GRAND FORKS,16104,529,14520,31153,0.5169325586620871,0.4660867332199146,0.016980708117998268
2008,NORTH DAKOTA,GRANT,280,462,587,1329,0.2106847253574116,0.44168547780285927,0.3476297968397291
2008,NORTH DAKOTA,GRIGGS,598,34,682,1314,0.4550989345509893,0.5190258751902588,0.0258751902587519
2008,NORTH DAKOTA,HETTINGER,406,49,893,1348,0.30118694362017806,0.6624629080118695,0.03635014836795252
2008,NORTH DAKOTA,KIDDER,422,54,752,1228,0.34364820846905536,0.6123778501628665,0.043973941368078175
2008,NORTH DAKOTA,LAMOURE,868,63,1310,2241,0.38732708612226685,0.5845604640785363,0.028112449799196786
2008,NORTH DAKOTA,LOGAN,299,32,726,1057,0.282876064333018,0.6868495742667928,0.030274361400189215
2008,NORTH DAKOTA,MCHENRY,981,61,1374,2416,0.4060430463576159,0.5687086092715232,0.025248344370860928
2008,NORTH DAKOTA,MCINTOSH,579,37,916,1532,0.3779373368146214,0.597911227154047,0.024151436031331592
2008,NORTH DAKOTA,MCKENZIE,933,42,1740,2715,0.343646408839779,0.6408839779005525,0.015469613259668509
2008,NORTH DAKOTA,MCLEAN,1867,102,2767,4736,0.39421452702702703,0.5842483108108109,0.02153716216216216
2008,NORTH DAKOTA,MERCER,1476,132,2789,4397,0.3356834205139868,0.6342961109847624,0.03002046850125085
2008,NORTH DAKOTA,MORTON,5079,316,7869,13264,0.382916164053076,0.5932599517490953,0.02382388419782871
2008,NORTH DAKOTA,MOUNTRAIL,1477,55,1406,2938,0.5027229407760381,0.4785568413886998,0.018720217835262083
2008,NORTH DAKOTA,NELSON,907,45,800,1752,0.5176940639269406,0.45662100456621,0.025684931506849314
2008,NORTH DAKOTA,OLIVER,332,26,682,1040,0.3192307692307692,0.6557692307692308,0.025
2008,NORTH DAKOTA,PEMBINA,1494,91,1722,3307,0.45176897490172363,0.5207136377381313,0.027517387360145147
2008,NORTH DAKOTA,PIERCE,792,46,1301,2139,0.3702664796633941,0.6082281439925199,0.021505376344086023
2008,NORTH DAKOTA,RAMSEY,2314,87,2361,4762,0.4859302813943721,0.49580008399832004,0.018269634607307853
2008,NORTH DAKOTA,RANSOM,1371,64,998,2433,0.5635018495684341,0.41019317714755443,0.026304973284011508
2008,NORTH DAKOTA,RENVILLE,505,42,799,1346,0.37518573551263,0.5936106983655275,0.031203566121842496
2008,NORTH DAKOTA,RICHLAND,3513,150,3900,7563,0.46449821499405,0.5156683855612852,0.019833399444664817
2008,NORTH DAKOTA,ROLETTE,3403,86,1045,4534,0.7505513895015439,0.23048081164534628,0.018967798853109837
2008,NORTH DAKOTA,SARGENT,1115,34,778,1927,0.5786196159833938,0.4037363777893098,0.017644006227296314
2008,NORTH DAKOTA,SHERIDAN,229,19,555,803,0.2851805728518057,0.6911581569115816,0.023661270236612703
2008,NORTH DAKOTA,SIOUX,1145,18,215,1378,0.8309143686502177,0.15602322206095792,0.013062409288824383
2008,NORTH DAKOTA,SLOPE,106,8,297,411,0.25790754257907544,0.7226277372262774,0.019464720194647202
2008,NORTH DAKOTA,STARK,3802,244,7024,11070,0.34345076784101175,0.6345076784101175,0.02204155374887082
2008,NORTH DAKOTA,STEELE,614,14,404,1032,0.5949612403100775,0.39147286821705424,0.013565891472868217
2008,NORTH DAKOTA,STUTSMAN,4056,229,5499,9784,0.4145543744889616,0.5620400654129191,0.02340556009811938
2008,NORTH DAKOTA,TOWNER,621,40,536,1197,0.518796992481203,0.4477861319966583,0.03341687552213868
2008,NORTH DAKOTA,TRAILL,2136,60,1845,4041,0.5285820341499629,0.45657015590200445,0.014847809948032665
2008,NORTH DAKOTA,WALSH,2325,142,2415,4882,0.47623924621056946,0.4946743138058173,0.029086439983613273
2008,NORTH DAKOTA,WARD,10144,416,15061,25621,0.39592521759494165,0.5878381015573163,0.016236680847742088
2008,NORTH DAKOTA,WELLS,841,68,1468,2377,0.3538073201514514,0.6175851914177535,0.02860748843079512
2008,NORTH DAKOTA,WILLIAMS,2921,161,6291,9373,0.31163981649418543,0.6711831857462925,0.01717699775952203
2008,OHIO,ADAMS,4170,304,6914,11388,0.36617492096944154,0.6071303126097647,0.026694766420793818
2008,OHIO,ALLEN,19521,801,29941,50263,0.38837713626325526,0.5956866880210094,0.015936175715735232
2008,OHIO,ASHLAND,9300,710,15158,25168,0.3695168467895741,0.6022727272727273,0.028210425937698666
2008,OHIO,ASHTABULA,25027,898,18949,44874,0.5577171636136738,0.42227124838436514,0.020011588001961046
2008,OHIO,ATHENS,20722,634,9742,31098,0.666345102578944,0.3132677342594379,0.02038716316161811
2008,OHIO,AUGLAIZE,6727,364,16395,23486,0.28642595588861447,0.698075449203781,0.01549859490760453
2008,OHIO,BELMONT,16302,687,15422,32411,0.5029773842214064,0.47582610841998085,0.021196507358612816
2008,OHIO,BROWN,7503,418,12192,20113,0.3730423109431711,0.6061751106249689,0.02078257843185999
2008,OHIO,BUTLER,66030,2406,105340,173776,0.3799719178712826,0.606182671945493,0.01384541018322438
2008,OHIO,CARROLL,6423,433,7097,13953,0.4603311115889056,0.5086361355980793,0.03103275281301512
2008,OHIO,CHAMPAIGN,7385,361,11141,18887,0.39100968920421453,0.5898766347222958,0.019113676073489703
2008,OHIO,CLARK,31958,1178,33634,66770,0.4786281264040737,0.5037292197094504,0.017642653886475963
2008,OHIO,CLERMONT,31611,1310,62559,95480,0.3310745705906996,0.6552052785923753,0.01372015081692501
2008,OHIO,CLINTON,6558,338,12410,19306,0.33968714389309024,0.6428053454884491,0.017507510618460582
2008,OHIO,COLUMBIANA,21882,1013,25585,48480,0.4513613861386139,0.527743399339934,0.020895214521452144
2008,OHIO,COSHOCTON,7689,499,8675,16863,0.45596868884540115,0.5144398980015419,0.029591413153056988
2008,OHIO,CRAWFORD,8288,569,12316,21173,0.3914419307608747,0.5816842204694658,0.02687384876965947
2008,OHIO,CUYAHOGA,458204,7046,199864,665114,0.6889104724904302,0.30049585484593616,0.010593672663633603
2008,OHIO,DARKE,7964,539,17290,25793,0.3087659442484395,0.6703369131159617,0.020897142635598807
2008,OHIO,DEFIANCE,8399,391,10407,19197,0.4375162785851956,0.5421159556180654,0.020367765796739074
2008,OHIO,DELAWARE,36653,985,54778,92416,0.3966088123268698,0.5927328601108033,0.01065832756232687
2008,OHIO,ERIE,23148,649,17432,41229,0.5614494651822746,0.4228091877076815,0.0157413471100439
2008,OHIO,FAIRFIELD,29250,1116,41580,71946,0.40655491618714035,0.5779334500875657,0.015511633725293971
2008,OHIO,FAYETTE,4401,191,7102,11694,0.3763468445356593,0.6073199931588849,0.01633316230545579
2008,OHIO,FRANKLIN,334684,7129,218478,560291,0.5973395967452627,0.3899366579152619,0.01272374533947538
2008,OHIO,FULTON,9900,384,11689,21973,0.45055295134938333,0.5319710553861557,0.01747599326446093
2008,OHIO,GALLIA,4777,294,8247,13318,0.35868749061420635,0.6192371226910948,0.022075386694698905
2008,OHIO,GEAUGA,21250,756,29096,51102,0.41583499667332,0.5693710617979727,0.014793941528707291
2008,OHIO,GREENE,33540,1113,48936,83589,0.40124896816566774,0.5854358827118401,0.013315149122492194
2008,OHIO,GUERNSEY,7625,503,9197,17325,0.4401154401154401,0.5308513708513708,0.029033189033189032
2008,OHIO,HAMILTON,224644,4331,195107,424082,0.5297183091949198,0.46006904325106934,0.010212647554010782
2008,OHIO,HANCOCK,13870,691,22420,36981,0.37505746193991507,0.6062572672453422,0.018685270814742704
2008,OHIO,HARDIN,5013,352,7749,13114,0.3822632301357328,0.5908952264755224,0.02684154338874485
2008,OHIO,HARRISON,3683,232,3872,7787,0.4729677667908052,0.4972389880570181,0.029793245152176705
2008,OHIO,HENRY,6320,281,8239,14840,0.42587601078167114,0.555188679245283,0.018935309973045822
2008,OHIO,HIGHLAND,6857,423,11908,19188,0.35735876589535126,0.6205962059620597,0.02204502814258912
2008,OHIO,HOCKING,6231,338,6326,12895,0.48321054672353625,0.490577743311361,0.026211709965102754
2008,OHIO,HOLMES,3141,252,7720,11113,0.28264195086835237,0.694681904076307,0.02267614505534059
2008,OHIO,HURON,12076,622,12884,25582,0.47205066062074896,0.50363536861856,0.02431397076069111
2008,OHIO,JACKSON,5397,377,8219,13993,0.3856928464232116,0.5873651111269921,0.026942042449796328
2008,OHIO,JEFFERSON,17635,745,17559,35939,0.49069256239739556,0.48857786805420295,0.02072956954840146
2008,OHIO,KNOX,11014,577,16640,28231,0.3901385002302433,0.5894229747440757,0.020438525025680988
2008,OHIO,LAKE,60155,2038,59142,121335,0.4957761569209214,0.48742737050315244,0.016796472575926154
2008,OHIO,LAWRENCE,11262,517,15415,27194,0.4141354710597926,0.566852982275502,0.01901154666470545
2008,OHIO,LICKING,33896,1501,46886,82283,0.4119441439908608,0.569813934834656,0.018241921174483186
2008,OHIO,LOGAN,7936,433,13848,22217,0.35720394292658775,0.6233064770221002,0.019489580051312058
2008,OHIO,LORAIN,85276,2515,59068,146859,0.5806658087008627,0.4022089214825104,0.017125269816626834
2008,OHIO,LUCAS,142852,3272,73706,219830,0.649829413637811,0.33528635763999454,0.014884228722194423
2008,OHIO,MADISON,6532,316,10603,17451,0.37430519740989054,0.6075869577674632,0.018107844822646265
2008,OHIO,MAHONING,79173,2540,45319,127032,0.6232524088418666,0.35675262925876944,0.01999496189936394
2008,OHIO,MARION,12870,693,15454,29017,0.44353310128545337,0.5325843471068684,0.023882551607678257
2008,OHIO,MEDINA,40924,1338,48189,90451,0.4524438646338902,0.5327635957590298,0.014792539607080076
2008,OHIO,MEIGS,4094,245,6015,10354,0.3954027429012942,0.5809349043847788,0.023662352713926985
2008,OHIO,MERCER,5853,318,15100,21271,0.275163367965775,0.7098867002021532,0.014949931832071835
2008,OHIO,MIAMI,18372,1018,33417,52807,0.34790842123203364,0.6328138314996118,0.019277747268354573
2008,OHIO,MONROE,3705,211,3066,6982,0.5306502434832426,0.4391291893440275,0.030220567172729876
2008,OHIO,MONTGOMERY,145997,3835,128679,278511,0.5242055071433445,0.462024839234357,0.01376965362229858
2008,OHIO,MORGAN,2966,202,3440,6608,0.4488498789346247,0.5205811138014528,0.030569007263922518
2008,OHIO,MORROW,6177,399,10067,16643,0.37114702878086886,0.6048789280778706,0.02397404314126059
2008,OHIO,MUSKINGUM,17730,792,20549,39071,0.45378925545801235,0.5259399554656906,0.020270789076296997
2008,OHIO,NOBLE,2474,248,3450,6172,0.40084251458198317,0.5589760207388205,0.04018146467919637
2008,OHIO,OTTAWA,12049,402,10618,23069,0.5223026572456544,0.46027135983354284,0.01742598292080281
2008,OHIO,PAULDING,4165,287,5317,9769,0.4263486539052104,0.5442726993551029,0.029378646739686765
2008,OHIO,PERRY,7261,422,7721,15404,0.4713710724487146,0.5012334458582186,0.027395481693066735
2008,OHIO,PICKAWAY,9077,421,14228,23726,0.3825760768776869,0.599679676304476,0.017744246817836973
2008,OHIO,PIKE,6033,311,6162,12506,0.48240844394690546,0.49272349272349275,0.02486806332960179
2008,OHIO,PORTAGE,41856,1527,34822,78205,0.5352087462438463,0.4452656479764721,0.019525605779681605
2008,OHIO,PREBLE,6999,441,13562,21002,0.3332539758118274,0.6457480239977145,0.02099800019045805
2008,OHIO,PUTNAM,5281,327,13072,18680,0.28270877944325484,0.6997858672376873,0.017505353319057816
2008,OHIO,RICHLAND,25727,1361,34034,61122,0.4209122738130297,0.5568207846601878,0.0222669415267825
2008,OHIO,ROSS,14455,626,16759,31840,0.45398869346733667,0.5263505025125628,0.0196608040201005
2008,OHIO,SANDUSKY,15601,582,14190,30373,0.5136469891021631,0.46719125539130146,0.01916175550653541
2008,OHIO,SCIOTO,14926,651,16994,32571,0.4582604157072242,0.5217524791992877,0.019987105093488073
2008,OHIO,SENECA,13087,539,13823,27449,0.476775110204379,0.5035884731684215,0.019636416627199532
2008,OHIO,SHELBY,7317,427,15924,23668,0.3091515970931215,0.6728071657934764,0.01804123711340206
2008,OHIO,STARK,96990,3812,86743,187545,0.5171558825881788,0.4625183289343891,0.020325788477432084
2008,OHIO,SUMMIT,155105,3455,110499,269059,0.5764720748980707,0.4106868753693428,0.012841049732586533
2008,OHIO,TRUMBULL,64145,2579,40164,106888,0.6001141381633112,0.37575780255968866,0.024128059277000225
2008,OHIO,TUSCARAWAS,21498,998,20454,42950,0.500535506402794,0.4762281722933644,0.023236321303841675
2008,OHIO,UNION,8761,423,15744,24928,0.35145218228498076,0.631578947368421,0.016968870346598202
2008,OHIO,VAN WERT,5178,306,9168,14652,0.3533988533988534,0.6257166257166257,0.020884520884520884
2008,OHIO,VINTON,2463,162,3021,5646,0.43623804463336874,0.5350690754516472,0.028692879914984058
2008,OHIO,WARREN,33398,1127,71691,106216,0.3144347367628229,0.6749548090683136,0.010610454168863448
2008,OHIO,WASHINGTON,12368,545,17019,29932,0.4132032607243084,0.5685888012829079,0.018207937992783644
2008,OHIO,WAYNE,21712,1088,29342,52142,0.41640136550189866,0.5627325380691189,0.020866096428982395
2008,OHIO,WILLIAMS,8174,343,9880,18397,0.44431157253900094,0.537044083274447,0.018644344186552156
2008,OHIO,WOOD,34285,1090,29648,65023,0.5272749642434216,0.45596173661627426,0.0167632991403042
2008,OHIO,WYANDOT,4461,246,6270,10977,0.40639518994260726,0.5711943153867177,0.022410494670675046
2008,OKLAHOMA,ADAIR,2052,0,4638,6690,0.30672645739910315,0.6932735426008969,0.0
2008,OKLAHOMA,ALFALFA,411,0,2023,2434,0.16885784716516022,0.8311421528348397,0.0
2008,OKLAHOMA,ATOKA,1370,0,3511,4881,0.280680188485966,0.719319811514034,0.0
2008,OKLAHOMA,BEAVER,265,0,2199,2464,0.1075487012987013,0.8924512987012987,0.0
2008,OKLAHOMA,BECKHAM,1625,0,5772,7397,0.21968365553602812,0.7803163444639719,0.0
2008,OKLAHOMA,BLAINE,1011,0,3101,4112,0.2458657587548638,0.7541342412451362,0.0
2008,OKLAHOMA,BRYAN,4426,0,9307,13733,0.3222893759557271,0.677710624044273,0.0
2008,OKLAHOMA,CADDO,3404,0,6413,9817,0.346745441580931,0.653254558419069,0.0
2008,OKLAHOMA,CANADIAN,11426,0,36428,47854,0.23876791908722364,0.7612320809127764,0.0
2008,OKLAHOMA,CARTER,5603,0,13241,18844,0.29733602207599236,0.7026639779240076,0.0
2008,OKLAHOMA,CHEROKEE,7194,0,9186,16380,0.4391941391941392,0.5608058608058608,0.0
2008,OKLAHOMA,CHOCTAW,1860,0,3730,5590,0.33273703041144903,0.667262969588551,0.0
2008,OKLAHOMA,CIMARRON,152,0,1119,1271,0.11959087332808813,0.8804091266719118,0.0
2008,OKLAHOMA,CLEVELAND,39681,0,64749,104430,0.37997701809824763,0.6200229819017524,0.0
2008,OKLAHOMA,COAL,600,0,1672,2272,0.2640845070422535,0.7359154929577465,0.0
2008,OKLAHOMA,COMANCHE,14120,0,20127,34247,0.41229888749379506,0.5877011125062049,0.0
2008,OKLAHOMA,COTTON,690,0,1793,2483,0.2778896496173983,0.7221103503826017,0.0
2008,OKLAHOMA,CRAIG,2073,0,3858,5931,0.3495194739504299,0.6504805260495701,0.0
2008,OKLAHOMA,CREEK,8318,0,20187,28505,0.2918084546570777,0.7081915453429223,0.0
2008,OKLAHOMA,CUSTER,2660,0,7842,10502,0.25328508855456106,0.746714911445439,0.0
2008,OKLAHOMA,DELAWARE,5085,0,10277,15362,0.3310115870329384,0.6689884129670616,0.0
2008,OKLAHOMA,DEWEY,346,0,1857,2203,0.15705855651384476,0.8429414434861553,0.0
2008,OKLAHOMA,ELLIS,282,0,1627,1909,0.14772132006286012,0.8522786799371399,0.0
2008,OKLAHOMA,GARFIELD,5545,0,17067,22612,0.2452237749867327,0.7547762250132672,0.0
2008,OKLAHOMA,GARVIN,3028,0,7710,10738,0.2819891972434345,0.7180108027565655,0.0
2008,OKLAHOMA,GRADY,5520,0,15195,20715,0.2664735698769008,0.7335264301230991,0.0
2008,OKLAHOMA,GRANT,514,0,1836,2350,0.21872340425531914,0.7812765957446809,0.0
2008,OKLAHOMA,GREER,566,0,1548,2114,0.26773888363292336,0.7322611163670766,0.0
2008,OKLAHOMA,HARMON,333,0,757,1090,0.3055045871559633,0.6944954128440367,0.0
2008,OKLAHOMA,HARPER,221,0,1342,1563,0.1413947536788228,0.8586052463211772,0.0
2008,OKLAHOMA,HASKELL,1474,0,3207,4681,0.314889980773339,0.6851100192266609,0.0
2008,OKLAHOMA,HUGHES,1709,0,3134,4843,0.35288044600454266,0.6471195539954574,0.0
2008,OKLAHOMA,JACKSON,2264,0,6719,8983,0.252031615273294,0.747968384726706,0.0
2008,OKLAHOMA,JEFFERSON,805,0,1652,2457,0.32763532763532766,0.6723646723646723,0.0
2008,OKLAHOMA,JOHNSTON,1249,0,2708,3957,0.31564316401314124,0.6843568359868587,0.0
2008,OKLAHOMA,KAY,5463,0,13230,18693,0.29224843524313915,0.7077515647568609,0.0
2008,OKLAHOMA,KINGFISHER,1009,0,5372,6381,0.15812568562921173,0.8418743143707883,0.0
2008,OKLAHOMA,KIOWA,1226,0,2537,3763,0.325803879883072,0.674196120116928,0.0
2008,OKLAHOMA,LATIMER,1313,0,2860,4173,0.3146417445482866,0.6853582554517134,0.0
2008,OKLAHOMA,LE FLORE,5136,0,11605,16741,0.3067917089779583,0.6932082910220417,0.0
2008,OKLAHOMA,LINCOLN,3504,0,10470,13974,0.2507513954486904,0.7492486045513096,0.0
2008,OKLAHOMA,LOGAN,5717,0,12556,18273,0.31286597712471953,0.6871340228752805,0.0
2008,OKLAHOMA,LOVE,1257,0,2589,3846,0.32683307332293293,0.6731669266770671,0.0
2008,OKLAHOMA,MAJOR,515,0,2956,3471,0.14837222702391242,0.8516277729760876,0.0
2008,OKLAHOMA,MARSHALL,1643,0,3730,5373,0.3057882002605621,0.6942117997394379,0.0
2008,OKLAHOMA,MAYES,5749,0,10234,15983,0.35969467559281737,0.6403053244071827,0.0
2008,OKLAHOMA,MCCLAIN,3551,0,11193,14744,0.24084373304395007,0.7591562669560499,0.0
2008,OKLAHOMA,MCCURTAIN,2794,0,7745,10539,0.26511054179713445,0.7348894582028656,0.0
2008,OKLAHOMA,MCINTOSH,3320,0,4903,8223,0.4037455916332239,0.5962544083667761,0.0
2008,OKLAHOMA,MURRAY,1592,0,3746,5338,0.29823904083926567,0.7017609591607343,0.0
2008,OKLAHOMA,MUSKOGEE,11294,0,15289,26583,0.42485799194974233,0.5751420080502577,0.0
2008,OKLAHOMA,NOBLE,1174,0,3881,5055,0.23224530168150345,0.7677546983184965,0.0
2008,OKLAHOMA,NOWATA,1411,0,3031,4442,0.31764970733903647,0.6823502926609635,0.0
2008,OKLAHOMA,OKFUSKEE,1480,0,2643,4123,0.35896192093136065,0.6410380790686393,0.0
2008,OKLAHOMA,OKLAHOMA,116182,0,163172,279354,0.41589524402729156,0.5841047559727085,0.0
2008,OKLAHOMA,OKMULGEE,6191,0,8727,14918,0.41500201099343076,0.5849979890065693,0.0
2008,OKLAHOMA,OSAGE,7498,0,12160,19658,0.38142232170108864,0.6185776782989114,0.0
2008,OKLAHOMA,OTTAWA,4268,0,6905,11173,0.3819923028729974,0.6180076971270025,0.0
2008,OKLAHOMA,PAWNEE,2063,0,4533,6596,0.3127653123104912,0.6872346876895088,0.0
2008,OKLAHOMA,PAYNE,10601,0,18435,29036,0.36509849841575975,0.6349015015842403,0.0
2008,OKLAHOMA,PITTSBURG,5457,0,11752,17209,0.31710151664826547,0.6828984833517345,0.0
2008,OKLAHOMA,PONTOTOC,4512,0,9750,14262,0.3163651661758519,0.6836348338241481,0.0
2008,OKLAHOMA,POTTAWATOMIE,7910,0,17753,25663,0.3082258504461676,0.6917741495538323,0.0
2008,OKLAHOMA,PUSHMATAHA,1265,0,3208,4473,0.2828079588642969,0.7171920411357031,0.0
2008,OKLAHOMA,ROGER MILLS,287,0,1502,1789,0.16042481833426495,0.8395751816657351,0.0
2008,OKLAHOMA,ROGERS,10772,0,27743,38515,0.27968324029598857,0.7203167597040114,0.0
2008,OKLAHOMA,SEMINOLE,2977,0,5600,8577,0.34709105747930513,0.6529089425206949,0.0
2008,OKLAHOMA,SEQUOYAH,4454,0,9466,13920,0.3199712643678161,0.6800287356321839,0.0
2008,OKLAHOMA,STEPHENS,4538,0,14394,18932,0.23969997887175154,0.7603000211282485,0.0
2008,OKLAHOMA,TEXAS,923,0,5336,6259,0.14746764658891195,0.852532353411088,0.0
2008,OKLAHOMA,TILLMAN,1042,0,2195,3237,0.3219029966017918,0.6780970033982082,0.0
2008,OKLAHOMA,TULSA,96133,0,158363,254496,0.3777387463850119,0.6222612536149881,0.0
2008,OKLAHOMA,WAGONER,8810,0,21441,30251,0.29123004198208324,0.7087699580179168,0.0
2008,OKLAHOMA,WASHINGTON,6308,0,16457,22765,0.27709202723479026,0.7229079727652098,0.0
2008,OKLAHOMA,WASHITA,1052,0,3724,4776,0.2202680067001675,0.7797319932998324,0.0
2008,OKLAHOMA,WOODS,873,0,3043,3916,0.22293156281920326,0.7770684371807968,0.0
2008,OKLAHOMA,WOODWARD,1350,0,6404,7754,0.17410368841888058,0.8258963115811194,0.0
2008,OREGON,BAKER,2805,322,5650,8777,0.31958527970832856,0.6437279252592002,0.03668679503247123
2008,OREGON,BENTON,29901,1313,15264,46478,0.6433366323852145,0.3284134429192306,0.028249924695554887
2008,OREGON,CLACKAMAS,103476,4807,83595,191878,0.5392801676065,0.4356674553622614,0.0250523770312386
2008,OREGON,CLATSOP,10701,655,7192,18548,0.5769355186543024,0.3877507008841924,0.03531378046150528
2008,OREGON,COLUMBIA,13390,965,10413,24768,0.5406169250645995,0.420421511627907,0.03896156330749354
2008,OREGON,COOS,14401,1196,15354,30951,0.4652838357403638,0.49607444024425706,0.038641724015379145
2008,OREGON,CROOK,3632,349,6371,10352,0.3508500772797527,0.6154366306027821,0.033713292117465224
2008,OREGON,CURRY,5230,456,6646,12332,0.42409990269218295,0.5389231268245216,0.03697697048329549
2008,OREGON,DESCHUTES,38819,1899,39064,79782,0.4865633852247374,0.4896342533403525,0.02380236143491013
2008,OREGON,DOUGLAS,20298,1720,30919,52937,0.38343691557889564,0.5840716323176606,0.032491452103443716
2008,OREGON,GILLIAM,430,32,648,1110,0.38738738738738737,0.5837837837837838,0.02882882882882883
2008,OREGON,GRANT,1006,118,2785,3909,0.2573548222051676,0.7124584292657968,0.030186748529035558
2008,OREGON,HARNEY,950,138,2595,3683,0.25794189519413524,0.7045886505566115,0.037469454249253326
2008,OREGON,HOOD RIVER,6302,263,3265,9830,0.6410986775178027,0.33214649033570703,0.026754832146490336
2008,OREGON,JACKSON,49090,2914,49043,101047,0.4858135323166447,0.4853484022286659,0.0288380654546894
2008,OREGON,JEFFERSON,3682,234,4402,8318,0.4426544842510219,0.5292137533060832,0.028131762442894927
2008,OREGON,JOSEPHINE,17412,1664,22973,42049,0.41408832552498276,0.5463387952151062,0.039572879259911056
2008,OREGON,KLAMATH,9370,916,19113,29399,0.3187183237525086,0.6501241538827851,0.031157522364706283
2008,OREGON,LAKE,957,93,2638,3688,0.25949023861171366,0.71529284164859,0.025216919739696312
2008,OREGON,LANE,114037,5038,63835,182910,0.6234596249521622,0.3489967743699087,0.027543600677929037
2008,OREGON,LINCOLN,14258,840,8791,23889,0.5968437356105321,0.36799363723889655,0.03516262715057139
2008,OREGON,LINN,22163,1748,28071,51982,0.4263591243122619,0.5400138509484053,0.03362702473933284
2008,OREGON,MALHEUR,2949,327,7157,10433,0.282660787884597,0.685996357711109,0.03134285440429407
2008,OREGON,MARION,61816,3688,59059,124563,0.4962629352215345,0.47412955693103087,0.02960750784743463
2008,OREGON,MORROW,1410,139,2509,4058,0.34746180384425823,0.61828486939379,0.034253326761951704
2008,OREGON,MULTNOMAH,279696,9843,75171,364710,0.7668997285514518,0.20611170519042527,0.026988566258122893
2008,OREGON,POLK,17536,957,17714,36207,0.4843262352583754,0.48924241168834753,0.02643135305327699
2008,OREGON,SHERMAN,385,28,634,1047,0.36771728748806115,0.6055396370582617,0.026743075453677174
2008,OREGON,TILLAMOOK,7072,468,5757,13297,0.5318492893133789,0.4329548018350004,0.03519590885162067
2008,OREGON,UMATILLA,9484,785,15254,25523,0.37158641225561256,0.597657015241155,0.03075657250323238
2008,OREGON,UNION,4613,400,7581,12594,0.36628553279339365,0.6019533111005241,0.03176115610608226
2008,OREGON,WALLOWA,1492,137,2836,4465,0.3341545352743561,0.6351623740201567,0.030683090705487123
2008,OREGON,WASCO,5906,371,5103,11380,0.5189806678383129,0.4484182776801406,0.03260105448154657
2008,OREGON,WASHINGTON,141544,5903,89185,236632,0.5981608573650224,0.37689323506541805,0.024945907569559486
2008,OREGON,WHEELER,281,33,498,812,0.3460591133004926,0.6133004926108374,0.04064039408866995
2008,OREGON,YAMHILL,20797,1339,21390,43526,0.4778063686072692,0.4914304094104673,0.030763221982263476
2008,PENNSYLVANIA,ADAMS,17633,507,26349,44489,0.396345163973117,0.592258760592506,0.011396075434377036
2008,PENNSYLVANIA,ALLEGHENY,373153,5880,272347,651380,0.5728653013601891,0.41810770978537876,0.009026988854432129
2008,PENNSYLVANIA,ARMSTRONG,11138,392,18542,30072,0.3703777600425645,0.6165868582069699,0.01303538175046555
2008,PENNSYLVANIA,BEAVER,40499,1069,42895,84463,0.47948805986053067,0.5078555106969915,0.012656429442477772
2008,PENNSYLVANIA,BEDFORD,6059,258,16124,22441,0.2699968807094158,0.7185063054231094,0.011496813867474712
2008,PENNSYLVANIA,BERKS,97047,2336,80513,179896,0.5394616889758527,0.4475530306399253,0.012985280384221995
2008,PENNSYLVANIA,BLAIR,19813,560,32708,53081,0.373259735121795,0.6161903505962586,0.01054991428194646
2008,PENNSYLVANIA,BRADFORD,10306,419,15057,25782,0.3997362500969669,0.5840121014661391,0.016251648436893956
2008,PENNSYLVANIA,BUCKS,179031,3644,150248,332923,0.5377549763759187,0.451299549745737,0.010945473878344242
2008,PENNSYLVANIA,BUTLER,32260,1021,57074,90355,0.3570361352443141,0.6316639920314315,0.01129987272425433
2008,PENNSYLVANIA,CAMBRIA,32451,1176,31995,65622,0.49451403492731094,0.4875651458352382,0.017920819237450855
2008,PENNSYLVANIA,CAMERON,879,109,1323,2311,0.38035482475119,0.5724794461272177,0.047165729121592385
2008,PENNSYLVANIA,CARBON,13464,498,12957,26919,0.5001671681711802,0.4813328875515435,0.018499944277276272
2008,PENNSYLVANIA,CENTRE,41950,795,32992,75737,0.5538904366425921,0.4356127124126913,0.010496850944716585
2008,PENNSYLVANIA,CHESTER,137833,2051,114421,254305,0.5419987809913293,0.4499361003519396,0.008065118656731091
2008,PENNSYLVANIA,CLARION,6756,272,10737,17765,0.38029833943146635,0.6043906557838447,0.015311004784688996
2008,PENNSYLVANIA,CLEARFIELD,14555,557,18662,33774,0.43095280393201874,0.5525552199917096,0.01649197607627169
2008,PENNSYLVANIA,CLINTON,7097,192,7504,14793,0.47975393767322383,0.507266950584736,0.012979111742040155
2008,PENNSYLVANIA,COLUMBIA,13230,334,14477,28041,0.47180913662137586,0.5162797332477443,0.011911130130879783
2008,PENNSYLVANIA,CRAWFORD,16780,544,20750,38074,0.4407207017912486,0.5449913326679624,0.01428796554078899
2008,PENNSYLVANIA,CUMBERLAND,48306,1253,63739,113298,0.426362336493142,0.5625783332450706,0.011059330261787499
2008,PENNSYLVANIA,DAUPHIN,69975,1313,58238,129526,0.5402390253694239,0.4496240137115328,0.010136960919043281
2008,PENNSYLVANIA,DELAWARE,169030,2730,109322,281082,0.6013547648017304,0.3889327669505696,0.00971246824769996
2008,PENNSYLVANIA,ELK,7290,292,6676,14258,0.5112919062982185,0.46822836302426707,0.02047973067751438
2008,PENNSYLVANIA,ERIE,75775,1516,50351,127642,0.5936525595023582,0.3944704721016593,0.011876968395982514
2008,PENNSYLVANIA,FAYETTE,25866,607,26081,52554,0.4921794725425277,0.49627050272101075,0.011550024736461544
2008,PENNSYLVANIA,FOREST,1038,40,1366,2444,0.4247135842880524,0.5589198036006546,0.016366612111292964
2008,PENNSYLVANIA,FRANKLIN,21169,560,41906,63635,0.3326628427752023,0.6585369686493282,0.008800188575469475
2008,PENNSYLVANIA,FULTON,1576,88,4642,6306,0.2499207104345068,0.7361243260386933,0.013954963526799874
2008,PENNSYLVANIA,GREENE,7829,243,7889,15961,0.49050811352672136,0.4942672764864357,0.01522460998684293
2008,PENNSYLVANIA,HUNTINGDON,6621,280,11745,18646,0.35508956344524295,0.6298938110050413,0.015016625549715756
2008,PENNSYLVANIA,INDIANA,17065,507,19727,37299,0.4575189683369527,0.5288881739456822,0.013592857717365077
2008,PENNSYLVANIA,JEFFERSON,6447,297,12057,18801,0.34290729216531035,0.6412956757619276,0.015797032072762087
2008,PENNSYLVANIA,JUNIATA,3068,159,6484,9711,0.31593038821954483,0.6676964267325713,0.016373185047883845
2008,PENNSYLVANIA,LACKAWANNA,67520,858,39488,107866,0.6259618415441381,0.3660838447703632,0.007954313685498674
2008,PENNSYLVANIA,LANCASTER,99586,1943,126568,228097,0.436594957408471,0.5548867367830352,0.008518305808493755
2008,PENNSYLVANIA,LAWRENCE,19711,522,21851,42084,0.46837277825301776,0.5192234578462124,0.01240376390076989
2008,PENNSYLVANIA,LEBANON,23310,628,34314,58252,0.4001579344915196,0.5890613197830118,0.010780745725468653
2008,PENNSYLVANIA,LEHIGH,87089,1993,63382,152464,0.5712102529121629,0.41571780879420717,0.013071938293629971
2008,PENNSYLVANIA,LUZERNE,72492,1544,61127,135163,0.5363302087109638,0.45224654676205767,0.011423244526978536
2008,PENNSYLVANIA,LYCOMING,18381,574,30280,49235,0.37333197928303036,0.6150096476084087,0.011658373108560983
2008,PENNSYLVANIA,MCKEAN,6465,258,9224,15947,0.40540540540540543,0.5784160030099705,0.016178591584624067
2008,PENNSYLVANIA,MERCER,26411,820,26565,53796,0.49094728232582346,0.4938099486950703,0.015242768979106253
2008,PENNSYLVANIA,MIFFLIN,5375,197,10929,16501,0.32573783407066237,0.6623234955457244,0.011938670383613114
2008,PENNSYLVANIA,MONROE,39453,639,28293,68385,0.576924764202676,0.4137310813774951,0.00934415441982891
2008,PENNSYLVANIA,MONTGOMERY,253393,3466,165552,422411,0.5998731093650497,0.39192161188984187,0.008205278745108437
2008,PENNSYLVANIA,MONTOUR,3364,85,4574,8023,0.4192945282313349,0.5701109310731647,0.010594540695500436
2008,PENNSYLVANIA,NORTHAMPTON,75255,1775,58551,135581,0.5550556493904013,0.43185254571068216,0.013091804898916514
2008,PENNSYLVANIA,NORTHUMBERLAND,14329,569,19018,33916,0.42248496284939263,0.5607382946102135,0.016776742540393914
2008,PENNSYLVANIA,PERRY,6396,279,13058,19733,0.32412709674149903,0.6617341509147114,0.014138752343789592
2008,PENNSYLVANIA,PHILADELPHIA,595980,3954,117221,717155,0.8310337374765566,0.16345281006198104,0.005513452461462306
2008,PENNSYLVANIA,PIKE,11493,286,12518,24297,0.4730213606618101,0.5152076388031445,0.011771000535045479
2008,PENNSYLVANIA,POTTER,2300,98,5109,7507,0.3063807113360863,0.6805648061808979,0.013054482483015852
2008,PENNSYLVANIA,SCHUYLKILL,28300,987,33767,63054,0.4488216449392584,0.5355251054651569,0.015653249595584735
2008,PENNSYLVANIA,SNYDER,5382,197,9900,15479,0.3476968796433878,0.6395762000129207,0.012726920343691453
2008,PENNSYLVANIA,SOMERSET,12878,603,21686,35167,0.3661955810845395,0.6166576620126824,0.017146756902778174
2008,PENNSYLVANIA,SULLIVAN,1233,46,1841,3120,0.3951923076923077,0.5900641025641026,0.014743589743589743
2008,PENNSYLVANIA,SUSQUEHANNA,8381,269,10633,19283,0.43463154073536275,0.5514183477674636,0.013950111497173677
2008,PENNSYLVANIA,TIOGA,6390,249,11326,17965,0.35569162259949905,0.6304480935151684,0.013860283885332591
2008,PENNSYLVANIA,UNION,7333,208,9859,17400,0.4214367816091954,0.5666091954022988,0.011954022988505748
2008,PENNSYLVANIA,VENANGO,9238,332,13718,23288,0.3966849879766403,0.589058742700103,0.014256269323256613
2008,PENNSYLVANIA,WARREN,8537,272,9685,18494,0.46160917054179734,0.523683356764356,0.014707472693846653
2008,PENNSYLVANIA,WASHINGTON,46122,1128,50752,98002,0.4706230485092141,0.5178669823064835,0.011509969184302362
2008,PENNSYLVANIA,WAYNE,9892,239,12702,22833,0.43323260193579466,0.5563000919721456,0.010467306092059737
2008,PENNSYLVANIA,WESTMORELAND,72721,1770,102294,176785,0.4113527731425177,0.5786350651921826,0.010012161665299658
2008,PENNSYLVANIA,WYOMING,5985,161,6983,13129,0.4558610709117221,0.531875999695331,0.012262929392946912
2008,PENNSYLVANIA,YORK,82839,2076,109268,194183,0.4266027407136567,0.5627063131170081,0.010690946169335112
2008,RHODE ISLAND,BRISTOL,16162,483,9260,25905,0.6238950009650647,0.3574599498166377,0.018645049218297627
2008,RHODE ISLAND,FEDERAL PRECINCT,0,0,0,0,,,
2008,RHODE ISLAND,KENT,48406,1888,33780,84074,0.5757546922948831,0.4017889002545377,0.022456407450579252
2008,RHODE ISLAND,NEWPORT,25479,801,15717,41997,0.6066861918708479,0.3742410172155154,0.01907279091363669
2008,RHODE ISLAND,PROVIDENCE,167442,5178,81010,253630,0.6601821551078343,0.31940227891022355,0.020415565981942198
2008,RHODE ISLAND,WASHINGTON,39082,1454,25624,66160,0.5907194679564691,0.38730350665054414,0.0219770253929867
2008,SOUTH CAROLINA,ABBEVILLE,4593,144,6264,11001,0.41750749931824377,0.5694027815653122,0.01308971911644396
2008,SOUTH CAROLINA,AIKEN,26101,820,42849,69770,0.37410061631073527,0.6141464812956858,0.011752902393578903
2008,SOUTH CAROLINA,ALLENDALE,3029,48,947,4024,0.7527335984095428,0.235337972166998,0.011928429423459244
2008,SOUTH CAROLINA,ANDERSON,24132,965,48690,73787,0.32704948026075054,0.659872335235204,0.013078184504045428
2008,SOUTH CAROLINA,BAMBERG,4426,79,2309,6814,0.6495450542999707,0.3388611681831523,0.011593777516877018
2008,SOUTH CAROLINA,BARNWELL,4931,98,4769,9798,0.5032659726474791,0.48673198611961627,0.010002041232904674
2008,SOUTH CAROLINA,BEAUFORT,30396,653,37821,68870,0.4413532742848846,0.5491650936547118,0.00948163206040366
2008,SOUTH CAROLINA,BERKELEY,27755,821,36205,64781,0.4284435251076705,0.5588830058196076,0.01267346907272194
2008,SOUTH CAROLINA,CALHOUN,3970,73,3695,7738,0.5130524683380718,0.4775135693977772,0.009433962264150943
2008,SOUTH CAROLINA,CHARLESTON,82698,1914,69822,154434,0.5354908893119391,0.452115466801352,0.012393643886708886
2008,SOUTH CAROLINA,CHEROKEE,7215,246,13305,20766,0.34744293556775496,0.6407107772320139,0.011846287200231146
2008,SOUTH CAROLINA,CHESTER,7478,185,6318,13981,0.5348687504470353,0.451899005793577,0.013232243759387741
2008,SOUTH CAROLINA,CHESTERFIELD,7842,192,8325,16359,0.4793691545938016,0.5088941866862278,0.011736658719970658
2008,SOUTH CAROLINA,CLARENDON,8673,121,6758,15552,0.5576774691358025,0.43454218106995884,0.007780349794238683
2008,SOUTH CAROLINA,COLLETON,8616,180,8525,17321,0.49743086426880667,0.49217712603198427,0.010392009699209052
2008,SOUTH CAROLINA,DARLINGTON,14505,285,14544,29334,0.49447739824094905,0.4958069134792391,0.009715688279811823
2008,SOUTH CAROLINA,DILLON,7408,135,5874,13417,0.5521353506745174,0.43780278750838486,0.010061861817097712
2008,SOUTH CAROLINA,DORCHESTER,21806,670,29929,52405,0.4161053334605477,0.5711096269439939,0.012785039595458448
2008,SOUTH CAROLINA,EDGEFIELD,5075,111,6334,11520,0.4405381944444444,0.5498263888888889,0.009635416666666667
2008,SOUTH CAROLINA,FAIRFIELD,7591,116,3912,11619,0.6533264480592134,0.33668990446682157,0.009983647473965056
2008,SOUTH CAROLINA,FLORENCE,28012,500,29861,58373,0.47987939629623283,0.5115549997430319,0.00856560396073527
2008,SOUTH CAROLINA,GEORGETOWN,14199,301,15790,30290,0.4687685704853087,0.5212941564872895,0.009937273027401782
2008,SOUTH CAROLINA,GREENVILLE,70886,3408,116363,190657,0.3717985702072308,0.6103263976670146,0.017875032125754628
2008,SOUTH CAROLINA,GREENWOOD,12348,324,16995,29667,0.4162200424714329,0.5728587319243604,0.010921225604206695
2008,SOUTH CAROLINA,HAMPTON,5816,95,3439,9350,0.6220320855614974,0.36780748663101603,0.010160427807486631
2008,SOUTH CAROLINA,HORRY,38879,1310,64609,104798,0.3709899043874883,0.6165098570583408,0.012500238554170881
2008,SOUTH CAROLINA,JASPER,5389,100,3365,8854,0.6086514569686018,0.38005421278518187,0.0112943302462164
2008,SOUTH CAROLINA,KERSHAW,11226,293,16466,27985,0.40114346971591924,0.5883866356976952,0.010469894586385564
2008,SOUTH CAROLINA,LANCASTER,12139,341,16441,28921,0.41972960824314515,0.5684796514643339,0.011790740292521005
2008,SOUTH CAROLINA,LAURENS,10578,370,15334,26282,0.4024807853283616,0.5834411384217335,0.014078076249904878
2008,SOUTH CAROLINA,LEE,5960,119,3074,9153,0.6511526275538075,0.33584617065443023,0.013001201791762264
2008,SOUTH CAROLINA,LEXINGTON,33303,1249,74960,109512,0.3041036598728906,0.6844911973117102,0.011405142815399226
2008,SOUTH CAROLINA,MARION,9608,150,5416,15174,0.6331883484908396,0.3569263213391327,0.009885330170027679
2008,SOUTH CAROLINA,MARLBORO,6794,86,3996,10876,0.6246781905112173,0.367414490621552,0.0079073188672306
2008,SOUTH CAROLINA,MCCORMICK,2755,40,2437,5232,0.5265672782874617,0.4657874617737003,0.00764525993883792
2008,SOUTH CAROLINA,NEWBERRY,6708,200,9616,16524,0.4059549745824256,0.5819414185427257,0.012103606874848705
2008,SOUTH CAROLINA,OCONEE,9481,487,21164,31132,0.30454195040472826,0.6798149813696518,0.015643068225619942
2008,SOUTH CAROLINA,ORANGEBURG,27263,376,12115,39754,0.6857926246415456,0.3047492076269055,0.009458167731549026
2008,SOUTH CAROLINA,PICKENS,11691,885,32552,45128,0.2590631093777699,0.7213260060273001,0.019610884594929975
2008,SOUTH CAROLINA,RICHLAND,105656,1440,57941,165037,0.640195834873392,0.35107884898537906,0.008725316141228937
2008,SOUTH CAROLINA,SALUDA,3323,89,5191,8603,0.38626060676508195,0.6033941648262234,0.010345228408694642
2008,SOUTH CAROLINA,SPARTANBURG,41632,1654,65042,108328,0.3843143047042316,0.6004172513108338,0.015268443984934642
2008,SOUTH CAROLINA,SUMTER,25431,346,18581,44358,0.5733125929933721,0.4188872356733847,0.007800171333243158
2008,SOUTH CAROLINA,UNION,5935,167,7449,13551,0.4379750571913512,0.5497011290679654,0.012323813740683344
2008,SOUTH CAROLINA,WILLIAMSBURG,11279,160,5004,16443,0.6859453870948123,0.3043240284619595,0.009730584443228121
2008,SOUTH CAROLINA,YORK,37918,1278,54500,93696,0.40469176912568305,0.5816683743169399,0.01363985655737705
2008,SOUTH DAKOTA,AURORA,655,19,794,1468,0.44618528610354224,0.5408719346049047,0.012942779291553134
2008,SOUTH DAKOTA,BEADLE,3493,83,4054,7630,0.4577981651376147,0.5313237221494103,0.010878112712975098
2008,SOUTH DAKOTA,BENNETT,557,18,614,1189,0.46846089150546677,0.5164003364171573,0.015138772077375946
2008,SOUTH DAKOTA,BON HOMME,1367,37,1712,3116,0.43870346598202825,0.5494223363286265,0.011874197689345315
2008,SOUTH DAKOTA,BROOKINGS,7207,151,6431,13789,0.5226629922401914,0.466386249909348,0.010950757850460511
2008,SOUTH DAKOTA,BROWN,9041,145,8067,17253,0.5240248072798933,0.46757085724221875,0.008404335477887903
2008,SOUTH DAKOTA,BRULE,965,34,1407,2406,0.4010806317539485,0.5847880299251871,0.014131338320864505
2008,SOUTH DAKOTA,BUFFALO,454,2,156,612,0.7418300653594772,0.2549019607843137,0.0032679738562091504
2008,SOUTH DAKOTA,BUTTE,1306,78,2821,4205,0.31058263971462546,0.6708680142687277,0.01854934601664685
2008,SOUTH DAKOTA,CAMPBELL,243,10,591,844,0.28791469194312796,0.7002369668246445,0.011848341232227487
2008,SOUTH DAKOTA,CHARLES MIX,1807,21,2109,3937,0.4589789179578359,0.5356870713741427,0.005334010668021336
2008,SOUTH DAKOTA,CLARK,830,25,1065,1920,0.4322916666666667,0.5546875,0.013020833333333334
2008,SOUTH DAKOTA,CLAY,3808,55,2296,6159,0.6182821886669914,0.372787790225686,0.008930021107322618
2008,SOUTH DAKOTA,CODINGTON,5595,107,6374,12076,0.4633156674395495,0.5278237827095065,0.00886054985094402
2008,SOUTH DAKOTA,CORSON,837,18,535,1390,0.602158273381295,0.38489208633093525,0.012949640287769784
2008,SOUTH DAKOTA,CUSTER,1475,66,2909,4450,0.33146067415730335,0.6537078651685393,0.014831460674157304
2008,SOUTH DAKOTA,DAVISON,3554,80,4731,8365,0.42486551105797965,0.5655708308427974,0.009563658099222952
2008,SOUTH DAKOTA,DAY,1785,21,1372,3178,0.5616740088105727,0.43171806167400884,0.006607929515418502
2008,SOUTH DAKOTA,DEUEL,1054,36,1088,2178,0.4839302112029385,0.4995408631772268,0.01652892561983471
2008,SOUTH DAKOTA,DEWEY,1328,18,659,2005,0.6623441396508728,0.3286783042394015,0.008977556109725686
2008,SOUTH DAKOTA,DOUGLAS,424,18,1293,1735,0.24438040345821327,0.7452449567723343,0.01037463976945245
2008,SOUTH DAKOTA,EDMUNDS,819,21,1213,2053,0.3989283974671213,0.590842669264491,0.010228933268387726
2008,SOUTH DAKOTA,FALL RIVER,1338,69,2348,3755,0.3563249001331558,0.6252996005326231,0.01837549933422104
2008,SOUTH DAKOTA,FAULK,426,9,739,1174,0.3628620102214651,0.6294718909710392,0.007666098807495741
2008,SOUTH DAKOTA,GRANT,1786,37,1951,3774,0.4732379438261791,0.5169581346051935,0.00980392156862745
2008,SOUTH DAKOTA,GREGORY,771,24,1423,2218,0.34761045987376016,0.6415689810640216,0.010820559062218215
2008,SOUTH DAKOTA,HAAKON,187,15,939,1141,0.16389132340052587,0.8229623137598597,0.013146362839614373
2008,SOUTH DAKOTA,HAMLIN,1043,33,1661,2737,0.38107416879795397,0.6068688344903179,0.01205699671172817
2008,SOUTH DAKOTA,HAND,718,16,1247,1981,0.3624432104997476,0.6294800605754669,0.008076728924785462
2008,SOUTH DAKOTA,HANSON,961,27,1426,2414,0.3980944490472245,0.5907207953603977,0.011184755592377795
2008,SOUTH DAKOTA,HARDING,135,12,575,722,0.18698060941828254,0.796398891966759,0.01662049861495845
2008,SOUTH DAKOTA,HUGHES,3037,51,5298,8386,0.36215120438826615,0.6317672310994514,0.006081564512282376
2008,SOUTH DAKOTA,HUTCHINSON,1242,34,2285,3561,0.34877843302443134,0.6416736871665263,0.009547879809042405
2008,SOUTH DAKOTA,HYDE,226,3,547,776,0.2912371134020619,0.7048969072164949,0.003865979381443299
2008,SOUTH DAKOTA,JACKSON,435,15,668,1118,0.389087656529517,0.5974955277280859,0.013416815742397137
2008,SOUTH DAKOTA,JERAULD,542,4,546,1092,0.49633699633699635,0.5,0.003663003663003663
2008,SOUTH DAKOTA,JONES,147,8,463,618,0.23786407766990292,0.7491909385113269,0.012944983818770227
2008,SOUTH DAKOTA,KINGSBURY,1277,27,1435,2739,0.46622855056589996,0.5239138371668492,0.009857612267250822
2008,SOUTH DAKOTA,LAKE,3033,50,2993,6076,0.49917709019091505,0.4925938117182357,0.008229098090849244
2008,SOUTH DAKOTA,LAWRENCE,4932,157,6787,11876,0.4152913438868306,0.571488716739643,0.01321993937352644
2008,SOUTH DAKOTA,LINCOLN,8642,156,11803,20601,0.4194941993107131,0.5729333527498666,0.007572447939420417
2008,SOUTH DAKOTA,LYMAN,710,19,894,1623,0.4374614910659273,0.5508317929759704,0.01170671595810228
2008,SOUTH DAKOTA,MARSHALL,1261,16,900,2177,0.5792374827744603,0.41341295360587965,0.007349563619660083
2008,SOUTH DAKOTA,MCCOOK,1219,40,1646,2905,0.4196213425129088,0.5666092943201377,0.013769363166953529
2008,SOUTH DAKOTA,MCPHERSON,441,8,915,1364,0.32331378299120234,0.6708211143695014,0.005865102639296188
2008,SOUTH DAKOTA,MEADE,3751,199,7515,11465,0.32716964675098126,0.6554731792411688,0.017357174007849977
2008,SOUTH DAKOTA,MELLETTE,373,11,445,829,0.4499396863691194,0.5367913148371531,0.013268998793727383
2008,SOUTH DAKOTA,MINER,605,16,577,1198,0.505008347245409,0.48163606010016696,0.01335559265442404
2008,SOUTH DAKOTA,MINNEHAHA,39838,709,39251,79798,0.4992355698137798,0.49187949572670997,0.008884934459510264
2008,SOUTH DAKOTA,MOODY,1663,32,1508,3203,0.5192007492975336,0.47080861692163595,0.009990633780830472
2008,SOUTH DAKOTA,OGLALA LAKOTA,2971,12,331,3314,0.8964996982498491,0.09987929993964997,0.003621001810500905
2008,SOUTH DAKOTA,PENNINGTON,17802,382,27603,45787,0.38880031449974883,0.6028567060519361,0.008342979448315024
2008,SOUTH DAKOTA,PERKINS,499,55,1102,1656,0.30132850241545894,0.6654589371980676,0.03321256038647343
2008,SOUTH DAKOTA,POTTER,482,15,937,1434,0.33612273361227335,0.6534170153417015,0.010460251046025104
2008,SOUTH DAKOTA,ROBERTS,2672,31,1781,4484,0.5958965209634255,0.3971900089206066,0.006913470115967886
2008,SOUTH DAKOTA,SANBORN,500,12,669,1181,0.42337002540220153,0.5664690939881456,0.010160880609652836
2008,SOUTH DAKOTA,SPINK,1550,29,1660,3239,0.47854276011114544,0.5125038592158073,0.008953380673047236
2008,SOUTH DAKOTA,STANLEY,510,13,1017,1540,0.33116883116883117,0.6603896103896104,0.008441558441558441
2008,SOUTH DAKOTA,SULLY,233,9,581,823,0.28311057108140947,0.7059538274605103,0.010935601458080195
2008,SOUTH DAKOTA,TODD,2208,28,571,2807,0.7866049162807267,0.2034200213751336,0.00997506234413965
2008,SOUTH DAKOTA,TRIPP,914,36,1859,2809,0.32538269846920614,0.6618013527945888,0.012815948736205056
2008,SOUTH DAKOTA,TURNER,1681,47,2538,4266,0.39404594467885606,0.5949367088607594,0.011017346460384434
2008,SOUTH DAKOTA,UNION,3244,66,4310,7620,0.42572178477690287,0.5656167979002624,0.008661417322834646
2008,SOUTH DAKOTA,WALWORTH,923,29,1668,2620,0.3522900763358779,0.6366412213740458,0.011068702290076336
2008,SOUTH DAKOTA,YANKTON,4838,90,5039,9967,0.48540182602588544,0.5055683756396108,0.009029798334503862
2008,SOUTH DAKOTA,ZIEBACH,554,16,312,882,0.6281179138321995,0.35374149659863946,0.018140589569160998
2008,TENNESSEE,ANDERSON,11396,499,19675,31570,0.36097560975609755,0.6232182451694647,0.01580614507443776
2008,TENNESSEE,BEDFORD,5027,263,10217,15507,0.3241761785000322,0.6588637389566002,0.016960082543367512
2008,TENNESSEE,BENTON,2645,138,3696,6479,0.40824201265627413,0.5704584040747029,0.021299583269023
2008,TENNESSEE,BLEDSOE,1517,101,3166,4784,0.3170986622073579,0.6617892976588629,0.021112040133779264
2008,TENNESSEE,BLOUNT,15253,821,35571,51645,0.29534320844225,0.6887598024978216,0.015896989059928358
2008,TENNESSEE,BRADLEY,9357,501,28333,38191,0.24500536775680135,0.7418763583043125,0.013118273938886125
2008,TENNESSEE,CAMPBELL,3867,226,8535,12628,0.3062242635413367,0.6758789990497308,0.01789673740893253
2008,TENNESSEE,CANNON,2011,124,3322,5457,0.3685175004581272,0.6087593916071101,0.02272310793476269
2008,TENNESSEE,CARROLL,3980,211,7455,11646,0.3417482397389662,0.640133951571355,0.01811780868967886
2008,TENNESSEE,CARTER,5587,330,15852,21769,0.2566493637741743,0.72819146492719,0.015159171298635674
2008,TENNESSEE,CHEATHAM,5498,228,10702,16428,0.334672510348186,0.6514487460433407,0.013878743608473338
2008,TENNESSEE,CHESTER,1797,75,4587,6459,0.2782164421737111,0.7101718532280539,0.011611704598235021
2008,TENNESSEE,CLAIBORNE,3078,167,7175,10420,0.29539347408829175,0.6885796545105566,0.01602687140115163
2008,TENNESSEE,CLAY,1248,70,1676,2994,0.4168336673346693,0.5597862391449566,0.02338009352037408
2008,TENNESSEE,COCKE,3340,196,8945,12481,0.2676067622786636,0.7166893678391154,0.015703869882220976
2008,TENNESSEE,COFFEE,7132,408,13250,20790,0.34304954304954305,0.6373256373256373,0.019624819624819625
2008,TENNESSEE,CROCKETT,1967,76,3994,6037,0.32582408481033626,0.6615868809011098,0.012589034288553918
2008,TENNESSEE,CUMBERLAND,7889,387,17436,25712,0.30682171748599874,0.6781269446172993,0.01505133789670193
2008,TENNESSEE,DAVIDSON,158423,3148,102915,264486,0.5989844453014527,0.3891132233842245,0.011902331314322875
2008,TENNESSEE,DECATUR,1566,96,3101,4763,0.3287843795926937,0.6510602561410875,0.02015536426621877
2008,TENNESSEE,DEKALB,2832,148,4085,7065,0.40084925690021234,0.5782024062278839,0.020948336871903752
2008,TENNESSEE,DICKSON,7506,336,11677,19519,0.38454838874942365,0.5982376146318972,0.017213996618679235
2008,TENNESSEE,DYER,4411,180,9859,14450,0.3052595155709343,0.6822837370242214,0.01245674740484429
2008,TENNESSEE,FAYETTE,6892,189,12173,19254,0.35795159447387553,0.6322322634257816,0.009816142100342786
2008,TENNESSEE,FENTRESS,1831,119,4789,6739,0.27170203294257306,0.7106395607656922,0.01765840629173468
2008,TENNESSEE,FRANKLIN,6613,280,10539,17432,0.3793597980725103,0.6045777879761358,0.016062413951353834
2008,TENNESSEE,GIBSON,7406,331,13516,21253,0.3484684515127276,0.6359572766197713,0.01557427186750106
2008,TENNESSEE,GILES,4614,173,6902,11689,0.3947300881170331,0.5904696723415177,0.014800239541449225
2008,TENNESSEE,GRAINGER,2066,140,5297,7503,0.27535652405704386,0.7059842729574837,0.018659202985472478
2008,TENNESSEE,GREENE,7110,409,17151,24670,0.2882042967166599,0.695216862586137,0.01657884069720308
2008,TENNESSEE,GRUNDY,1971,98,2563,4632,0.4255181347150259,0.5533246977547496,0.021157167530224525
2008,TENNESSEE,HAMBLEN,6807,354,15508,22669,0.3002779125678239,0.6841060479068332,0.01561603952534298
2008,TENNESSEE,HAMILTON,64246,1572,81702,147520,0.43550704989154015,0.5538367678958785,0.010656182212581345
2008,TENNESSEE,HANCOCK,604,49,1588,2241,0.26952253458277553,0.7086122266845158,0.02186523873270861
2008,TENNESSEE,HARDEMAN,5919,93,5225,11237,0.5267420129927917,0.4649817566966272,0.008276230310581115
2008,TENNESSEE,HARDIN,2794,164,7077,10035,0.2784255107125062,0.7052316890881913,0.01634280019930244
2008,TENNESSEE,HAWKINS,5930,354,14756,21040,0.2818441064638783,0.7013307984790874,0.01682509505703422
2008,TENNESSEE,HAYWOOD,4893,63,3165,8121,0.6025120059106022,0.3897303287772442,0.007757665312153676
2008,TENNESSEE,HENDERSON,3021,144,7669,10834,0.278844378807458,0.7078641314380654,0.013291489754476648
2008,TENNESSEE,HENRY,5153,210,8182,13545,0.38043558508674785,0.6040605389442599,0.015503875968992248
2008,TENNESSEE,HICKMAN,3563,151,4784,8498,0.41927512355848434,0.5629559896446222,0.017768886796893386
2008,TENNESSEE,HOUSTON,1678,68,1608,3354,0.5002981514609421,0.47942754919499103,0.020274299344066785
2008,TENNESSEE,HUMPHREYS,3600,162,3818,7580,0.47493403693931396,0.5036939313984169,0.021372031662269128
2008,TENNESSEE,JACKSON,2224,92,2185,4501,0.4941124194623417,0.4854476782937125,0.02043990224394579
2008,TENNESSEE,JEFFERSON,5178,262,13092,18532,0.27940859054608247,0.7064537017051586,0.014137707748758903
2008,TENNESSEE,JOHNSON,1837,133,4621,6591,0.2787133970565923,0.7011075709300562,0.02017903201335154
2008,TENNESSEE,KNOX,70215,2856,113015,186086,0.3773255376546328,0.6073267199037005,0.015347742441666756
2008,TENNESSEE,LAKE,1024,39,1175,2238,0.4575513851653262,0.5250223413762288,0.01742627345844504
2008,TENNESSEE,LAUDERDALE,4322,83,4933,9338,0.462840008567145,0.528271578496466,0.008888412936388949
2008,TENNESSEE,LAWRENCE,5161,293,10566,16020,0.3221598002496879,0.6595505617977528,0.0182896379525593
2008,TENNESSEE,LEWIS,1804,79,2951,4834,0.37318990484071163,0.6104675217211419,0.016342573438146463
2008,TENNESSEE,LINCOLN,3695,204,9231,13130,0.2814166031987814,0.7030464584920031,0.015536938309215537
2008,TENNESSEE,LOUDON,6058,311,15815,22184,0.27307969707897584,0.7129011900468807,0.014019112874143527
2008,TENNESSEE,MACON,2060,155,5145,7360,0.2798913043478261,0.6990489130434783,0.021059782608695652
2008,TENNESSEE,MADISON,20209,347,23290,43846,0.46090863476713956,0.5311773023764995,0.0079140628563609
2008,TENNESSEE,MARION,4506,185,6746,11437,0.3939844364780974,0.5898399930051587,0.0161755705167439
2008,TENNESSEE,MARSHALL,4320,214,6755,11289,0.38267339888386925,0.5983700947825317,0.01895650633359908
2008,TENNESSEE,MAURY,13058,421,20288,33767,0.3867089169899606,0.6008232890099802,0.01246779400005923
2008,TENNESSEE,MCMINN,5541,259,12989,18789,0.2949065942838895,0.6913087444781522,0.01378466123795838
2008,TENNESSEE,MCNAIRY,3131,156,7135,10422,0.30042218384187297,0.6846094799462675,0.014968336211859529
2008,TENNESSEE,MEIGS,1372,68,2797,4237,0.32381401935331605,0.660136889308473,0.016049091338211
2008,TENNESSEE,MONROE,5053,240,11484,16777,0.30118614770221136,0.6845085533766466,0.01430529892114204
2008,TENNESSEE,MONTGOMERY,25716,627,30175,56518,0.455005484978237,0.5339007042004317,0.011093810821331257
2008,TENNESSEE,MOORE,881,61,2010,2952,0.2984417344173442,0.6808943089430894,0.020663956639566397
2008,TENNESSEE,MORGAN,1969,136,4717,6822,0.2886250366461448,0.6914394605687482,0.019935502785107008
2008,TENNESSEE,OBION,4308,211,8873,13392,0.3216845878136201,0.6625597371565114,0.015755675029868577
2008,TENNESSEE,OVERTON,3419,176,4497,8092,0.42251606524962926,0.5557340583292141,0.021749876421156698
2008,TENNESSEE,PERRY,1329,75,1596,3000,0.443,0.532,0.025
2008,TENNESSEE,PICKETT,854,31,1786,2671,0.31973043803818796,0.6686634219393486,0.011606140022463497
2008,TENNESSEE,POLK,2124,110,4267,6501,0.32671896631287495,0.6563605599138594,0.01692047377326565
2008,TENNESSEE,PUTNAM,9739,476,17101,27316,0.3565309708595695,0.6260433445599649,0.017425684580465662
2008,TENNESSEE,RHEA,2907,157,8042,11106,0.26175040518638576,0.7241130920223303,0.01413650279128399
2008,TENNESSEE,ROANE,7224,394,15658,23276,0.3103626052586355,0.672710087643925,0.016927307097439424
2008,TENNESSEE,ROBERTSON,9318,393,17903,27614,0.3374375316868255,0.6483305569638589,0.014231911349315564
2008,TENNESSEE,RUTHERFORD,40460,1385,59892,101737,0.39769208842407383,0.5886943786429716,0.01361353293295458
2008,TENNESSEE,SCOTT,1720,132,4931,6783,0.2535751142562288,0.7269644699985257,0.019460415745245468
2008,TENNESSEE,SEQUATCHIE,1717,110,3610,5437,0.31579915394519037,0.6639691006069524,0.020231745447857274
2008,TENNESSEE,SEVIER,8604,415,24922,33941,0.2534987183642203,0.7342741816681889,0.01222709996759082
2008,TENNESSEE,SHELBY,256297,2800,145458,404555,0.6335281976492689,0.359550617344984,0.0069211850057470554
2008,TENNESSEE,SMITH,2992,186,4563,7741,0.38651337036558586,0.5894587262627567,0.02402790337165741
2008,TENNESSEE,STEWART,2470,81,2956,5507,0.44852006537134553,0.5367713818776103,0.014708552751044126
2008,TENNESSEE,SULLIVAN,18354,835,44808,63997,0.28679469350125786,0.7001578198978077,0.013047486600934419
2008,TENNESSEE,SUMNER,21487,792,44949,67228,0.3196138513714524,0.6686053430118403,0.011780805616707324
2008,TENNESSEE,TIPTON,7931,220,17165,25316,0.3132801390425028,0.6780297045346816,0.00869015642281561
2008,TENNESSEE,TROUSDALE,1475,76,1688,3239,0.45538746526705776,0.5211485026242667,0.023464032108675516
2008,TENNESSEE,UNICOI,2107,105,5011,7223,0.29170704693340715,0.6937560570400111,0.014536896026581753
2008,TENNESSEE,UNION,1829,103,4467,6399,0.28582591029848414,0.6980778246601032,0.016096265041412722
2008,TENNESSEE,VAN BUREN,849,63,1294,2206,0.38485947416137806,0.586582048957389,0.028558476881233003
2008,TENNESSEE,WARREN,5515,323,8562,14400,0.38298611111111114,0.5945833333333334,0.022430555555555554
2008,TENNESSEE,WASHINGTON,15941,700,32341,48982,0.32544608223429017,0.6602629537381078,0.014290964027601976
2008,TENNESSEE,WAYNE,1355,96,4076,5527,0.24516012303238646,0.7374705988782341,0.01736927808937941
2008,TENNESSEE,WEAKLEY,4596,239,8855,13690,0.33571950328707084,0.6468224981738495,0.01745799853907962
2008,TENNESSEE,WHITE,3372,172,6103,9647,0.34953871669949205,0.6326319062921115,0.01782937700839639
2008,TENNESSEE,WILLIAMSON,27886,902,64858,93646,0.29778100506161503,0.692586976485915,0.009632018452469939
2008,TENNESSEE,WILSON,15886,678,34595,51159,0.3105220977736078,0.6762251021325671,0.013252800093825134
2008,TEXAS,ANDERSON,4630,141,11884,16655,0.2779945962173521,0.713539477634344,0.008465926148303812
2008,TEXAS,ANDREWS,790,23,3816,4629,0.17066321019658673,0.8243681140635126,0.0049686757399006265
2008,TEXAS,ANGELINA,9379,205,19569,29153,0.3217164614276404,0.6712516722121222,0.007031866360237368
2008,TEXAS,ARANSAS,3006,79,6693,9778,0.30742483125383513,0.6844958069134792,0.00807936183268562
2008,TEXAS,ARCHER,740,30,3595,4365,0.16953035509736541,0.8235967926689576,0.006872852233676976
2008,TEXAS,ARMSTRONG,128,6,856,990,0.1292929292929293,0.8646464646464647,0.006060606060606061
2008,TEXAS,ATASCOSA,4415,61,5462,9938,0.4442543771382572,0.5496075669148722,0.0061380559468705975
2008,TEXAS,AUSTIN,2821,114,8786,11721,0.24067912294172852,0.7495947444757274,0.009726132582544152
2008,TEXAS,BAILEY,682,16,1618,2316,0.29447322970639034,0.6986183074265976,0.0069084628670120895
2008,TEXAS,BANDERA,2250,112,6935,9297,0.2420135527589545,0.7459395503925997,0.012046896848445735
2008,TEXAS,BASTROP,11687,414,13817,25918,0.45092213905393935,0.5331044062041824,0.01597345474187823
2008,TEXAS,BAYLOR,366,15,1262,1643,0.22276323797930614,0.7681071211199026,0.009129640900791236
2008,TEXAS,BEE,3645,41,4471,8157,0.4468554615667525,0.5481181807036901,0.005026357729557436
2008,TEXAS,BELL,40413,679,49242,90334,0.4473730821174752,0.5451103681891647,0.0075165496933601965
2008,TEXAS,BEXAR,275527,3913,246275,525715,0.5240995596473375,0.46845724394396204,0.007443196408700532
2008,TEXAS,BLANCO,1467,54,3418,4939,0.2970236890058716,0.6920429236687589,0.010933387325369508
2008,TEXAS,BORDEN,40,5,316,361,0.11080332409972299,0.8753462603878116,0.013850415512465374
2008,TEXAS,BOSQUE,1797,87,5762,7646,0.23502484959455924,0.7535966518441015,0.011378498561339262
2008,TEXAS,BOWIE,10815,209,24162,35186,0.3073665662479395,0.6866935713067698,0.005939862445290741
2008,TEXAS,BRAZORIA,36480,945,67515,104940,0.34762721555174386,0.6433676386506575,0.009005145797598629
2008,TEXAS,BRAZOS,20502,706,37465,58673,0.34942818672984166,0.6385390213556491,0.01203279191450923
2008,TEXAS,BREWSTER,1970,75,1855,3900,0.5051282051282051,0.4756410256410256,0.019230769230769232
2008,TEXAS,BRISCOE,205,8,617,830,0.2469879518072289,0.7433734939759036,0.00963855421686747
2008,TEXAS,BROOKS,1747,6,556,2309,0.7566045907319185,0.2407968817669987,0.00259852750108272
2008,TEXAS,BROWN,2822,141,12052,15015,0.18794538794538795,0.8026640026640026,0.009390609390609391
2008,TEXAS,BURLESON,2053,65,4547,6665,0.3080270067516879,0.6822205551387847,0.009752438109527382
2008,TEXAS,BURNET,4608,226,12059,16893,0.27277570591369205,0.7138459717042562,0.013378322382051737
2008,TEXAS,CALDWELL,5403,138,6107,11648,0.46385645604395603,0.5242960164835165,0.011847527472527472
2008,TEXAS,CALHOUN,2729,44,4106,6879,0.39671463875563306,0.596889082715511,0.006396278528855938
2008,TEXAS,CALLAHAN,1063,64,4589,5716,0.18596920923722884,0.8028341497550735,0.01119664100769769
2008,TEXAS,CAMERON,48480,506,26671,75657,0.6407867084341171,0.3525252124720779,0.006688079093804936
2008,TEXAS,CAMP,1734,35,2798,4567,0.37968031530545215,0.6126560105101817,0.0076636741843661045
2008,TEXAS,CARSON,406,26,2548,2980,0.13624161073825503,0.8550335570469799,0.0087248322147651
2008,TEXAS,CASS,3490,77,8279,11846,0.29461421576903596,0.6988856998142833,0.0065000844166807365
2008,TEXAS,CASTRO,719,10,1562,2291,0.313836752509821,0.6817983413356613,0.004364906154517678
2008,TEXAS,CHAMBERS,3188,116,9988,13292,0.23984351489617814,0.7514294312368341,0.008727053866987662
2008,TEXAS,CHEROKEE,4610,112,11695,16417,0.28080648108667844,0.7123713224096972,0.0068221965036242916
2008,TEXAS,CHILDRESS,497,17,1782,2296,0.21646341463414634,0.7761324041811847,0.007404181184668989
2008,TEXAS,CLAY,1085,41,4213,5339,0.2032215770743585,0.7890990822251358,0.007679340700505713
2008,TEXAS,COCHRAN,284,15,758,1057,0.2686849574266793,0.7171239356669821,0.014191106906338695
2008,TEXAS,COKE,299,18,1252,1569,0.1905672402804334,0.7979604843849586,0.011472275334608031
2008,TEXAS,COLEMAN,643,48,3011,3702,0.17368989735278229,0.8133441383036196,0.012965964343598054
2008,TEXAS,COLLIN,109047,2639,184897,296583,0.36767785071969733,0.6234241342221233,0.00889801505817933
2008,TEXAS,COLLINGSWORTH,234,18,943,1195,0.19581589958158996,0.7891213389121339,0.01506276150627615
2008,TEXAS,COLORADO,2508,50,5795,8353,0.30025140668023464,0.6937627199808452,0.005985873338920148
2008,TEXAS,COMAL,12384,541,35233,48158,0.25715353627642346,0.7316126084970306,0.011233855226545953
2008,TEXAS,COMANCHE,1334,70,3813,5217,0.25570251102166,0.730879815986199,0.013417672992141078
2008,TEXAS,CONCHO,257,13,807,1077,0.23862581244196843,0.7493036211699164,0.012070566388115135
2008,TEXAS,COOKE,3051,110,11871,15032,0.20296700372538584,0.7897152740819585,0.007317722192655668
2008,TEXAS,CORYELL,6619,163,11550,18332,0.361062622736199,0.630045821514292,0.008891555749509054
2008,TEXAS,COTTLE,187,9,509,705,0.2652482269503546,0.7219858156028369,0.01276595744680851
2008,TEXAS,CRANE,319,16,1119,1454,0.21939477303988997,0.7696011004126547,0.011004126547455296
2008,TEXAS,CROCKETT,512,7,1026,1545,0.3313915857605178,0.6640776699029126,0.004530744336569579
2008,TEXAS,CROSBY,684,9,1221,1914,0.3573667711598746,0.6379310344827587,0.004702194357366771
2008,TEXAS,CULBERSON,492,10,257,759,0.6482213438735178,0.3386034255599473,0.013175230566534914
2008,TEXAS,DALLAM,302,18,1269,1589,0.19005663939584644,0.7986154814348647,0.011327879169288861
2008,TEXAS,DALLAS,422989,5474,310000,738463,0.5727964705069855,0.4197908358306374,0.007412693662377127
2008,TEXAS,DAWSON,1152,38,2906,4096,0.28125,0.70947265625,0.00927734375
2008,TEXAS,DEAF SMITH,1247,31,3466,4744,0.26285834738617203,0.7306070826306914,0.0065345699831365935
2008,TEXAS,DELTA,589,18,1580,2187,0.26931870141746683,0.7224508459076361,0.00823045267489712
2008,TEXAS,DENTON,91160,2168,149935,243263,0.37473845179908166,0.6163493831778775,0.008912165023040906
2008,TEXAS,DEWITT,1716,22,4888,6626,0.25897977663748867,0.7376999698158768,0.0033202535466344703
2008,TEXAS,DICKENS,234,8,730,972,0.24074074074074073,0.7510288065843621,0.00823045267489712
2008,TEXAS,DIMMIT,2692,21,874,3587,0.7504878728742682,0.24365765263451353,0.005854474491218288
2008,TEXAS,DONLEY,291,25,1374,1690,0.17218934911242603,0.8130177514792899,0.014792899408284023
2008,TEXAS,DUVAL,3298,35,1076,4409,0.7480154229984124,0.24404626899523701,0.007938308006350647
2008,TEXAS,EASTLAND,1271,73,5165,6509,0.1952680903364572,0.7935166692272239,0.011215240436318942
2008,TEXAS,ECTOR,9123,284,26199,35606,0.2562208616525305,0.7358029545582205,0.007976183789249002
2008,TEXAS,EDWARDS,346,16,673,1035,0.3342995169082126,0.6502415458937199,0.015458937198067632
2008,TEXAS,EL PASO,122021,1429,61783,185233,0.6587433124767185,0.33354207943508984,0.007714608088191629
2008,TEXAS,ELLIS,15333,442,38078,53853,0.28471951423319036,0.7070729578667855,0.00820752790002414
2008,TEXAS,ERATH,3128,123,10768,14019,0.22312575789999287,0.7681004351237606,0.008773806976246523
2008,TEXAS,FALLS,2225,46,3328,5599,0.3973923914984819,0.5943918556885158,0.008215752813002321
2008,TEXAS,FANNIN,3464,138,8092,11694,0.29622028390627675,0.6919787925431845,0.011800923550538737
2008,TEXAS,FAYETTE,3014,118,7582,10714,0.2813141683778234,0.7076722045921224,0.011013627030054134
2008,TEXAS,FISHER,687,14,1083,1784,0.3850896860986547,0.6070627802690582,0.007847533632286996
2008,TEXAS,FLOYD,730,7,1784,2521,0.2895676318921063,0.7076556921856406,0.002776675922253074
2008,TEXAS,FOARD,198,13,327,538,0.3680297397769517,0.6078066914498141,0.024163568773234202
2008,TEXAS,FORT BEND,98368,1248,103206,202822,0.4849966966108213,0.5088501247399198,0.006153178649258956
2008,TEXAS,FRANKLIN,1036,63,3392,4491,0.23068358940102426,0.7552883544867512,0.014028056112224449
2008,TEXAS,FREESTONE,2034,49,5205,7288,0.27908891328210755,0.7141877058177827,0.00672338090010977
2008,TEXAS,FRIO,2405,13,1644,4062,0.5920728705071393,0.40472673559822747,0.003200393894633186
2008,TEXAS,GAINES,650,32,3385,4067,0.1598229653307106,0.832308827145316,0.007868207523973445
2008,TEXAS,GALVESTON,41805,941,62258,105004,0.39812769037370005,0.5929107462572855,0.008961563369014514
2008,TEXAS,GARZA,375,19,1356,1750,0.21428571428571427,0.7748571428571429,0.010857142857142857
2008,TEXAS,GILLESPIE,2576,199,9563,12338,0.20878586480791053,0.775085102934025,0.016129032258064516
2008,TEXAS,GLASSCOCK,52,3,502,557,0.0933572710951526,0.9012567324955116,0.005385996409335727
2008,TEXAS,GOLIAD,1329,28,2298,3655,0.3636114911080711,0.6287277701778385,0.007660738714090287
2008,TEXAS,GONZALES,2167,44,4076,6287,0.3446794973755368,0.648321934149833,0.0069985684746301895
2008,TEXAS,GRAY,1153,56,6924,8133,0.14176810525021516,0.8513463666543711,0.0068855280954137465
2008,TEXAS,GRAYSON,13900,441,31136,45477,0.3056490093893617,0.6846537810321701,0.009697209578468237
2008,TEXAS,GREGG,13166,241,29203,42610,0.30898850035203,0.6853555503402957,0.0056559493076742545
2008,TEXAS,GRIMES,2704,56,5562,8322,0.3249218937755347,0.6683489545782264,0.0067291516462388845
2008,TEXAS,GUADALUPE,16156,436,30869,47461,0.34040580687301153,0.6504077031668106,0.00918648996017783
2008,TEXAS,HALE,2708,64,7171,9943,0.27235240872975963,0.7212109021422106,0.00643668912802977
2008,TEXAS,HALL,324,10,930,1264,0.2563291139240506,0.7357594936708861,0.007911392405063292
2008,TEXAS,HAMILTON,863,39,2876,3778,0.22842773954473267,0.7612493382742191,0.010322922181048173
2008,TEXAS,HANSFORD,240,15,1847,2102,0.11417697431018078,0.878686964795433,0.007136060894386299
2008,TEXAS,HARDEMAN,373,23,1199,1595,0.23385579937304074,0.7517241379310344,0.014420062695924765
2008,TEXAS,HARDIN,3939,160,16603,20702,0.1902714713554246,0.8019998067819535,0.007728721862621969
2008,TEXAS,HARRIS,590982,8607,571883,1171472,0.5044781266645725,0.48817470669380064,0.007347166641626945
2008,TEXAS,HARRISON,8887,168,17103,26158,0.3397430996253536,0.6538343910084868,0.006422509366159492
2008,TEXAS,HARTLEY,250,24,1711,1985,0.12594458438287154,0.8619647355163728,0.012090680100755667
2008,TEXAS,HASKELL,699,29,1388,2116,0.33034026465028354,0.6559546313799622,0.013705103969754254
2008,TEXAS,HAYS,28431,983,29638,59052,0.48145702093070514,0.5018966334755809,0.016646345593714015
2008,TEXAS,HEMPHILL,216,9,1345,1570,0.1375796178343949,0.856687898089172,0.005732484076433121
2008,TEXAS,HENDERSON,7913,223,20857,28993,0.2729279481254096,0.7193805401303763,0.007691511744214121
2008,TEXAS,HIDALGO,90261,855,39668,130784,0.690153229752875,0.30330927330560314,0.006537496941521899
2008,TEXAS,HILL,3811,113,9264,13188,0.28897482559902943,0.7024567788898999,0.00856839551107067
2008,TEXAS,HOCKLEY,1797,53,5795,7645,0.23505559189012426,0.7580117724002616,0.0069326357096141265
2008,TEXAS,HOOD,5087,210,17299,22596,0.22512834129934503,0.7655779784032573,0.00929368029739777
2008,TEXAS,HOPKINS,3530,90,9299,12919,0.27324096292282685,0.71979255360322,0.006966483473953092
2008,TEXAS,HOUSTON,2656,96,5872,8624,0.3079777365491651,0.6808905380333952,0.011131725417439703
2008,TEXAS,HOWARD,2545,115,7029,9689,0.2626690060893797,0.7254618639694499,0.0118691299411704
2008,TEXAS,HUDSPETH,430,10,458,898,0.47884187082405344,0.5100222717149221,0.011135857461024499
2008,TEXAS,HUNT,8594,357,20573,29524,0.29108521880503996,0.6968229237230728,0.012091857471887279
2008,TEXAS,HUTCHINSON,1322,78,7361,8761,0.15089601643647985,0.8402008903093254,0.008903093254194727
2008,TEXAS,IRION,164,9,644,817,0.200734394124847,0.7882496940024479,0.011015911872705019
2008,TEXAS,JACK,470,25,2528,3023,0.1554746940125703,0.8362553754548462,0.008269930532583526
2008,TEXAS,JACKSON,1301,33,3723,5057,0.25726715443939097,0.7362072374925845,0.0065256080680245205
2008,TEXAS,JASPER,3658,96,9022,12776,0.28631809643080774,0.7061678146524734,0.007514088916718848
2008,TEXAS,JEFF DAVIS,468,19,749,1236,0.3786407766990291,0.6059870550161812,0.015372168284789644
2008,TEXAS,JEFFERSON,44888,503,42905,88296,0.508380900607049,0.4859223520884298,0.005696747304521156
2008,TEXAS,JIM HOGG,1336,7,472,1815,0.7360881542699724,0.26005509641873276,0.003856749311294766
2008,TEXAS,JIM WELLS,6706,65,4841,11612,0.5775060282466414,0.41689631415776784,0.005597657595590768
2008,TEXAS,JOHNSON,12912,453,36685,50050,0.257982017982018,0.7329670329670329,0.009050949050949051
2008,TEXAS,JONES,1528,77,4203,5808,0.2630853994490358,0.7236570247933884,0.013257575757575758
2008,TEXAS,KARNES,1760,31,2736,4527,0.3887784404683013,0.6043737574552683,0.0068478020764303075
2008,TEXAS,KAUFMAN,11161,249,23735,35145,0.3175700668658415,0.6753449992886612,0.007084933845497226
2008,TEXAS,KENDALL,3599,176,12971,16746,0.21491699510330825,0.7745730323659381,0.010509972530753612
2008,TEXAS,KENEDY,108,0,94,202,0.5346534653465347,0.46534653465346537,0.0
2008,TEXAS,KENT,99,7,342,448,0.22098214285714285,0.7633928571428571,0.015625
2008,TEXAS,KERR,5570,234,16752,22556,0.24694094697641425,0.7426848732044689,0.010374179819116865
2008,TEXAS,KIMBLE,342,14,1487,1843,0.18556701030927836,0.806836679327184,0.007596310363537711
2008,TEXAS,KING,8,4,151,163,0.049079754601226995,0.9263803680981595,0.024539877300613498
2008,TEXAS,KINNEY,633,11,907,1551,0.4081237911025145,0.5847840103159252,0.0070921985815602835
2008,TEXAS,KLEBERG,5256,80,4540,9876,0.5321992709599028,0.45970028351559333,0.008100445524503848
2008,TEXAS,KNOX,367,15,986,1368,0.2682748538011696,0.7207602339181286,0.010964912280701754
2008,TEXAS,LA SALLE,1052,10,714,1776,0.5923423423423423,0.40202702702702703,0.00563063063063063
2008,TEXAS,LAMAR,5243,167,12952,18362,0.28553534473368913,0.7053697854264241,0.009094869839886723
2008,TEXAS,LAMB,1156,25,3344,4525,0.2554696132596685,0.7390055248618784,0.0055248618784530384
2008,TEXAS,LAMPASAS,1903,80,5651,7634,0.24927953890489912,0.7402410269845429,0.010479434110558029
2008,TEXAS,LAVACA,1869,61,6293,8223,0.22728931047063117,0.7652924723336981,0.00741821719567068
2008,TEXAS,LEE,2000,65,4312,6377,0.31362709738121375,0.6761800219538968,0.010192880664889447
2008,TEXAS,LEON,1418,57,5566,7041,0.20139184774889932,0.7905127112626047,0.008095440988495952
2008,TEXAS,LIBERTY,5991,187,15448,21626,0.27702765190049017,0.7143253491168039,0.008646998982706003
2008,TEXAS,LIMESTONE,2516,57,5079,7652,0.3288029273392577,0.6637480397281756,0.007449032932566649
2008,TEXAS,LIPSCOMB,155,8,1093,1256,0.12340764331210191,0.8702229299363057,0.006369426751592357
2008,TEXAS,LIVE OAK,1048,33,3095,4176,0.2509578544061303,0.741139846743295,0.007902298850574713
2008,TEXAS,LLANO,2250,98,7281,9629,0.23366912451968014,0.756153286945685,0.010177588534634957
2008,TEXAS,LOVING,12,0,67,79,0.1518987341772152,0.8481012658227848,0.0
2008,TEXAS,LUBBOCK,30486,744,66304,97534,0.3125679250312711,0.6798039657965428,0.007628109172186109
2008,TEXAS,LYNN,627,16,1473,2116,0.29631379962192816,0.696124763705104,0.007561436672967864
2008,TEXAS,MADISON,1146,37,2891,4074,0.2812960235640648,0.7096219931271478,0.009081983308787433
2008,TEXAS,MARION,1644,41,2567,4252,0.38664158043273755,0.6037158984007526,0.009642521166509878
2008,TEXAS,MARTIN,314,12,1389,1715,0.18309037900874636,0.8099125364431486,0.006997084548104956
2008,TEXAS,MASON,546,31,1544,2121,0.25742574257425743,0.727958510136728,0.014615747289014616
2008,TEXAS,MATAGORDA,4440,98,7835,12373,0.3588458740806595,0.6332336539238664,0.007920471995474016
2008,TEXAS,MAVERICK,8554,69,2316,10939,0.781972758021757,0.21171953560654538,0.006307706371697596
2008,TEXAS,MCCULLOCH,728,19,2263,3010,0.24186046511627907,0.751827242524917,0.006312292358803987
2008,TEXAS,MCLENNAN,29998,632,49044,79674,0.3765092752968346,0.615558400481964,0.007932324221201395
2008,TEXAS,MCMULLEN,132,5,400,537,0.24581005586592178,0.74487895716946,0.00931098696461825
2008,TEXAS,MEDINA,5147,110,10480,15737,0.3270636080574442,0.6659464955201119,0.006989896422443922
2008,TEXAS,MENARD,295,11,712,1018,0.28978388998035365,0.6994106090373281,0.010805500982318271
2008,TEXAS,MIDLAND,9691,370,36155,46216,0.20968928509607063,0.7823048294962783,0.00800588540765103
2008,TEXAS,MILAM,3044,96,5217,8357,0.36424554265884884,0.6242670814885725,0.011487375852578677
2008,TEXAS,MILLS,398,26,1753,2177,0.18282039503904457,0.8052365640790078,0.011943040881947635
2008,TEXAS,MITCHELL,586,30,1815,2431,0.24105306458247636,0.746606334841629,0.012340600575894693
2008,TEXAS,MONTAGUE,1597,108,6245,7950,0.20088050314465408,0.7855345911949686,0.013584905660377358
2008,TEXAS,MONTGOMERY,36703,1260,119884,157847,0.2325226326759457,0.7594949539744182,0.00798241334963604
2008,TEXAS,MOORE,1123,32,4282,5437,0.2065477285267611,0.7875666727974986,0.005885598675740298
2008,TEXAS,MORRIS,2055,35,3158,5248,0.39157774390243905,0.6017530487804879,0.006669207317073171
2008,TEXAS,MOTLEY,67,5,522,594,0.1127946127946128,0.8787878787878788,0.008417508417508417
2008,TEXAS,NACOGDOCHES,8393,170,14828,23391,0.3588132187593519,0.6339190286862468,0.007267752554401265
2008,TEXAS,NAVARRO,5400,111,10810,16321,0.3308620795294406,0.6623368666135654,0.006801053856994057
2008,TEXAS,NEWTON,1751,63,3446,5260,0.3328897338403042,0.6551330798479087,0.011977186311787073
2008,TEXAS,NOLAN,1521,57,3485,5063,0.30041477384949633,0.6883270788070314,0.01125814734347225
2008,TEXAS,NUECES,47912,927,52391,101230,0.4732984293193717,0.5175442062629655,0.009157364417662748
2008,TEXAS,OCHILTREE,243,15,2851,3109,0.0781601801222258,0.9170151174010936,0.004824702476680605
2008,TEXAS,OLDHAM,102,5,813,920,0.1108695652173913,0.883695652173913,0.005434782608695652
2008,TEXAS,ORANGE,7646,251,21509,29406,0.2600149629327348,0.7314493640753588,0.008535672991906414
2008,TEXAS,PALO PINTO,2499,127,7264,9890,0.2526794742163802,0.734479271991911,0.012841253791708796
2008,TEXAS,PANOLA,2586,48,7582,10216,0.25313234142521535,0.7421691464369616,0.004698512137823023
2008,TEXAS,PARKER,10502,475,36974,47951,0.21901524472899417,0.7710788096181519,0.009905945652853954
2008,TEXAS,PARMER,719,25,2969,3713,0.19364395367627255,0.7996229464045247,0.006733099919202801
2008,TEXAS,PECOS,1476,54,2480,4010,0.3680798004987531,0.6184538653366584,0.013466334164588529
2008,TEXAS,POLK,6230,188,13731,20149,0.3091964861779741,0.6814730259566232,0.00933048786540275
2008,TEXAS,POTTER,8939,313,20761,30013,0.2978376037050611,0.691733582114417,0.010428814180521774
2008,TEXAS,PRESIDIO,1252,16,489,1757,0.7125782583949914,0.27831531018782013,0.00910643141718839
2008,TEXAS,RAINS,1048,42,3146,4236,0.2474032105760151,0.7426817752596789,0.009915014164305949
2008,TEXAS,RANDALL,9468,416,41948,51832,0.1826670782528168,0.8093069918197253,0.008025929927457941
2008,TEXAS,REAGAN,197,2,795,994,0.1981891348088531,0.7997987927565392,0.002012072434607646
2008,TEXAS,REAL,375,15,1238,1628,0.23034398034398035,0.7604422604422605,0.009213759213759214
2008,TEXAS,RED RIVER,1539,52,3461,5052,0.30463182897862234,0.6850752177355502,0.010292953285827395
2008,TEXAS,REEVES,1606,26,1445,3077,0.5219369515762106,0.4696132596685083,0.008449788755281119
2008,TEXAS,REFUGIO,1382,24,1855,3261,0.4237963814780742,0.5688439129101502,0.007359705611775529
2008,TEXAS,ROBERTS,41,0,477,518,0.07915057915057915,0.9208494208494209,0.0
2008,TEXAS,ROBERTSON,2675,55,3980,6710,0.3986587183308495,0.5931445603576752,0.00819672131147541
2008,TEXAS,ROCKWALL,8492,274,23300,32066,0.2648287906193476,0.7266263331878001,0.008544876192852243
2008,TEXAS,RUNNELS,720,29,3118,3867,0.18619084561675717,0.8063098008792345,0.0074993535040082755
2008,TEXAS,RUSK,4983,93,13646,18722,0.26615746180963573,0.728875120179468,0.004967418010896272
2008,TEXAS,SABINE,1077,48,3749,4874,0.22096840377513335,0.7691834222404595,0.009848173984407058
2008,TEXAS,SAN AUGUSTINE,1328,45,2342,3715,0.35746971736204575,0.6304172274562584,0.012113055181695828
2008,TEXAS,SAN JACINTO,2721,86,6151,8958,0.3037508372404555,0.6866488055369502,0.009600357222594329
2008,TEXAS,SAN PATRICIO,8854,138,12404,21396,0.41381566647971585,0.5797345298186577,0.006449803701626472
2008,TEXAS,SAN SABA,487,29,1941,2457,0.19820919820919822,0.78998778998779,0.011803011803011803
2008,TEXAS,SCHLEICHER,324,10,970,1304,0.24846625766871167,0.7438650306748467,0.007668711656441718
2008,TEXAS,SCURRY,1088,67,4414,5569,0.19536721134853655,0.792601903393787,0.012030885257676423
2008,TEXAS,SHACKELFORD,208,13,1284,1505,0.1382059800664452,0.8531561461794019,0.008637873754152824
2008,TEXAS,SHELBY,2548,42,6630,9220,0.27635574837310195,0.7190889370932755,0.00455531453362256
2008,TEXAS,SHERMAN,127,9,884,1020,0.12450980392156863,0.8666666666666667,0.008823529411764706
2008,TEXAS,SMITH,23726,648,55187,79561,0.2982114352509395,0.6936438707406896,0.008144694008370935
2008,TEXAS,SOMERVELL,799,57,2677,3533,0.22615341069912256,0.7577129917916785,0.01613359750919898
2008,TEXAS,STARR,8274,26,1492,9792,0.8449754901960784,0.15236928104575165,0.0026552287581699347
2008,TEXAS,STEPHENS,626,31,2869,3526,0.1775382870107771,0.8136698808848554,0.008791832104367556
2008,TEXAS,STERLING,97,2,520,619,0.1567043618739903,0.840064620355412,0.0032310177705977385
2008,TEXAS,STONEWALL,206,5,524,735,0.2802721088435374,0.7129251700680272,0.006802721088435374
2008,TEXAS,SUTTON,381,8,1189,1578,0.2414448669201521,0.7534854245880862,0.005069708491761723
2008,TEXAS,SWISHER,813,39,1683,2535,0.3207100591715976,0.663905325443787,0.015384615384615385
2008,TEXAS,TARRANT,274880,5253,348420,628553,0.4373219123924315,0.5543207971324614,0.008357290475107111
2008,TEXAS,TAYLOR,12690,432,34317,47439,0.2675014228799089,0.7233921457029027,0.00910643141718839
2008,TEXAS,TERRELL,186,10,323,519,0.3583815028901734,0.6223506743737958,0.019267822736030827
2008,TEXAS,TERRY,1379,22,2879,4280,0.32219626168224297,0.6726635514018692,0.0051401869158878505
2008,TEXAS,THROCKMORTON,166,1,671,838,0.19809069212410502,0.8007159904534606,0.0011933174224343676
2008,TEXAS,TITUS,3145,72,6028,9245,0.34018388318009735,0.6520281233098972,0.0077879935100054086
2008,TEXAS,TOM GREEN,11158,341,27362,38861,0.2871259102956692,0.7040992254445331,0.008774864259797741
2008,TEXAS,TRAVIS,254017,6716,136981,397714,0.638692628371141,0.3444208652448745,0.016886506383984472
2008,TEXAS,TRINITY,1925,57,4095,6077,0.3167681421754155,0.6738522297186111,0.009379628105973342
2008,TEXAS,TYLER,2166,100,5644,7910,0.2738305941845765,0.7135271807838179,0.012642225031605562
2008,TEXAS,UPSHUR,3790,152,11222,15164,0.24993405433922447,0.7400422052228963,0.010023740437879188
2008,TEXAS,UPTON,288,11,898,1197,0.24060150375939848,0.7502088554720133,0.009189640768588136
2008,TEXAS,UVALDE,4126,50,4590,8766,0.4706821811544604,0.5236139630390144,0.005703855806525211
2008,TEXAS,VAL VERDE,6982,86,5752,12820,0.5446177847113884,0.4486739469578783,0.00670826833073323
2008,TEXAS,VAN ZANDT,4505,156,15734,20395,0.2208874724197107,0.7714635940181417,0.0076489335621475855
2008,TEXAS,VICTORIA,9832,221,19878,29931,0.3284888577060573,0.6641274932344392,0.0073836490595035244
2008,TEXAS,WALKER,7334,189,11623,19146,0.38305651310978794,0.6070719732581218,0.009871513632090254
2008,TEXAS,WALLER,7153,90,8265,15508,0.46124580861490844,0.5329507351044622,0.0058034562806293525
2008,TEXAS,WARD,899,36,2667,3602,0.2495835646862854,0.7404219877845641,0.009994447529150472
2008,TEXAS,WASHINGTON,4034,167,10176,14377,0.2805870487584336,0.707797176045072,0.0116157751964944
2008,TEXAS,WEBB,33452,250,13119,46821,0.7144657311889964,0.28019478439161916,0.005339484419384464
2008,TEXAS,WHARTON,4937,50,9431,14418,0.34241919822444167,0.6541129144125398,0.0034678873630184493
2008,TEXAS,WHEELER,314,13,1918,2245,0.1398663697104677,0.8543429844097995,0.005790645879732739
2008,TEXAS,WICHITA,13868,383,31731,45982,0.3015962768039668,0.6900743769301031,0.008329346265930147
2008,TEXAS,WILBARGER,1196,30,3283,4509,0.26524728321135504,0.7280993568418718,0.00665335994677312
2008,TEXAS,WILLACY,3409,38,1456,4903,0.6952885988170507,0.2969610442586172,0.007750356924332041
2008,TEXAS,WILLIAMSON,67691,2389,88323,158403,0.42733407826871966,0.5575841366640784,0.01508178506720201
2008,TEXAS,WILSON,5362,100,10904,16366,0.32763045337895635,0.6662593180984969,0.006110228522546743
2008,TEXAS,WINKLER,477,26,1529,2032,0.23474409448818898,0.7524606299212598,0.012795275590551181
2008,TEXAS,WISE,4471,195,15973,20639,0.21662871263142594,0.7739231551916275,0.009448132176946558
2008,TEXAS,WOOD,4010,116,13658,17784,0.22548358074673863,0.7679937022042285,0.0065227170490328385
2008,TEXAS,YOAKUM,450,19,1989,2458,0.18307567127746135,0.8091944670463792,0.007729861676159479
2008,TEXAS,YOUNG,1303,60,5942,7305,0.1783709787816564,0.8134154688569473,0.008213552361396304
2008,TEXAS,ZAPATA,1939,8,919,2866,0.676552686671319,0.3206559665038381,0.0027913468248429866
2008,TEXAS,ZAVALA,3263,17,596,3876,0.8418472652218782,0.15376676986584106,0.0043859649122807015
2008,UTAH,BEAVER,542,65,1902,2509,0.21602231964926266,0.758070944599442,0.025906735751295335
2008,UTAH,BOX ELDER,3311,519,15228,19058,0.17373281561548956,0.7990345261832301,0.0272326582012803
2008,UTAH,CACHE,10294,1911,29127,41332,0.2490564211748766,0.7047082163940772,0.046235362431046166
2008,UTAH,CARBON,3468,218,4091,7777,0.44593030731644595,0.526038318117526,0.02803137456602803
2008,UTAH,DAGGETT,131,11,297,439,0.2984054669703872,0.6765375854214123,0.025056947608200455
2008,UTAH,DAVIS,30477,3084,77341,110902,0.27481019278281726,0.6973814719301726,0.027808335287010152
2008,UTAH,DUCHESNE,911,144,4689,5744,0.15860027855153203,0.8163300835654597,0.025069637883008356
2008,UTAH,EMERY,973,117,3358,4448,0.21875,0.7549460431654677,0.026303956834532374
2008,UTAH,GARFIELD,405,44,1710,2159,0.18758684576192683,0.7920333487725799,0.020379805465493284
2008,UTAH,GRAND,2067,139,1871,4077,0.506990434142752,0.458915869511896,0.034093696345351976
2008,UTAH,IRON,3258,674,12518,16450,0.1980547112462006,0.7609726443768997,0.040972644376899695
2008,UTAH,JUAB,741,192,2683,3616,0.2049225663716814,0.7419800884955752,0.05309734513274336
2008,UTAH,KANE,856,86,2212,3154,0.2714013950538998,0.7013316423589093,0.027266962587190868
2008,UTAH,MILLARD,758,328,3653,4739,0.15994935640430472,0.770837729478793,0.0692129141169023
2008,UTAH,MORGAN,689,161,3311,4161,0.16558519586637827,0.7957221821677481,0.038692621965873586
2008,UTAH,PIUTE,141,22,635,798,0.17669172932330826,0.7957393483709273,0.02756892230576441
2008,UTAH,RICH,154,21,831,1006,0.15308151093439365,0.8260437375745527,0.020874751491053677
2008,UTAH,SALT LAKE,176988,10069,176692,363749,0.4865662860928827,0.48575253815130764,0.02768117575580964
2008,UTAH,SAN JUAN,2406,86,2638,5130,0.46900584795321637,0.5142300194931774,0.01676413255360624
2008,UTAH,SANPETE,1631,476,6664,8771,0.18595371109337588,0.7597765363128491,0.05426975259377494
2008,UTAH,SEVIER,1359,254,6394,8007,0.1697264893218434,0.7985512676408143,0.03172224303734233
2008,UTAH,SUMMIT,9532,321,6956,16809,0.5670771610446784,0.41382592658694745,0.019096912368374085
2008,UTAH,TOOELE,5830,509,10998,17337,0.3362750187460345,0.6343658072330853,0.0293591740208802
2008,UTAH,UINTAH,1462,248,8441,10151,0.14402521919022757,0.8315436902768201,0.024431090532952417
2008,UTAH,UTAH,29567,5488,122224,157279,0.18799076799827058,0.7771158260161878,0.034893405985541616
2008,UTAH,WASATCH,2892,209,5430,8531,0.33899894502403,0.636502168561716,0.024498886414253896
2008,UTAH,WASHINGTON,10826,1392,37311,49529,0.21857901431484586,0.7533162389711079,0.028104746714046315
2008,UTAH,WAYNE,335,39,940,1314,0.2549467275494673,0.715372907153729,0.02968036529680365
2008,UTAH,WEBER,25666,1843,45885,73394,0.3497016104858708,0.6251873450145788,0.025111044499550372
2008,VERMONT,ADDISON,13202,369,5667,19238,0.6862459715147105,0.29457324046158645,0.01918078802370309
2008,VERMONT,BENNINGTON,12524,472,6133,19129,0.6547127398191228,0.32061268231481,0.024674577866067228
2008,VERMONT,CALEDONIA,8900,356,5472,14728,0.6042911461162411,0.37153720803910917,0.024171645844649647
2008,VERMONT,CHITTENDEN,59611,1592,22237,83440,0.7144175455417067,0.26650287631831254,0.019079578139980825
2008,VERMONT,ESSEX,1733,84,1284,3101,0.5588519832312158,0.41405998065140276,0.02708803611738149
2008,VERMONT,FRANKLIN,13179,428,7853,21460,0.6141192917054986,0.36593662628145385,0.01994408201304753
2008,VERMONT,GRAND ISLE,2694,85,1490,4269,0.6310611384399156,0.3490278753806512,0.019910986179433123
2008,VERMONT,LAMOILLE,8914,239,3515,12668,0.7036627723397537,0.2774707925481528,0.018866435112093464
2008,VERMONT,ORANGE,9799,333,5047,15179,0.6455629488108571,0.3324988470913762,0.021938204097766652
2008,VERMONT,ORLEANS,7998,291,4482,12771,0.6262626262626263,0.35095137420718814,0.022785999530185577
2008,VERMONT,RUTLAND,19355,678,11584,31617,0.6121706676787804,0.36638517253376346,0.021444159787456115
2008,VERMONT,WASHINGTON,22324,747,9129,32200,0.6932919254658385,0.2835093167701863,0.023198757763975154
2008,VERMONT,WINDHAM,17585,499,5997,24081,0.7302437606411694,0.24903450853369877,0.020721730825131845
2008,VERMONT,WINDSOR,21444,637,9084,31165,0.6880795764479384,0.2914808278517568,0.02043959570030483
2008,VIRGINIA,ACCOMACK,7607,183,7833,15623,0.48691032452153876,0.5013761761505473,0.011713499327913972
2008,VIRGINIA,ALBEMARLE,29792,616,20576,50984,0.5843401851561274,0.4035775929703436,0.01208222187352895
2008,VIRGINIA,ALEXANDRIA,50473,710,19181,70364,0.717312830424649,0.27259678244556873,0.010090387129782274
2008,VIRGINIA,ALLEGHANY,3553,101,3715,7369,0.48215497353779346,0.5041389605102456,0.013706065951960918
2008,VIRGINIA,AMELIA,2488,71,3970,6529,0.3810690764282432,0.6080563639148415,0.0108745596569153
2008,VIRGINIA,AMHERST,6094,136,8470,14700,0.4145578231292517,0.5761904761904761,0.00925170068027211
2008,VIRGINIA,APPOMATTOX,2641,86,4903,7630,0.34613368283093054,0.6425950196592398,0.011271297509829619
2008,VIRGINIA,ARLINGTON,78994,1283,29876,110153,0.7171298103546885,0.27122275380606975,0.011647435839241781
2008,VIRGINIA,AUGUSTA,9825,393,23120,33338,0.29470874077629133,0.693502909592657,0.011788349631051652
2008,VIRGINIA,BATH,1043,40,1349,2432,0.42886513157894735,0.5546875,0.01644736842105263
2008,VIRGINIA,BEDFORD,12225,422,25917,38564,0.3170054973550462,0.6720516543926979,0.01094284825225599
2008,VIRGINIA,BLAND,864,64,2031,2959,0.2919905373436972,0.6863805339641771,0.021628928692125717
2008,VIRGINIA,BOTETOURT,5693,242,11471,17406,0.32707112489945994,0.6590256233482708,0.013903251752269332
2008,VIRGINIA,BRISTOL,2665,115,4579,7359,0.3621415953254518,0.6222312814241066,0.015627123250441636
2008,VIRGINIA,BRUNSWICK,4973,64,2877,7914,0.6283800859236796,0.36353297952994695,0.008086934546373515
2008,VIRGINIA,BUCHANAN,4063,130,4541,8734,0.46519349667964277,0.519922143347836,0.014884359972521181
2008,VIRGINIA,BUCKINGHAM,3489,77,3428,6994,0.49885616242493563,0.49013440091507005,0.01100943665999428
2008,VIRGINIA,BUENA VISTA,1108,33,1282,2423,0.4572843582335947,0.5290961617829137,0.01361947998349154
2008,VIRGINIA,CAMPBELL,8091,279,17444,25814,0.31343457038816147,0.675757340977764,0.010808088634074533
2008,VIRGINIA,CAROLINE,7163,139,5617,12919,0.5544546791547333,0.43478597414660575,0.010759346698660887
2008,VIRGINIA,CARROLL,4109,283,8187,12579,0.3266555370061213,0.6508466491772001,0.02249781381667859
2008,VIRGINIA,CHARLES CITY,2838,27,1288,4153,0.6833614254755599,0.31013725018059235,0.006501324343847821
2008,VIRGINIA,CHARLOTTE,2705,80,3372,6157,0.4393373396134481,0.5476693194737697,0.0129933409127822
2008,VIRGINIA,CHARLOTTESVILLE,15705,261,4078,20044,0.7835262422670126,0.2034524047096388,0.013021353023348633
2008,VIRGINIA,CHESAPEAKE,53994,902,52625,107521,0.5021716687902829,0.48943927232819634,0.00838905888152082
2008,VIRGINIA,CHESTERFIELD,74310,1365,86413,162088,0.4584546666008588,0.5331239820344504,0.008421351364690785
2008,VIRGINIA,CLARKE,3457,134,3840,7431,0.46521329565334407,0.5167541380702463,0.018032566276409635
2008,VIRGINIA,COLONIAL HEIGHTS,2562,126,6161,8849,0.2895242400271217,0.6962368629223641,0.014238897050514182
2008,VIRGINIA,COVINGTON,1304,30,1020,2354,0.5539507221750213,0.4333050127442651,0.012744265080713678
2008,VIRGINIA,CRAIG,877,49,1695,2621,0.3346051125524609,0.646699732926364,0.018695154521175122
2008,VIRGINIA,CULPEPER,8802,228,10711,19741,0.44587406919608935,0.5425763639126691,0.011549566891241578
2008,VIRGINIA,CUMBERLAND,2255,51,2418,4724,0.4773497036409822,0.5118543607112617,0.010795935647756138
2008,VIRGINIA,DANVILLE,12352,177,8361,20890,0.5912876974629009,0.40023934897079944,0.008472953566299665
2008,VIRGINIA,DICKENSON,3278,151,3324,6753,0.48541389012290836,0.49222567747667706,0.02236043240041463
2008,VIRGINIA,DINWIDDIE,6246,120,6526,12892,0.4844865032578343,0.5062053986968663,0.00930809804529941
2008,VIRGINIA,EMPORIA,1702,18,897,2617,0.6503630110813909,0.34275888421857087,0.006878104700038212
2008,VIRGINIA,ESSEX,2934,51,2379,5364,0.5469798657718121,0.44351230425055926,0.009507829977628635
2008,VIRGINIA,FAIRFAX,316934,5033,205685,527652,0.6006496706162395,0.38981184568617194,0.009538483697588562
2008,VIRGINIA,FALLS CHURCH,4695,85,1970,6750,0.6955555555555556,0.29185185185185186,0.012592592592592593
2008,VIRGINIA,FAUQUIER,14616,376,19227,34219,0.42713112598264125,0.5618808264414507,0.01098804757590812
2008,VIRGINIA,FLOYD,2937,138,4441,7516,0.39076636508781265,0.5908728046833422,0.018360830228845132
2008,VIRGINIA,FLUVANNA,6185,130,6420,12735,0.4856694149980369,0.5041224970553593,0.010208087946603848
2008,VIRGINIA,FRANKLIN,12437,401,16990,29828,0.41695722140270886,0.5695990344642617,0.013443744133029368
2008,VIRGINIA,FREDERICK,12961,502,20149,33612,0.38560633107223613,0.5994585267166488,0.014935142211115079
2008,VIRGINIA,FREDERICKSBURG,6155,109,3413,9677,0.6360442285832386,0.3526919499844993,0.011263821432262065
2008,VIRGINIA,GALAX,1052,33,1317,2402,0.4379683597002498,0.548293089092423,0.013738551207327226
2008,VIRGINIA,GILES,3192,141,4462,7795,0.40949326491340604,0.5724182168056446,0.018088518280949328
2008,VIRGINIA,GLOUCESTER,6916,217,12089,19222,0.359796067006555,0.6289147851420248,0.011289147851420248
2008,VIRGINIA,GOOCHLAND,4813,106,7643,12562,0.3831396274478586,0.6084222257602293,0.008438146791912116
2008,VIRGINIA,GRAYSON,2480,200,4540,7220,0.34349030470914127,0.628808864265928,0.027700831024930747
2008,VIRGINIA,GREENE,3174,106,4980,8260,0.3842615012106538,0.6029055690072639,0.012832929782082324
2008,VIRGINIA,GREENSVILLE,3122,36,1729,4887,0.6388377327603847,0.3537957847350113,0.007366482504604052
2008,VIRGINIA,HALIFAX,8126,124,8600,16850,0.4822551928783383,0.5103857566765578,0.007359050445103857
2008,VIRGINIA,HAMPTON,46917,550,20476,67943,0.6905347129211251,0.3013702662525941,0.008095020826280852
2008,VIRGINIA,HANOVER,18447,457,37344,56248,0.3279583274071967,0.6639169392689518,0.008124733323851515
2008,VIRGINIA,HARRISONBURG,8444,183,6048,14675,0.5754003407155025,0.41212947189097104,0.012470187393526405
2008,VIRGINIA,HENRICO,86323,1262,67381,154966,0.5570447711110824,0.434811507040254,0.008143721848663578
2008,VIRGINIA,HENRY,11118,339,13758,25215,0.4409280190362879,0.5456276026174895,0.013444378346222486
2008,VIRGINIA,HIGHLAND,590,34,930,1554,0.37966537966537967,0.5984555984555985,0.021879021879021878
2008,VIRGINIA,HOPEWELL,5285,90,4149,9524,0.5549139017219655,0.4356362872742545,0.009449811003779925
2008,VIRGINIA,ISLE OF WIGHT,8573,166,11258,19997,0.4287143071460719,0.5629844476671501,0.008301245186778017
2008,VIRGINIA,JAMES CITY,17352,339,20912,38603,0.4494987436209621,0.5417195554749631,0.008781700904074813
2008,VIRGINIA,KING AND QUEEN,1918,24,1763,3705,0.5176788124156545,0.47584345479082324,0.006477732793522267
2008,VIRGINIA,KING GEORGE,4473,113,5888,10474,0.4270574756540004,0.5621539049073897,0.01078861943860989
2008,VIRGINIA,KING WILLIAM,3344,78,4966,8388,0.3986647591797806,0.5920362422508345,0.009298998569384835
2008,VIRGINIA,LANCASTER,3235,56,3647,6938,0.4662727010665898,0.5256558085903719,0.00807149034303834
2008,VIRGINIA,LEE,3219,183,5825,9227,0.3488674542104693,0.6312994472743036,0.019833098515227052
2008,VIRGINIA,LEXINGTON,1543,22,914,2479,0.6224283985478015,0.3686970552642194,0.008874546187979023
2008,VIRGINIA,LOUDOUN,74845,1278,63336,139459,0.5366810317010734,0.4541549846191354,0.009163983679791193
2008,VIRGINIA,LOUISA,6978,193,8182,15353,0.4545040057317788,0.5329251612062789,0.012570833061942292
2008,VIRGINIA,LUNENBURG,2703,47,2900,5650,0.4784070796460177,0.5132743362831859,0.00831858407079646
2008,VIRGINIA,LYNCHBURG,16269,434,17638,34341,0.4737485804140823,0.5136134649544276,0.012637954631490056
2008,VIRGINIA,MADISON,2862,79,3758,6699,0.4272279444693238,0.560979250634423,0.011792804896253173
2008,VIRGINIA,MANASSAS,7518,134,5975,13627,0.5516988331987965,0.4384677478535261,0.009833418947677405
2008,VIRGINIA,MANASSAS PARK,2463,43,1634,4140,0.5949275362318841,0.39468599033816426,0.01038647342995169
2008,VIRGINIA,MARTINSVILLE,4139,70,2311,6520,0.6348159509202455,0.3544478527607362,0.010736196319018405
2008,VIRGINIA,MATHEWS,1934,50,3456,5440,0.35551470588235295,0.6352941176470588,0.009191176470588236
2008,VIRGINIA,MECKLENBURG,7127,138,7817,15082,0.47255005967378333,0.5182999602174778,0.009149980108738895
2008,VIRGINIA,MIDDLESEX,2391,70,3545,6006,0.3981018981018981,0.5902430902430903,0.011655011655011656
2008,VIRGINIA,MONTGOMERY,21031,594,19028,40653,0.5173295943718791,0.4680589378397658,0.014611467788355103
2008,VIRGINIA,NELSON,4391,95,3647,8133,0.5398991761957457,0.44842001721382024,0.011680806590434033
2008,VIRGINIA,NEW KENT,3493,113,6385,9991,0.3496146531878691,0.6390751676508858,0.01131017916124512
2008,VIRGINIA,NEWPORT NEWS,51972,656,28667,81295,0.6393013100436681,0.3526293129958792,0.008069376960452672
2008,VIRGINIA,NORFOLK,62819,813,24814,88446,0.7102525834972752,0.28055536711665874,0.009192049386066074
2008,VIRGINIA,NORTHAMPTON,3800,73,2713,6586,0.5769814758578804,0.4119344063164288,0.011084117825690859
2008,VIRGINIA,NORTHUMBERLAND,3312,53,4041,7406,0.4472049689440994,0.5456386713475561,0.007156359708344585
2008,VIRGINIA,NORTON,743,25,744,1512,0.4914021164021164,0.49206349206349204,0.016534391534391533
2008,VIRGINIA,NOTTOWAY,3413,76,3499,6988,0.4884087006296508,0.5007155123068117,0.010875787063537493
2008,VIRGINIA,ORANGE,7107,188,8506,15801,0.4497816593886463,0.5383203594709196,0.01189798114043415
2008,VIRGINIA,PAGE,4235,113,6041,10389,0.40764269900856676,0.5814804119742035,0.010876889017229762
2008,VIRGINIA,PATRICK,2879,161,5491,8531,0.337475090845153,0.643652561247216,0.018872347907630992
2008,VIRGINIA,PETERSBURG,13774,183,1583,15540,0.8863577863577864,0.10186615186615186,0.011776061776061776
2008,VIRGINIA,PITTSYLVANIA,11415,288,18730,30433,0.3750862550520816,0.6154503335195347,0.009463411428383663
2008,VIRGINIA,POQUOSON,1748,88,5229,7065,0.24741684359518754,0.7401273885350318,0.012455767869780608
2008,VIRGINIA,PORTSMOUTH,32327,354,13984,46665,0.6927461695060538,0.2996678452801886,0.007585985213757634
2008,VIRGINIA,POWHATAN,4237,131,10088,14456,0.2930962921970116,0.697841726618705,0.009061981184283342
2008,VIRGINIA,PRINCE EDWARD,5101,113,4174,9388,0.5433532168726033,0.4446101406050277,0.012036642522368982
2008,VIRGINIA,PRINCE GEORGE,7130,124,8752,16006,0.4454579532675247,0.5467949518930401,0.007747094839435212
2008,VIRGINIA,PRINCE WILLIAM,93435,1390,67621,162446,0.5751757507110055,0.416267559681371,0.008556689607623456
2008,VIRGINIA,PULASKI,5918,275,8857,15050,0.39322259136212623,0.5885049833887043,0.018272425249169437
2008,VIRGINIA,RADFORD,2930,81,2418,5429,0.5396942346656843,0.4453858905875852,0.01491987474673052
2008,VIRGINIA,RAPPAHANNOCK,2105,73,2227,4405,0.4778660612939841,0.5055618615209989,0.016572077185017027
2008,VIRGINIA,RICHMOND,75241,848,20741,96830,0.7770422389755242,0.21420014458329031,0.008757616441185582
2008,VIRGINIA,ROANOKE,44746,1036,45965,91747,0.487710769834436,0.5009973078138795,0.011291922351684523
2008,VIRGINIA,ROCKBRIDGE,4347,116,5732,10195,0.4263854830799412,0.5622363903874448,0.011378126532614026
2008,VIRGINIA,ROCKINGHAM,10453,413,22468,33334,0.31358372832543346,0.6740265194696106,0.012389752204955902
2008,VIRGINIA,RUSSELL,4932,173,6389,11494,0.42909344005568123,0.5558552288150339,0.015051331129284844
2008,VIRGINIA,SALEM,5164,154,7088,12406,0.41625020151539577,0.571336450104788,0.012413348379816218
2008,VIRGINIA,SCOTT,2725,170,6980,9875,0.2759493670886076,0.7068354430379746,0.017215189873417722
2008,VIRGINIA,SHENANDOAH,6912,306,12005,19223,0.35956926598345734,0.6245123029704001,0.015918431046142642
2008,VIRGINIA,SMYTH,4239,246,7817,12302,0.3445781173792879,0.6354251341245326,0.019996748496179485
2008,VIRGINIA,SOUTHAMPTON,4402,82,4583,9067,0.48549685673320836,0.5054593581118342,0.009043785154957538
2008,VIRGINIA,SPOTSYLVANIA,24897,562,28610,54069,0.460467180824502,0.5291386931513437,0.010394126024154321
2008,VIRGINIA,STAFFORD,25716,518,29221,55455,0.46372734649715985,0.5269317464610945,0.009340907041745559
2008,VIRGINIA,STAUNTON,5569,116,5330,11015,0.505583295506128,0.48388561053109397,0.01053109396277803
2008,VIRGINIA,SUFFOLK,22446,297,17165,39908,0.5624436203267515,0.43011426280445025,0.007442116868798236
2008,VIRGINIA,SURRY,2626,36,1663,4325,0.6071676300578035,0.3845086705202312,0.008323699421965317
2008,VIRGINIA,SUSSEX,3301,36,2026,5363,0.6155137050158493,0.3777736341599851,0.006712660824165579
2008,VIRGINIA,TAZEWELL,5596,264,11201,17061,0.3279995310943087,0.656526581091378,0.015473887814313346
2008,VIRGINIA,VIRGINIA BEACH,98885,2045,100319,201249,0.4913564787899567,0.4984819800346834,0.010161541175359877
2008,VIRGINIA,WARREN,6997,250,8879,16126,0.4338955723676051,0.5506015130844599,0.015502914547935011
2008,VIRGINIA,WASHINGTON,8063,360,16077,24500,0.32910204081632655,0.6562040816326531,0.014693877551020407
2008,VIRGINIA,WAYNESBORO,3906,139,4815,8860,0.44085778781038376,0.5434537246049661,0.015688487584650114
2008,VIRGINIA,WESTMORELAND,4577,81,3719,8377,0.5463769846006924,0.4439536827026382,0.009669332696669452
2008,VIRGINIA,WILLIAMSBURG,4328,106,2353,6787,0.6376897008987771,0.34669220568734344,0.015618093413879475
2008,VIRGINIA,WINCHESTER,5268,133,4725,10126,0.5202449140825598,0.4666205806833893,0.013134505234050959
2008,VIRGINIA,WISE,4995,229,8914,14138,0.35330315461875794,0.6304993634177394,0.016197481963502618
2008,VIRGINIA,WYTHE,4107,177,8207,12491,0.3287967336482267,0.6570330638059403,0.014170202545833
2008,VIRGINIA,YORK,13700,364,19833,33897,0.4041655603740744,0.5850960261970086,0.010738413428917013
2008,WASHINGTON,ADAMS,1552,84,3222,4858,0.3194730341704405,0.6632358995471387,0.01729106628242075
2008,WASHINGTON,ASOTIN,4139,190,5451,9780,0.4232106339468303,0.557361963190184,0.019427402862985686
2008,WASHINGTON,BENTON,26288,1278,45345,72911,0.36054916267778525,0.6219226179863121,0.017528219335902675
2008,WASHINGTON,CHELAN,13781,572,17605,31958,0.4312222291757932,0.5508792790537581,0.017898491770448714
2008,WASHINGTON,CLALLAM,19470,850,18199,38519,0.5054648355357096,0.47246813260988085,0.022067031854409513
2008,WASHINGTON,CLARK,95356,3196,84212,182764,0.5217438882930993,0.46076907924974286,0.017487032457157863
2008,WASHINGTON,COLUMBIA,686,43,1499,2228,0.30789946140035906,0.6728007181328546,0.019299820466786355
2008,WASHINGTON,COWLITZ,24597,1078,19554,45229,0.5438324968493665,0.43233323752459707,0.023834265626036393
2008,WASHINGTON,DOUGLAS,5848,263,9098,15209,0.38450917220067066,0.5981984351370899,0.017292392662239465
2008,WASHINGTON,FERRY,1467,118,1916,3501,0.4190231362467866,0.5472722079405884,0.03370465581262497
2008,WASHINGTON,FRANKLIN,7361,298,12037,19696,0.37373070674248576,0.6111393176279447,0.015129975629569456
2008,WASHINGTON,GARFIELD,385,20,968,1373,0.28040786598689005,0.7050254916241806,0.014566642388929352
2008,WASHINGTON,GRANT,9601,684,17153,27438,0.349916174648298,0.6251548946716233,0.024928930680078724
2008,WASHINGTON,GRAYS HARBOR,16354,726,12104,29184,0.5603755482456141,0.4147478070175439,0.024876644736842105
2008,WASHINGTON,ISLAND,22058,675,19426,42159,0.5232097535520293,0.4607794302521407,0.01601081619583007
2008,WASHINGTON,JEFFERSON,13252,409,6330,19991,0.6628983042369067,0.31664248912010406,0.020459206642989346
2008,WASHINGTON,KING,648230,14086,259716,922032,0.7030450136220868,0.2816778593367692,0.015277127041143907
2008,WASHINGTON,KITSAP,68624,2416,53297,124337,0.5519193803936077,0.4286495572516628,0.019431062354729484
2008,WASHINGTON,KITTITAS,8030,367,9471,17868,0.4494067606895008,0.5300537273337811,0.020539511976718154
2008,WASHINGTON,KLICKITAT,4965,255,4944,10164,0.4884887839433294,0.48642266824085006,0.025088547815820542
2008,WASHINGTON,LEWIS,13624,803,20278,34705,0.3925659126926956,0.5842962109206167,0.023137876386687798
2008,WASHINGTON,LINCOLN,2032,142,3803,5977,0.3399698845574703,0.6362723774468797,0.02375773799564999
2008,WASHINGTON,MASON,15050,656,12600,28306,0.5316893944746697,0.44513530700204906,0.023175298523281283
2008,WASHINGTON,OKANOGAN,7613,459,8798,16870,0.45127445168938946,0.5215174866627149,0.027208061647895673
2008,WASHINGTON,PACIFIC,6094,288,4555,10937,0.5571911858827832,0.4164761817683094,0.02633263234890738
2008,WASHINGTON,PEND OREILLE,2562,273,3717,6552,0.391025641025641,0.5673076923076923,0.041666666666666664
2008,WASHINGTON,PIERCE,181824,6023,141673,329520,0.5517844136926439,0.4299374848264142,0.018278101480941975
2008,WASHINGTON,SAN JUAN,7374,199,2958,10531,0.7002184028107492,0.28088500617225337,0.018896591016997435
2008,WASHINGTON,SKAGIT,30053,1146,24687,55886,0.5377554306982071,0.44173853916902267,0.020506030132770282
2008,WASHINGTON,SKAMANIA,2817,149,2524,5490,0.5131147540983606,0.4597449908925319,0.027140255009107467
2008,WASHINGTON,SNOHOMISH,187294,6317,126722,320333,0.5846853118473588,0.3955945843856237,0.01972010376701745
2008,WASHINGTON,SPOKANE,105786,5411,108314,219511,0.481916623768285,0.49343313091371277,0.024650245318002285
2008,WASHINGTON,STEVENS,8499,710,13132,22341,0.3804216463005237,0.5877982185219999,0.03178013517747639
2008,WASHINGTON,THURSTON,75882,2461,48366,126709,0.5988682729719278,0.3817092708489531,0.019422456179119085
2008,WASHINGTON,WAHKIAKUM,1121,68,1105,2294,0.488666085440279,0.481691368788143,0.02964254577157803
2008,WASHINGTON,WALLA WALLA,10081,464,14182,24727,0.40769199660290373,0.5735430905487928,0.018764912848303474
2008,WASHINGTON,WHATCOM,58236,1898,40205,100339,0.580392469528299,0.40069165528857176,0.01891587518312919
2008,WASHINGTON,WHITMAN,9070,415,8104,17589,0.5156631985900278,0.46074250952299733,0.023594291886974813
2008,WASHINGTON,YAKIMA,33792,1324,41946,77062,0.4385040616646337,0.5443149671692923,0.01718097116607407
2008,WEST VIRGINIA,BARBOUR,2419,128,3685,6232,0.3881578947368421,0.5913029525032092,0.02053915275994865
2008,WEST VIRGINIA,BERKELEY,15994,457,20841,37292,0.428885551860989,0.5588598090743323,0.012254639064678751
2008,WEST VIRGINIA,BOONE,4529,209,3632,8370,0.5410991636798088,0.4339307048984468,0.024970131421744327
2008,WEST VIRGINIA,BRAXTON,2704,76,2629,5409,0.49990756147162135,0.48604178221482713,0.014050656313551489
2008,WEST VIRGINIA,BROOKE,4717,179,4961,9857,0.4785431672922796,0.5032971492340469,0.01815968347367353
2008,WEST VIRGINIA,CABELL,15292,507,18793,34592,0.44206753006475485,0.5432759019426457,0.014656567992599444
2008,WEST VIRGINIA,CALHOUN,993,70,1366,2429,0.4088102099629477,0.5623713462330177,0.02881844380403458
2008,WEST VIRGINIA,CLAY,1421,89,1755,3265,0.4352220520673813,0.5375191424196019,0.027258805513016845
2008,WEST VIRGINIA,DODDRIDGE,735,65,2218,3018,0.24353876739562624,0.7349237905897945,0.021537442014579192
2008,WEST VIRGINIA,FAYETTE,7242,294,7658,15194,0.4766355140186916,0.504014742661577,0.019349743319731473
2008,WEST VIRGINIA,GILMER,1004,72,1445,2521,0.3982546608488695,0.5731852439508132,0.028560095200317333
2008,WEST VIRGINIA,GRANT,997,55,3166,4218,0.2363679468942627,0.750592697961119,0.013039355144618302
2008,WEST VIRGINIA,GREENBRIER,5881,284,7567,13732,0.42826973492572096,0.5510486454995631,0.020681619574715992
2008,WEST VIRGINIA,HAMPSHIRE,2983,142,5222,8347,0.3573739067928597,0.6256139930513958,0.01701210015574458
2008,WEST VIRGINIA,HANCOCK,5504,198,7518,13220,0.416338880484115,0.5686838124054463,0.01497730711043873
2008,WEST VIRGINIA,HARDY,1901,130,3376,5407,0.3515812835213612,0.6243758091363047,0.02404290734233401
2008,WEST VIRGINIA,HARRISON,13582,466,17824,31872,0.42614206827309237,0.5592369477911646,0.014620983935742972
2008,WEST VIRGINIA,JACKSON,4861,227,7148,12236,0.39727034978751224,0.584177835894083,0.01855181431840471
2008,WEST VIRGINIA,JEFFERSON,11687,258,10600,22545,0.518385451319583,0.4701707695719672,0.011443779108449768
2008,WEST VIRGINIA,KANAWHA,40594,938,40952,82484,0.49214393094418313,0.4964841666262548,0.011371902429562097
2008,WEST VIRGINIA,LEWIS,2109,162,4335,6606,0.3192552225249773,0.6562216167120799,0.02452316076294278
2008,WEST VIRGINIA,LINCOLN,3029,169,3637,6835,0.4431602048280907,0.5321141185076811,0.024725676664228237
2008,WEST VIRGINIA,LOGAN,5873,266,7326,13465,0.43616784255477165,0.5440772372818418,0.019754920163386556
2008,WEST VIRGINIA,MARION,11618,488,11501,23607,0.49214216122336596,0.487186004151311,0.020671834625323
2008,WEST VIRGINIA,MARSHALL,5996,246,7759,14001,0.4282551246339547,0.5541747018070138,0.017570173559031496
2008,WEST VIRGINIA,MASON,4484,266,5853,10603,0.4228991794775064,0.5520135810619636,0.02508723946053004
2008,WEST VIRGINIA,MCDOWELL,3430,118,2882,6430,0.5334370139968896,0.44821150855365477,0.018351477449455676
2008,WEST VIRGINIA,MERCER,7450,326,13246,21022,0.3543906383788412,0.6301017981162591,0.01550756350489963
2008,WEST VIRGINIA,MINERAL,3750,181,7616,11547,0.3247596778383996,0.6595652550446003,0.015675067117000088
2008,WEST VIRGINIA,MINGO,3582,169,4587,8338,0.42959942432237946,0.5501319261213721,0.020268649556248502
2008,WEST VIRGINIA,MONONGALIA,17060,544,15775,33379,0.511099793283202,0.47260253452769707,0.016297672189100932
2008,WEST VIRGINIA,MONROE,2014,164,3397,5575,0.3612556053811659,0.6093273542600897,0.029417040358744394
2008,WEST VIRGINIA,MORGAN,2721,127,4428,7276,0.3739692138537658,0.6085761407366685,0.017454645409565695
2008,WEST VIRGINIA,NICHOLAS,4357,200,4804,9361,0.46544172631129155,0.5131930349321654,0.021365238756543104
2008,WEST VIRGINIA,OHIO,8593,253,10694,19540,0.43976458546571134,0.5472876151484135,0.012947799385875128
2008,WEST VIRGINIA,PENDLETON,1310,50,2035,3395,0.3858615611192931,0.5994108983799705,0.014727540500736377
2008,WEST VIRGINIA,PLEASANTS,1142,61,1772,2975,0.3838655462184874,0.5956302521008403,0.020504201680672268
2008,WEST VIRGINIA,POCAHONTAS,1548,83,2011,3642,0.42504118616144976,0.5521691378363537,0.022789676002196595
2008,WEST VIRGINIA,PRESTON,4205,266,7325,11796,0.35647677178704645,0.6209732112580536,0.022550016954899967
2008,WEST VIRGINIA,PUTNAM,9334,284,15162,24780,0.37667473769168686,0.611864406779661,0.011460855528652138
2008,WEST VIRGINIA,RALEIGH,10237,474,17548,28259,0.3622562723380162,0.6209703103436074,0.016773417318376446
2008,WEST VIRGINIA,RANDOLPH,4539,234,6060,10833,0.41899750761561894,0.5594018277485461,0.02160066463583495
2008,WEST VIRGINIA,RITCHIE,998,67,2781,3846,0.2594903796151846,0.7230889235569423,0.017420696827873113
2008,WEST VIRGINIA,ROANE,2511,109,2943,5563,0.45137515728923244,0.5290310983282401,0.019593744382527412
2008,WEST VIRGINIA,SUMMERS,2290,135,2891,5316,0.43077501881113617,0.5438299473288186,0.025395033860045147
2008,WEST VIRGINIA,TAYLOR,2462,136,3605,6203,0.39690472352087697,0.5811704014186684,0.02192487506045462
2008,WEST VIRGINIA,TUCKER,1288,96,2123,3507,0.36726546906187624,0.6053607071571143,0.02737382378100941
2008,WEST VIRGINIA,TYLER,1241,85,2415,3741,0.33172948409516173,0.6455493183640738,0.0227211975407645
2008,WEST VIRGINIA,UPSHUR,2925,135,5911,8971,0.3260506075130978,0.6589009029093746,0.015048489577527588
2008,WEST VIRGINIA,WAYNE,6137,346,8947,15430,0.3977316915100454,0.5798444588464031,0.022423849643551524
2008,WEST VIRGINIA,WEBSTER,1552,119,1386,3057,0.5076872751063134,0.4533856722276742,0.03892705266601243
2008,WEST VIRGINIA,WETZEL,2942,170,3342,6454,0.45584133870467924,0.5178184071893399,0.026340254105980787
2008,WEST VIRGINIA,WIRT,782,48,1496,2326,0.33619948409286327,0.6431642304385211,0.02063628546861565
2008,WEST VIRGINIA,WOOD,12573,533,22896,36002,0.34923059830009445,0.6359646686295206,0.014804733070384978
2008,WEST VIRGINIA,WYOMING,2735,174,4621,7530,0.36321381142098275,0.6136786188579018,0.023107569721115537
2008,WISCONSIN,ADAMS,5806,206,3974,9986,0.5814139795714,0.3979571399959944,0.020628880432605648
2008,WISCONSIN,ASHLAND,5818,122,2634,8574,0.6785630977373455,0.3072078376487054,0.014229064613949148
2008,WISCONSIN,BARRON,12078,351,10457,22886,0.5277462203967491,0.45691689242331557,0.015336887179935331
2008,WISCONSIN,BAYFIELD,5972,131,3365,9468,0.6307562315166878,0.3554076890578792,0.013836079425433037
2008,WISCONSIN,BROWN,67269,1631,55854,124754,0.5392131715215545,0.44771309937957904,0.013073729098866569
2008,WISCONSIN,BUFFALO,3949,128,2923,7000,0.5641428571428572,0.4175714285714286,0.018285714285714287
2008,WISCONSIN,BURNETT,4337,151,4200,8688,0.49919429097605894,0.48342541436464087,0.017380294659300185
2008,WISCONSIN,CALUMET,13295,457,12722,26474,0.5021908287376293,0.48054695172622197,0.017262219536148673
2008,WISCONSIN,CHIPPEWA,16239,500,13492,30231,0.5371638384439813,0.44629684760676125,0.016539313949257384
2008,WISCONSIN,CLARK,7454,350,6383,14187,0.5254105871572566,0.449918939874533,0.024670472968210334
2008,WISCONSIN,COLUMBIA,16661,418,12193,29272,0.5691787373599344,0.41654140475539764,0.014279857884667941
2008,WISCONSIN,CRAWFORD,4987,164,2830,7981,0.6248590402205237,0.35459215637138203,0.020548803408094223
2008,WISCONSIN,DANE,205984,3890,73065,282939,0.7280155793298202,0.258235874163689,0.013748546506490798
2008,WISCONSIN,DODGE,19183,625,23015,42823,0.4479602082992784,0.5374448310487355,0.014594960651986082
2008,WISCONSIN,DOOR,10142,227,7112,17481,0.5801727589954808,0.4068417138607631,0.012985527143756078
2008,WISCONSIN,DOUGLAS,15830,401,7835,24066,0.6577744535859719,0.32556303498711875,0.016662511426909332
2008,WISCONSIN,DUNN,13002,421,9566,22989,0.565574840140937,0.4161120535908478,0.018313106268215234
2008,WISCONSIN,EAU CLAIRE,33146,905,20959,55010,0.6025449918196691,0.38100345391746954,0.0164515542628613
2008,WISCONSIN,FLORENCE,1134,39,1512,2685,0.4223463687150838,0.5631284916201117,0.01452513966480447
2008,WISCONSIN,FOND DU LAC,23463,696,28164,52323,0.44842612235536955,0.538271888079812,0.01330198956481853
2008,WISCONSIN,FOREST,2673,47,1963,4683,0.5707879564381807,0.4191757420456972,0.010036301516122144
2008,WISCONSIN,GRANT,14875,377,9068,24320,0.6116365131578947,0.37286184210526313,0.015501644736842105
2008,WISCONSIN,GREEN,11502,302,6730,18534,0.6205891874393007,0.3631164346606237,0.016294377900075537
2008,WISCONSIN,GREEN LAKE,4000,143,5393,9536,0.41946308724832215,0.5655411073825504,0.014995805369127516
2008,WISCONSIN,IOWA,7987,153,3829,11969,0.6673072102932576,0.31990976689781936,0.012783022808923052
2008,WISCONSIN,IRON,1914,54,1464,3432,0.5576923076923077,0.42657342657342656,0.015734265734265736
2008,WISCONSIN,JACKSON,5572,127,3552,9251,0.6023132634309805,0.38395849097394874,0.013728245595070803
2008,WISCONSIN,JEFFERSON,21448,622,21096,43166,0.4968725385720243,0.4887179724783394,0.014409488949636288
2008,WISCONSIN,JUNEAU,6186,196,5148,11530,0.5365134431916739,0.4464874241110147,0.01699913269731136
2008,WISCONSIN,KENOSHA,45836,1344,31609,78789,0.5817563365444415,0.401185444668672,0.017058218786886493
2008,WISCONSIN,KEWAUNEE,5902,174,4711,10787,0.5471400760174284,0.43672939649578196,0.016130527486789656
2008,WISCONSIN,LA CROSSE,38524,993,23701,63218,0.6093834034610396,0.3749090448922775,0.015707551646682905
2008,WISCONSIN,LAFAYETTE,4732,115,2984,7831,0.6042651002426255,0.3810496743710893,0.014685225386285276
2008,WISCONSIN,LANGLADE,5182,139,5081,10402,0.49817342818688715,0.4884637569698135,0.013362814843299365
2008,WISCONSIN,LINCOLN,8424,325,6519,15268,0.5517422059208803,0.42697144354204875,0.021286350537070998
2008,WISCONSIN,MANITOWOC,22428,752,19234,42414,0.5287876644504174,0.45348234073654925,0.01772999481303343
2008,WISCONSIN,MARATHON,36367,1228,30345,67940,0.5352811304091846,0.4466440977332941,0.018074771857521342
2008,WISCONSIN,MARINETTE,11195,334,9726,21255,0.5266996000940956,0.45758645024700073,0.015713949658903787
2008,WISCONSIN,MARQUETTE,4068,124,3654,7846,0.5184807545245985,0.46571501401988274,0.015804231455518736
2008,WISCONSIN,MENOMINEE,1257,6,185,1448,0.8680939226519337,0.1277624309392265,0.004143646408839779
2008,WISCONSIN,MILWAUKEE,319819,5928,149445,475192,0.6730311116348761,0.31449393087425714,0.012474957490866849
2008,WISCONSIN,MONROE,10198,288,8666,19152,0.5324770258980785,0.45248538011695905,0.015037593984962405
2008,WISCONSIN,OCONTO,9927,286,8755,18968,0.5233551244200759,0.46156684943062,0.015078026149304091
2008,WISCONSIN,ONEIDA,11907,390,9630,21927,0.5430291421535094,0.439184566972226,0.017786290874264605
2008,WISCONSIN,OUTAGAMIE,50294,1592,39677,91563,0.5492830073282876,0.4333300569007132,0.0173869357709992
2008,WISCONSIN,OZAUKEE,20579,614,32172,53365,0.3856272838002436,0.6028670476904338,0.01150566850932259
2008,WISCONSIN,PEPIN,2102,53,1616,3771,0.5574118271015646,0.42853354547865286,0.01405462741978255
2008,WISCONSIN,PIERCE,11803,492,9812,22107,0.5339032885511377,0.4438413172298367,0.02225539421902565
2008,WISCONSIN,POLK,10876,485,11282,22643,0.4803250452678532,0.4982555315108422,0.021419423221304596
2008,WISCONSIN,PORTAGE,24817,795,13810,39422,0.6295215869311552,0.35031200852315963,0.02016640454568515
2008,WISCONSIN,PRICE,4559,174,3461,8194,0.5563827190627288,0.422382230900659,0.021235050036612156
2008,WISCONSIN,RACINE,53408,1280,45954,100642,0.5306730788338865,0.45660857296158663,0.012718348204526938
2008,WISCONSIN,RICHLAND,5041,111,3298,8450,0.5965680473372781,0.3902958579881657,0.013136094674556212
2008,WISCONSIN,ROCK,50529,1276,27364,79169,0.6382422412813096,0.34564033902158675,0.016117419697103664
2008,WISCONSIN,RUSK,3855,164,3253,7272,0.5301155115511551,0.44733223322332233,0.022552255225522552
2008,WISCONSIN,SAUK,18617,447,11562,30626,0.6078821916019069,0.37752236661660027,0.014595441781492849
2008,WISCONSIN,SAWYER,4765,121,4199,9085,0.5244909190974133,0.46219042377545405,0.013318657127132635
2008,WISCONSIN,SHAWANO,10259,292,9538,20089,0.5106774851909005,0.47478719697346805,0.01453531783563144
2008,WISCONSIN,SHEBOYGAN,30395,911,30801,62107,0.489397330413641,0.49593443573188206,0.01466823385447695
2008,WISCONSIN,ST. CROIX,21177,807,22837,44821,0.47247941812989447,0.509515628834698,0.01800495303540751
2008,WISCONSIN,TAYLOR,4563,197,4586,9346,0.48823025893430344,0.49069120479349454,0.021078536272202013
2008,WISCONSIN,TREMPEALEAU,8321,185,4808,13314,0.6249812227730209,0.3611236292624305,0.013895147964548596
2008,WISCONSIN,VERNON,8463,245,5367,14075,0.6012788632326821,0.3813143872113677,0.017406749555950268
2008,WISCONSIN,VILAS,6491,204,7055,13750,0.47207272727272725,0.513090909090909,0.014836363636363637
2008,WISCONSIN,WALWORTH,24177,760,25485,50422,0.4794930784181508,0.5054341358930625,0.01507278568878664
2008,WISCONSIN,WASHBURN,4693,116,4303,9112,0.5150351185250219,0.4722344161545215,0.012730465320456541
2008,WISCONSIN,WASHINGTON,25719,963,47729,74411,0.345634382013412,0.6414239830132642,0.012941634973323837
2008,WISCONSIN,WAUKESHA,85339,2406,145152,232897,0.3664237839044728,0.6232454690270807,0.010330747068446567
2008,WISCONSIN,WAUPACA,12952,327,12232,25511,0.507702559680138,0.4794794402414645,0.012818000078397554
2008,WISCONSIN,WAUSHARA,5868,211,5770,11849,0.49523166511941935,0.48696092497257154,0.017807409908009116
2008,WISCONSIN,WINNEBAGO,48167,1564,37946,87677,0.5493687055898354,0.4327930928293623,0.017838201580802262
2008,WISCONSIN,WOOD,21710,761,16581,39052,0.5559254327563249,0.42458772918160403,0.019486838062071084
2008,WYOMING,ALBANY,8644,621,7936,17201,0.5025289227370502,0.4613685250857508,0.036102552177199
2008,WYOMING,BIG HORN,1108,188,4045,5341,0.2074517880546714,0.7573488110840667,0.035199400861261936
2008,WYOMING,CAMPBELL,2990,384,13011,16385,0.1824839792493134,0.7940799511748551,0.023436069575831553
2008,WYOMING,CARBON,2336,233,4331,6900,0.33855072463768116,0.6276811594202899,0.033768115942028984
2008,WYOMING,CONVERSE,1380,199,4922,6501,0.21227503461006,0.7571142901092139,0.030610675280726043
2008,WYOMING,CROOK,612,127,2967,3706,0.1651376146788991,0.8005936319481921,0.03426875337290879
2008,WYOMING,FREMONT,6016,616,11083,17715,0.3395992097092859,0.6256279988710133,0.03477279141970082
2008,WYOMING,GOSHEN,1832,191,3942,5965,0.3071248952221291,0.6608549874266555,0.032020117351215426
2008,WYOMING,HOT SPRINGS,619,111,1834,2564,0.24141965678627145,0.7152886115444618,0.043291731669266774
2008,WYOMING,JOHNSON,908,133,3334,4375,0.20754285714285714,0.7620571428571429,0.0304
2008,WYOMING,LARAMIE,16072,1185,24549,41806,0.38444242453236377,0.5872123618619337,0.02834521360570253
2008,WYOMING,LINCOLN,1823,307,6485,8615,0.21160766105629716,0.7527568195008706,0.03563551944283227
2008,WYOMING,NATRONA,10475,1092,21906,33473,0.3129387864846294,0.654437905177307,0.03262330833806351
2008,WYOMING,NIOBRARA,244,43,1017,1304,0.18711656441717792,0.7799079754601227,0.032975460122699383
2008,WYOMING,PARK,3757,453,10839,15049,0.24965113961060537,0.7202471925044853,0.030101667884909297
2008,WYOMING,PLATTE,1407,188,3002,4597,0.30606917554927127,0.6530345877746356,0.04089623667609311
2008,WYOMING,SHERIDAN,4458,404,10177,15039,0.2964292838619589,0.6767072278741938,0.02686348826384733
2008,WYOMING,SUBLETTE,936,123,3316,4375,0.21394285714285713,0.7579428571428571,0.028114285714285713
2008,WYOMING,SWEETWATER,5762,711,10360,16833,0.3423038079961979,0.615457731836274,0.04223846016752807
2008,WYOMING,TETON,7472,322,4565,12359,0.6045796585484262,0.3693664535965693,0.02605388785500445
2008,WYOMING,UINTA,2317,338,5763,8418,0.2752435257780946,0.6846044191019245,0.040152055119980996
2008,WYOMING,WASHAKIE,1042,102,2956,4100,0.25414634146341464,0.7209756097560975,0.024878048780487806
2008,WYOMING,WESTON,658,138,2618,3414,0.19273579379027533,0.7668424135910955,0.040421792618629174
2012,ALABAMA,AUTAUGA,6363,190,17379,23932,0.2658783219120842,0.7261825171318737,0.00793916095604212
2012,ALABAMA,BALDWIN,18424,898,66016,85338,0.21589444327263352,0.7735826946963837,0.01052286203098268
2012,ALABAMA,BARBOUR,5912,47,5550,11509,0.5136849422191329,0.48223129724563385,0.004083760535233296
2012,ALABAMA,BIBB,2202,86,6132,8420,0.261520190023753,0.7282660332541567,0.010213776722090262
2012,ALABAMA,BLOUNT,2970,279,20757,24006,0.12371907023244189,0.8646588352911772,0.011622094476380905
2012,ALABAMA,BULLOCK,4061,10,1251,5322,0.7630590003757985,0.2350620067643743,0.0018789928598271326
2012,ALABAMA,BUTLER,4374,35,5087,9496,0.4606149957877001,0.5356992417860151,0.0036857624262847514
2012,ALABAMA,CALHOUN,15511,468,30278,46257,0.33532222150161056,0.6545603908597618,0.010117387638627667
2012,ALABAMA,CHAMBERS,6871,114,7626,14611,0.4702621312709602,0.5219355280268291,0.007802340702210663
2012,ALABAMA,CHEROKEE,2132,141,7506,9779,0.21801820227017077,0.7675631455159014,0.014418652213927805
2012,ALABAMA,CHILTON,3397,133,13932,17462,0.19453670828083838,0.7978467529492612,0.007616538769900355
2012,ALABAMA,CHOCTAW,3786,30,4152,7968,0.4751506024096386,0.5210843373493976,0.0037650602409638554
2012,ALABAMA,CLARKE,6334,47,7470,13851,0.4572955021298101,0.539311241065627,0.0033932568045628476
2012,ALABAMA,CLAY,1777,68,4817,6662,0.26673671570099067,0.7230561392975082,0.01020714500150105
2012,ALABAMA,CLEBURNE,971,62,5272,6305,0.15400475812846948,0.836161776367962,0.009833465503568596
2012,ALABAMA,COFFEE,4925,179,14666,19770,0.24911482043500252,0.741831057157309,0.009054122407688417
2012,ALABAMA,COLBERT,9166,283,13936,23385,0.3919606585418003,0.5959375668163353,0.012101774641864443
2012,ALABAMA,CONECUH,3555,28,3439,7022,0.5062660210766163,0.4897465109655369,0.003987467957846767
2012,ALABAMA,COOSA,2191,29,3049,5269,0.41582843044220913,0.5786676788764471,0.005503890681343709
2012,ALABAMA,COVINGTON,3158,112,12153,15423,0.20475912598067822,0.7879789924139272,0.0072618816053945405
2012,ALABAMA,CRENSHAW,2050,37,4331,6418,0.31941414770956683,0.6748208164537239,0.005765035836709256
2012,ALABAMA,CULLMAN,5052,406,28999,34457,0.14661752328989755,0.841599674957193,0.011782801752909423
2012,ALABAMA,DALE,5286,163,13108,18557,0.28485207738319773,0.7063641752438433,0.008783747372958992
2012,ALABAMA,DALLAS,14612,53,6288,20953,0.6973703049682624,0.3001002243115544,0.0025294707201832674
2012,ALABAMA,DEKALB,5239,293,18331,23863,0.21954490214977163,0.7681766751875289,0.012278422662699576
2012,ALABAMA,ELMORE,8954,278,26253,35485,0.25233197125546003,0.7398337325630548,0.007834296181485135
2012,ALABAMA,ESCAMBIA,5489,93,9287,14869,0.36915730714910217,0.6245880691371309,0.006254623713766898
2012,ALABAMA,ETOWAH,12803,597,29130,42530,0.3010345638372913,0.6849282859158241,0.014037150246884553
2012,ALABAMA,FAYETTE,1817,75,6054,7946,0.22866851245909892,0.7618927762396174,0.009438711301283665
2012,ALABAMA,FRANKLIN,3171,121,7567,10859,0.2920158393958928,0.6968413297725389,0.011142830831568284
2012,ALABAMA,GENEVA,2039,106,9175,11320,0.18012367491166079,0.8105123674911661,0.009363957597173145
2012,ALABAMA,GREENE,4521,15,804,5340,0.846629213483146,0.15056179775280898,0.0028089887640449437
2012,ALABAMA,HALE,5411,22,3210,8643,0.6260557676732617,0.3713988198542173,0.0025454124725211155
2012,ALABAMA,HENRY,3083,49,5628,8760,0.3519406392694064,0.6424657534246575,0.005593607305936073
2012,ALABAMA,HOUSTON,12367,281,29270,41918,0.29502838875900567,0.6982680471396536,0.006703564101340713
2012,ALABAMA,JACKSON,5822,316,14439,20577,0.282937260047626,0.7017057880157458,0.015356951936628274
2012,ALABAMA,JEFFERSON,159876,2359,141683,303918,0.5260497897459183,0.46618824814588145,0.0077619621082002386
2012,ALABAMA,LAMAR,1646,63,5457,7166,0.22969578565447948,0.7615126988557075,0.008791515489813006
2012,ALABAMA,LAUDERDALE,12511,502,23911,36924,0.33883111255551945,0.6475733939984833,0.013595493445997184
2012,ALABAMA,LAWRENCE,5069,169,8874,14112,0.35919784580498865,0.6288265306122449,0.01197562358276644
2012,ALABAMA,LEE,21381,784,32194,54359,0.3933295314483342,0.5922478338453614,0.014422634706304383
2012,ALABAMA,LIMESTONE,9829,335,25295,35459,0.27719337826785867,0.7133590907809019,0.00944753095123946
2012,ALABAMA,LOWNDES,5747,18,1756,7521,0.7641271107565484,0.23347959047998937,0.0023932987634623054
2012,ALABAMA,MACON,9045,18,1331,10394,0.8702135847604388,0.1280546469116798,0.00173176832788147
2012,ALABAMA,MADISON,62015,2160,90884,155059,0.39994453724066326,0.5861252813445205,0.013930181414816296
2012,ALABAMA,MARENGO,6167,34,5336,11537,0.5345410418653029,0.46251191817630233,0.00294703995839473
2012,ALABAMA,MARION,2249,159,9697,12105,0.18579099545642297,0.8010739363899215,0.013135068153655513
2012,ALABAMA,MARSHALL,6299,400,25867,32566,0.19342258797518885,0.794294663145612,0.012282748879199164
2012,ALABAMA,MOBILE,78760,1211,94893,174864,0.45040717357489246,0.5426674444139445,0.006925382011162961
2012,ALABAMA,MONROE,4914,53,5741,10708,0.45890922674635787,0.5361412028389989,0.004949570414643258
2012,ALABAMA,MONTGOMERY,63085,507,38332,101924,0.6189415643028139,0.37608414112475963,0.004974294572426514
2012,ALABAMA,MORGAN,13439,493,35391,49323,0.27246923342051377,0.7175354297183869,0.009995336861099284
2012,ALABAMA,PERRY,4568,25,1506,6099,0.7489752418429251,0.2469257255287752,0.004099032628299721
2012,ALABAMA,PICKENS,4455,32,5124,9611,0.463531370304859,0.5331391114348143,0.003329518260326709
2012,ALABAMA,PIKE,6035,109,7963,14107,0.4278018005245623,0.5644715389522932,0.007726660523144538
2012,ALABAMA,RANDOLPH,3078,96,7224,10398,0.2960184650894403,0.6947489901904212,0.009232544720138488
2012,ALABAMA,RUSSELL,10500,101,8278,18879,0.5561735261401557,0.4384766142274485,0.0053498596323957835
2012,ALABAMA,SHELBY,20051,1020,71436,92507,0.2167511647767196,0.7722226426108294,0.01102619261245095
2012,ALABAMA,ST. CLAIR,5801,316,29031,35148,0.16504495277113918,0.8259644930010243,0.008990554227836577
2012,ALABAMA,SUMTER,5421,20,1586,7027,0.7714529671267967,0.22570086808026185,0.0028461647929415115
2012,ALABAMA,TALLADEGA,13905,222,19246,33373,0.4166541815239865,0.5766937344559974,0.0066520840200161805
2012,ALABAMA,TALLAPOOSA,6319,114,12396,18829,0.3355993414413936,0.6583461681448829,0.006054490413723511
2012,ALABAMA,TUSCALOOSA,32048,794,45748,78590,0.407787250286296,0.5821096831657971,0.010103066547906858
2012,ALABAMA,WALKER,6557,313,21651,28521,0.22990077486764138,0.7591248553697275,0.010974369762631045
2012,ALABAMA,WASHINGTON,2976,41,5761,8778,0.3390293916609706,0.6562998405103668,0.004670767828662566
2012,ALABAMA,WILCOX,4868,4,1679,6551,0.7430926576095253,0.25629674858800183,0.000610593802472905
2012,ALABAMA,WINSTON,1286,116,8312,9714,0.13238624665431337,0.8556722256536957,0.01194152769199094
2012,ALASKA,DISTRICT 1,1518,305,5899,7722,0.19658119658119658,0.7639212639212639,0.0394975394975395
2012,ALASKA,DISTRICT 10,1344,298,4928,6570,0.2045662100456621,0.750076103500761,0.045357686453576865
2012,ALASKA,DISTRICT 11,2222,352,6057,8631,0.25744409686015524,0.7017726798748697,0.04078322326497509
2012,ALASKA,DISTRICT 12,1901,281,4300,6482,0.2932736809626658,0.6633755013884604,0.0433508176488738
2012,ALASKA,DISTRICT 13,2425,204,3078,5707,0.4249167688803224,0.5393376555107763,0.03574557560890135
2012,ALASKA,DISTRICT 14,3340,275,3453,7068,0.4725523486134692,0.4885398981324278,0.038907753254103
2012,ALASKA,DISTRICT 15,3283,293,2875,6451,0.508913346767943,0.4456673383971477,0.04541931483490932
2012,ALASKA,DISTRICT 16,4013,292,2876,7181,0.5588358167386158,0.4005013229355243,0.04066286032585991
2012,ALASKA,DISTRICT 17,2853,194,1542,4589,0.6217040749618653,0.3360209195903247,0.04227500544780998
2012,ALASKA,DISTRICT 18,4247,314,2369,6930,0.6128427128427129,0.34184704184704184,0.04531024531024531
2012,ALASKA,DISTRICT 19,4126,305,3855,8286,0.4979483466087376,0.4652425778421434,0.036809075549119
2012,ALASKA,DISTRICT 2,3096,453,5509,9058,0.34179730624862,0.6081916537867079,0.05001103996467211
2012,ALASKA,DISTRICT 20,3081,339,4544,7964,0.38686589653440484,0.5705675539929683,0.04256654947262682
2012,ALASKA,DISTRICT 21,3316,288,5262,8866,0.37401308369050307,0.5935032709226258,0.03248364538687119
2012,ALASKA,DISTRICT 22,2859,251,3445,6555,0.43615560640732265,0.5255530129672006,0.03829138062547673
2012,ALASKA,DISTRICT 23,3167,277,4926,8370,0.3783751493428913,0.5885304659498208,0.033094384707287934
2012,ALASKA,DISTRICT 24,3128,249,3912,7289,0.42913979969817534,0.5366991356839073,0.03416106461791741
2012,ALASKA,DISTRICT 25,3739,353,4569,8661,0.43170534580302505,0.5275372358850018,0.040757418311973215
2012,ALASKA,DISTRICT 26,3169,354,6968,10491,0.30206843961490804,0.6641883519206939,0.03374320846439806
2012,ALASKA,DISTRICT 27,4463,345,6015,10823,0.4123625612122332,0.5557608796082417,0.03187655917952509
2012,ALASKA,DISTRICT 28,2188,379,5882,8449,0.2589655580542076,0.6961770623742455,0.04485737957154693
2012,ALASKA,DISTRICT 29,1933,304,5774,8011,0.24129322181999752,0.7207589564349021,0.03794782174510049
2012,ALASKA,DISTRICT 3,2034,266,3769,6069,0.3351458230350964,0.6210248805404515,0.04382929642445214
2012,ALASKA,DISTRICT 30,3578,435,5492,9505,0.37643345607574963,0.5778011572856392,0.04576538663861126
2012,ALASKA,DISTRICT 31,4679,437,4219,9335,0.5012319228709159,0.45195500803427957,0.046813069094804496
2012,ALASKA,DISTRICT 32,5930,503,3095,9528,0.6223761544920235,0.3248320738874895,0.05279177162048698
2012,ALASKA,DISTRICT 33,2716,466,4289,7471,0.3635390175344666,0.57408646767501,0.062374514790523354
2012,ALASKA,DISTRICT 34,4662,452,3523,8637,0.5397707537339353,0.40789626027555864,0.05233298599050596
2012,ALASKA,DISTRICT 35,2830,298,3804,6932,0.4082515868436238,0.5487593768032314,0.042989036353144834
2012,ALASKA,DISTRICT 36,3341,245,1386,4972,0.6719629927594529,0.27876106194690264,0.04927594529364441
2012,ALASKA,DISTRICT 37,2631,187,1517,4335,0.6069204152249135,0.34994232987312573,0.043137254901960784
2012,ALASKA,DISTRICT 38,4101,454,2259,6814,0.6018491341356031,0.33152333431171116,0.06662753155268565
2012,ALASKA,DISTRICT 39,3645,349,2566,6560,0.555640243902439,0.39115853658536587,0.05320121951219512
2012,ALASKA,DISTRICT 4,2864,337,3586,6787,0.4219832031825549,0.5283630470016207,0.04965374981582437
2012,ALASKA,DISTRICT 40,2717,171,1347,4235,0.6415584415584416,0.31806375442739077,0.04037780401416765
2012,ALASKA,DISTRICT 5,3644,472,4027,8143,0.44750092103647304,0.4945351835932703,0.05796389537025666
2012,ALASKA,DISTRICT 6,2145,394,5254,7793,0.27524701655331707,0.67419479019633,0.05055819325035288
2012,ALASKA,DISTRICT 7,1962,366,5247,7575,0.259009900990099,0.6926732673267326,0.04831683168316832
2012,ALASKA,DISTRICT 8,2083,333,5826,8242,0.25272991992234894,0.7068672652268867,0.04040281485076438
2012,ALASKA,DISTRICT 9,1667,309,5432,7408,0.2250269978401728,0.7332613390928726,0.041711663066954646
2012,ALASKA,DISTRICT 99,0,0,0,0,,,
2012,ARIZONA,APACHE,17147,451,8250,25848,0.6633782110801609,0.3191736304549675,0.017448158464871556
2012,ARIZONA,COCHISE,18546,960,29497,49003,0.378466624492378,0.601942738199702,0.019590637307919923
2012,ARIZONA,COCONINO,29257,1254,21220,51731,0.5655603023332237,0.4101989136107943,0.024240784055981908
2012,ARIZONA,GILA,7697,376,13455,21528,0.35753437383872166,0.625,0.017465626161278336
2012,ARIZONA,GRAHAM,3609,170,8076,11855,0.3044285111767187,0.681231547870097,0.01433994095318431
2012,ARIZONA,GREENLEE,1310,72,1592,2974,0.44048419636852726,0.535305985205111,0.0242098184263618
2012,ARIZONA,LA PAZ,1880,123,3714,5717,0.3288437991953822,0.6496414203253454,0.021514780479272345
2012,ARIZONA,MARICOPA,602288,24385,749885,1376558,0.4375318729759298,0.5447536536782323,0.017714473345837953
2012,ARIZONA,MOHAVE,19533,1309,49168,70010,0.2790029995714898,0.7022996714755035,0.018697328953006714
2012,ARIZONA,NAVAJO,16945,506,19884,37335,0.45386366680058926,0.5325833668139816,0.013552966385429221
2012,ARIZONA,PIMA,201251,6220,174779,382250,0.5264905166775671,0.45723741007194246,0.016272073250490515
2012,ARIZONA,PINAL,44306,1930,62079,108315,0.40904768499284494,0.5731339149702257,0.017818400036929326
2012,ARIZONA,SANTA CRUZ,9486,173,4235,13894,0.6827407514034836,0.30480783071829565,0.012451417878220815
2012,ARIZONA,YAVAPAI,33918,1897,64468,100283,0.33822282939281834,0.642860704207094,0.01891646640008775
2012,ARIZONA,YUMA,18059,542,23352,41953,0.4304578933568517,0.5566228875169833,0.012919219126164994
2012,ARKANSAS,ARKANSAS,2455,142,3897,6494,0.37804126886356637,0.6000923929781337,0.02186633815829997
2012,ARKANSAS,ASHLEY,2859,195,4867,7921,0.3609392753440222,0.6144426208812018,0.024618103774775912
2012,ARKANSAS,BAXTER,5172,479,13688,19339,0.2674388541289622,0.7077925435648172,0.02476860230622059
2012,ARKANSAS,BENTON,22636,1975,54646,79257,0.28560253353016135,0.6894785318646933,0.02491893460514529
2012,ARKANSAS,BOONE,3772,460,11159,15391,0.24507829250860894,0.7250341108439997,0.029887596647391334
2012,ARKANSAS,BRADLEY,1449,69,2134,3652,0.39676889375684554,0.5843373493975904,0.018893756845564075
2012,ARKANSAS,CALHOUN,660,56,1458,2174,0.30358785648574055,0.6706531738730451,0.025758969641214352
2012,ARKANSAS,CARROLL,3696,362,6125,10183,0.36295787096140625,0.6014926838849062,0.03554944515368752
2012,ARKANSAS,CHICOT,2649,42,1670,4361,0.6074294886493924,0.382939692731025,0.009630818619582664
2012,ARKANSAS,CLARK,3811,255,4343,8409,0.45320489951242715,0.5164704483291711,0.030324652158401712
2012,ARKANSAS,CLAY,1738,147,3225,5110,0.3401174168297456,0.6311154598825832,0.028767123287671233
2012,ARKANSAS,CLEBURNE,2620,334,8693,11647,0.22495063106379326,0.7463724564265476,0.02867691250965914
2012,ARKANSAS,CLEVELAND,845,108,2313,3266,0.25872627066748316,0.7082057562767912,0.03306797305572566
2012,ARKANSAS,COLUMBIA,3557,108,5790,9455,0.37620306716023266,0.612374405076679,0.011422527763088313
2012,ARKANSAS,CONWAY,3005,211,4514,7730,0.388745148771022,0.5839586028460544,0.027296248382923674
2012,ARKANSAS,CRAIGHEAD,10527,823,20350,31700,0.3320820189274448,0.6419558359621451,0.025962145110410093
2012,ARKANSAS,CRAWFORD,4881,565,15145,20591,0.23704531105822932,0.7355155164877859,0.02743917245398475
2012,ARKANSAS,CRITTENDEN,9487,231,6998,16716,0.5675400813591769,0.4186408231634362,0.013819095477386936
2012,ARKANSAS,CROSS,2279,133,4269,6681,0.3411165993114803,0.6389762011674899,0.019907199521029786
2012,ARKANSAS,DALLAS,1337,82,1665,3084,0.4335278858625162,0.5398832684824902,0.026588845654993514
2012,ARKANSAS,DESHA,2443,81,1896,4420,0.5527149321266969,0.4289592760180995,0.01832579185520362
2012,ARKANSAS,DREW,2630,116,3887,6633,0.3965023368008443,0.586009347203377,0.017488315995778683
2012,ARKANSAS,FAULKNER,13621,1117,26722,41460,0.3285335262904004,0.644524843222383,0.026941630487216595
2012,ARKANSAS,FRANKLIN,1726,183,4631,6540,0.26391437308868504,0.7081039755351682,0.02798165137614679
2012,ARKANSAS,FULTON,1452,121,2949,4522,0.32109685979655017,0.6521450685537373,0.026758071649712518
2012,ARKANSAS,GARLAND,13804,910,26014,40728,0.3389314476527205,0.6387252013356904,0.022343351011589078
2012,ARKANSAS,GRANT,1468,182,4829,6479,0.22657817564438956,0.7453310696095077,0.028090754746102793
2012,ARKANSAS,GREENE,4000,690,9071,13761,0.2906765496693554,0.6591817455126807,0.05014170481796381
2012,ARKANSAS,HEMPSTEAD,2468,169,4284,6921,0.35659586764918366,0.6189856957087126,0.024418436642103743
2012,ARKANSAS,HOT SPRING,3830,333,7097,11260,0.3401420959147424,0.6302841918294849,0.029573712255772648
2012,ARKANSAS,HOWARD,1471,99,2892,4462,0.3296727924697445,0.6481398476019722,0.02218735992828328
2012,ARKANSAS,INDEPENDENCE,3281,388,8728,12397,0.26466080503347583,0.7040413003145922,0.03129789465193192
2012,ARKANSAS,IZARD,1524,179,3575,5278,0.2887457370215991,0.6773399014778325,0.033914361500568396
2012,ARKANSAS,JACKSON,2095,180,3072,5347,0.3918084907424724,0.5745277725827567,0.0336637366747709
2012,ARKANSAS,JEFFERSON,17470,393,9520,27383,0.6379870722711171,0.34766095752839354,0.014351970200489355
2012,ARKANSAS,JOHNSON,2799,235,5064,8098,0.3456408989874043,0.6253395900222277,0.02901951099036799
2012,ARKANSAS,LAFAYETTE,1173,43,1713,2929,0.400477978832366,0.5848412427449642,0.014680778422669852
2012,ARKANSAS,LAWRENCE,1788,216,3536,5540,0.3227436823104693,0.6382671480144404,0.03898916967509025
2012,ARKANSAS,LEE,2107,37,1280,3424,0.6153621495327103,0.37383177570093457,0.01080607476635514
2012,ARKANSAS,LINCOLN,1425,102,2199,3726,0.3824476650563607,0.5901771336553945,0.027375201288244767
2012,ARKANSAS,LITTLE RIVER,1552,114,3385,5051,0.3072658879429816,0.6701643238962581,0.022569788160760246
2012,ARKANSAS,LOGAN,2009,243,5079,7331,0.2740417405538126,0.6928113490656118,0.033146910380575635
2012,ARKANSAS,LONOKE,5625,609,17880,24114,0.23326698183627767,0.7414779795969146,0.025255038566807664
2012,ARKANSAS,MADISON,2099,206,4263,6568,0.3195797807551766,0.6490560292326432,0.03136419001218027
2012,ARKANSAS,MARION,2037,240,4774,7051,0.2888951921713232,0.6770670826833073,0.03403772514536945
2012,ARKANSAS,MILLER,4518,189,10622,15329,0.2947354687194207,0.6929349598799661,0.012329571400613217
2012,ARKANSAS,MISSISSIPPI,6467,305,6603,13375,0.4835140186915888,0.4936822429906542,0.02280373831775701
2012,ARKANSAS,MONROE,1583,62,1585,3230,0.49009287925696593,0.4907120743034056,0.019195046439628483
2012,ARKANSAS,MONTGOMERY,920,115,2369,3404,0.2702702702702703,0.6959459459459459,0.033783783783783786
2012,ARKANSAS,NEVADA,1314,74,1996,3384,0.3882978723404255,0.5898345153664303,0.02186761229314421
2012,ARKANSAS,NEWTON,993,160,2508,3661,0.2712373668396613,0.6850587271237367,0.04370390603660202
2012,ARKANSAS,OUACHITA,4633,161,5521,10315,0.4491517207949588,0.5352399418322831,0.01560833737275812
2012,ARKANSAS,PERRY,1187,170,2581,3938,0.30142204164550535,0.6554088369730828,0.043169121381411886
2012,ARKANSAS,PHILLIPS,5202,130,2598,7930,0.6559899117276167,0.32761664564943255,0.01639344262295082
2012,ARKANSAS,PIKE,851,90,2847,3788,0.22465681098204857,0.7515839493136219,0.02375923970432946
2012,ARKANSAS,POINSETT,2390,196,4974,7560,0.31613756613756616,0.6579365079365079,0.025925925925925925
2012,ARKANSAS,POLK,1556,215,5955,7726,0.20139787729743722,0.7707740098369144,0.02782811286564846
2012,ARKANSAS,POPE,5126,550,14763,20439,0.25079504868144237,0.7222956113312784,0.02690933998727922
2012,ARKANSAS,PRAIRIE,880,108,2153,3141,0.2801655523718561,0.6854504934734161,0.034383954154727794
2012,ARKANSAS,PULASKI,87248,3149,68984,159381,0.5474178227015767,0.4328244897446998,0.01975768755372347
2012,ARKANSAS,RANDOLPH,2046,209,3701,5956,0.3435191403626595,0.621390194761585,0.03509066487575554
2012,ARKANSAS,SALINE,12869,1230,32963,47062,0.2734477922740215,0.7004164718881476,0.026135735837830947
2012,ARKANSAS,SCOTT,897,112,2631,3640,0.24642857142857144,0.7228021978021978,0.03076923076923077
2012,ARKANSAS,SEARCY,814,181,2699,3694,0.22035733622089876,0.7306442880346508,0.04899837574445046
2012,ARKANSAS,SEBASTIAN,13092,1101,29169,43362,0.3019233430192334,0.6726857617268576,0.025390895253908953
2012,ARKANSAS,SEVIER,1042,152,3136,4330,0.24064665127020785,0.7242494226327945,0.03510392609699769
2012,ARKANSAS,SHARP,2092,270,4921,7283,0.2872442674721955,0.6756830976246052,0.03707263490319923
2012,ARKANSAS,ST. FRANCIS,4910,84,3368,8362,0.5871801004544367,0.402774455871801,0.010045443673762257
2012,ARKANSAS,STONE,1356,222,3776,5354,0.25326858423608517,0.7052670900261486,0.04146432573776616
2012,ARKANSAS,UNION,6196,282,10699,17177,0.3607149094719683,0.6228677883215928,0.016417302206438843
2012,ARKANSAS,VAN BUREN,1832,233,4365,6430,0.2849144634525661,0.6788491446345256,0.03623639191290824
2012,ARKANSAS,WASHINGTON,28236,2536,39688,70460,0.4007380073800738,0.5632699403917116,0.03599205222821459
2012,ARKANSAS,WHITE,5765,738,20011,26514,0.21743229991702498,0.7547333484197027,0.027834351663272233
2012,ARKANSAS,WOODRUFF,1340,118,1227,2685,0.49906890130353815,0.4569832402234637,0.04394785847299814
2012,ARKANSAS,YELL,1722,210,4042,5974,0.2882490793438232,0.67659859390693,0.03515232674924674
2012,CALIFORNIA,ALAMEDA,469684,17776,108182,595642,0.7885340523334486,0.1816225182240339,0.029843429442517486
2012,CALIFORNIA,ALPINE,389,28,236,653,0.5957120980091883,0.3614088820826952,0.042879019908116385
2012,CALIFORNIA,AMADOR,6830,538,10281,17649,0.3869907643492549,0.5825259221485637,0.030483313502181426
2012,CALIFORNIA,BUTTE,42669,3604,44479,90752,0.4701714562764457,0.4901159203102962,0.03971262341325811
2012,CALIFORNIA,CALAVERAS,8670,751,12365,21786,0.3979619939410631,0.5675663269989901,0.034471679059946754
2012,CALIFORNIA,COLUSA,2314,119,3601,6034,0.3834935366257872,0.5967848856479947,0.019721577726218097
2012,CALIFORNIA,CONTRA COSTA,290824,10885,136517,438226,0.6636393093974342,0.31152190878679037,0.02483878181577542
2012,CALIFORNIA,DEL NORTE,3791,365,4614,8770,0.4322690992018244,0.5261117445838084,0.04161915621436716
2012,CALIFORNIA,EL DORADO,35166,2635,50973,88774,0.39612949737535763,0.5741883884921261,0.029682114132516278
2012,CALIFORNIA,FRESNO,129129,5208,124490,258827,0.4989008101936815,0.48097764143617167,0.020121548370146854
2012,CALIFORNIA,GLENN,3301,278,5632,9211,0.35837585495603086,0.61144284008251,0.030181304961459127
2012,CALIFORNIA,HUMBOLDT,34457,4188,18825,57470,0.5995649904297895,0.3275622063685401,0.07287280320167043
2012,CALIFORNIA,IMPERIAL,25136,652,12777,38565,0.6517827045248282,0.3313107740178919,0.016906521457279916
2012,CALIFORNIA,INYO,3422,274,4340,8036,0.4258337481333997,0.5400696864111498,0.03409656545545047
2012,CALIFORNIA,KERN,89495,5359,126618,221472,0.4040917136251987,0.571711096662332,0.024197189712469296
2012,CALIFORNIA,KINGS,12979,768,17671,31418,0.4131071360366669,0.5624482780571647,0.02444458590616844
2012,CALIFORNIA,LAKE,13163,1028,9200,23391,0.5627378051387286,0.39331366764995085,0.043948527211320594
2012,CALIFORNIA,LASSEN,3053,334,7296,10683,0.2857811476177104,0.6829542263409155,0.031264626041374144
2012,CALIFORNIA,LOS ANGELES,2216903,78831,885333,3181067,0.6969054722833565,0.27831322006106757,0.024781307655575943
2012,CALIFORNIA,MADERA,16018,996,22852,39866,0.4017960166557969,0.5732202879646817,0.024983695379521397
2012,CALIFORNIA,MARIN,99896,3740,30880,134516,0.7426328466502126,0.229563769365726,0.027803383984061375
2012,CALIFORNIA,MARIPOSA,3498,362,5140,9000,0.38866666666666666,0.5711111111111111,0.04022222222222222
2012,CALIFORNIA,MENDOCINO,23193,2166,9658,35017,0.6623354370734215,0.27580889282348575,0.061855670103092786
2012,CALIFORNIA,MERCED,33005,1471,27581,62057,0.5318497510353385,0.4444462349130638,0.023704014051597725
2012,CALIFORNIA,MODOC,1111,98,2777,3986,0.2787255393878575,0.6966884094330156,0.024586051179126944
2012,CALIFORNIA,MONO,2733,163,2285,5181,0.527504342790967,0.44103454931480407,0.031461107894228915
2012,CALIFORNIA,MONTEREY,82920,3208,37390,123518,0.6713191599604916,0.30270891691899154,0.025971923120516847
2012,CALIFORNIA,NAPA,35870,1572,19526,56968,0.6296517343069794,0.34275382670973176,0.027594438983288862
2012,CALIFORNIA,NEVADA,24663,2027,24986,51676,0.4772621719947364,0.48351265577831104,0.03922517222695255
2012,CALIFORNIA,ORANGE,512440,27892,582332,1122664,0.45645001532070145,0.5187055076140323,0.02484447706526619
2012,CALIFORNIA,PLACER,66818,4583,99921,171322,0.39001412544798686,0.5832350778067031,0.02675079674531
2012,CALIFORNIA,PLUMAS,4026,300,5721,10047,0.40071663183039713,0.5694237085697224,0.029859659599880562
2012,CALIFORNIA,RIVERSIDE,329063,14717,318127,661907,0.49714385857831994,0.48062190005544586,0.02223424136623423
2012,CALIFORNIA,SACRAMENTO,300503,13792,202514,516809,0.5814585272315305,0.39185463101455276,0.026686841753916824
2012,CALIFORNIA,SAN BENITO,11276,425,7343,19044,0.5921024994749002,0.3855807603444654,0.02231674018063432
2012,CALIFORNIA,SAN BERNARDINO,305109,14050,262358,581517,0.5246776964387971,0.4511613589972434,0.02416094456395944
2012,CALIFORNIA,SAN DIEGO,626957,28599,536726,1192282,0.5258462343640179,0.4501669906951543,0.02398677494082776
2012,CALIFORNIA,SAN FRANCISCO,301723,12410,47076,361209,0.835314180986631,0.1303289785138244,0.034356840499544586
2012,CALIFORNIA,SAN JOAQUIN,114121,4505,86071,204697,0.5575118345652355,0.4204800265758658,0.02200813885889876
2012,CALIFORNIA,SAN LUIS OBISPO,61258,4413,59967,125638,0.48757541508142443,0.4772998615068689,0.03512472341170665
2012,CALIFORNIA,SAN MATEO,206085,6879,72756,285720,0.7212830743385132,0.25464090718185634,0.024076018479630406
2012,CALIFORNIA,SANTA BARBARA,94129,4585,64606,163320,0.5763470487386726,0.3955792309576292,0.02807372030369826
2012,CALIFORNIA,SANTA CLARA,450818,17430,174843,643091,0.7010174298816186,0.27187909642647773,0.027103473691903635
2012,CALIFORNIA,SANTA CRUZ,90805,5243,24047,120095,0.7561097464507265,0.20023314875723386,0.04365710479203964
2012,CALIFORNIA,SHASTA,25819,2449,48067,76335,0.3382327896770813,0.6296849413768258,0.03208226894609288
2012,CALIFORNIA,SIERRA,653,86,1056,1795,0.3637883008356546,0.5883008356545961,0.0479108635097493
2012,CALIFORNIA,SISKIYOU,8046,787,11077,19910,0.40411853340030135,0.556353591160221,0.03952787543947765
2012,CALIFORNIA,SOLANO,96783,3569,52092,152444,0.6348757576552702,0.3417123665083572,0.023411875836372702
2012,CALIFORNIA,SONOMA,153942,7782,54784,216508,0.7110222255066787,0.2530345299018974,0.035943244591423874
2012,CALIFORNIA,STANISLAUS,77724,4186,73459,155369,0.5002542334699972,0.47280345500067583,0.026942311529326957
2012,CALIFORNIA,SUTTER,12192,712,18122,31026,0.39296074260297814,0.5840907625862181,0.02294849481080384
2012,CALIFORNIA,TEHAMA,7934,808,14235,22977,0.3453018235626931,0.6195325760543152,0.035165600382991685
2012,CALIFORNIA,TRINITY,2674,284,2716,5674,0.4712724709199859,0.4786746563271061,0.050052872752908
2012,CALIFORNIA,TULARE,41752,2392,56956,101100,0.41297725024727994,0.5633630069238378,0.023659742828882294
2012,CALIFORNIA,TUOLUMNE,9998,809,13880,24687,0.4049904808198647,0.5622392352250172,0.03277028395511808
2012,CALIFORNIA,VENTURA,170929,8087,147958,326974,0.5227602194669912,0.45250692715628765,0.024732853376721084
2012,CALIFORNIA,YOLO,48715,2392,23368,74475,0.6541121181604566,0.31376972138301445,0.03211816045652904
2012,CALIFORNIA,YUBA,7711,714,11275,19700,0.3914213197969543,0.5723350253807107,0.03624365482233503
2012,COLORADO,ADAMS,100649,4609,70972,176230,0.5711229643080066,0.4027237133291721,0.026153322362821314
2012,COLORADO,ALAMOSA,3811,199,2705,6715,0.5675353685778108,0.4028294862248697,0.029635145197319433
2012,COLORADO,ARAPAHOE,153905,6023,125588,285516,0.5390415948668376,0.43986326510598356,0.02109514002717886
2012,COLORADO,ARCHULETA,2679,183,3872,6734,0.3978318978318978,0.574992574992575,0.027175527175527174
2012,COLORADO,BACA,467,80,1559,2106,0.22174738841405509,0.7402659069325735,0.03798670465337132
2012,COLORADO,BENT,815,52,1075,1942,0.4196704428424305,0.5535530381050463,0.026776519052523172
2012,COLORADO,BOULDER,125091,4427,49981,179499,0.6968896762656059,0.27844723368932417,0.024663090045069887
2012,COLORADO,BROOMFIELD,16966,803,15008,32777,0.5176190621472374,0.4578820514385087,0.024498886414253896
2012,COLORADO,CHAFFEE,5086,306,5070,10462,0.4861403173389409,0.4846109730453068,0.029248709615752246
2012,COLORADO,CHEYENNE,172,32,889,1093,0.15736505032021958,0.8133577310155535,0.0292772186642269
2012,COLORADO,CLEAR CREEK,3119,194,2430,5743,0.5430959428869928,0.42312380289047535,0.03378025422253178
2012,COLORADO,CONEJOS,2213,53,1835,4101,0.539624481833699,0.44745184101438673,0.012923677151914167
2012,COLORADO,COSTILLA,1340,51,446,1837,0.7294501905280348,0.24278715296679368,0.027762656505171474
2012,COLORADO,CROWLEY,535,43,924,1502,0.3561917443408788,0.6151797603195739,0.02862849533954727
2012,COLORADO,CUSTER,868,59,1788,2715,0.3197053406998158,0.6585635359116022,0.021731123388581953
2012,COLORADO,DELTA,4622,388,10915,15925,0.29023547880690737,0.6854003139717425,0.02436420722135008
2012,COLORADO,DENVER,222018,6565,73111,301694,0.7359045920701107,0.2423349486565858,0.021760459273303414
2012,COLORADO,DOLORES,334,52,859,1245,0.26827309236947794,0.6899598393574298,0.04176706827309237
2012,COLORADO,DOUGLAS,60991,2586,104204,167781,0.3635155351321067,0.6210715158450599,0.015412949022833336
2012,COLORADO,EAGLE,12792,465,9411,22668,0.5643197458973002,0.4151667548967708,0.020513499205929063
2012,COLORADO,EL PASO,111819,7404,170952,290175,0.38535021969501165,0.5891341431894547,0.02551563711553373
2012,COLORADO,ELBERT,3603,309,10266,14178,0.25412611087600506,0.7240795598815065,0.021794329242488364
2012,COLORADO,FREMONT,6704,538,13174,20416,0.3283699059561129,0.6452782131661442,0.026351880877742945
2012,COLORADO,GARFIELD,11305,568,12535,24408,0.46316781383153066,0.5135611274991806,0.023271058669288757
2012,COLORADO,GILPIN,1892,100,1346,3338,0.566806470940683,0.40323547034152185,0.029958058717795086
2012,COLORADO,GRAND,3684,250,4253,8187,0.44998167827042873,0.519482105777452,0.030536215952119212
2012,COLORADO,GUNNISON,5044,282,3341,8667,0.581977616245529,0.3854851736471674,0.032537210107303566
2012,COLORADO,HINSDALE,229,18,353,600,0.38166666666666665,0.5883333333333334,0.03
2012,COLORADO,HUERFANO,1953,115,1646,3714,0.5258481421647819,0.44318793753365643,0.03096392030156166
2012,COLORADO,JACKSON,216,32,600,848,0.25471698113207547,0.7075471698113207,0.03773584905660377
2012,COLORADO,JEFFERSON,159296,7559,144197,311052,0.5121201599732521,0.46357843704589585,0.024301402980852076
2012,COLORADO,KIOWA,118,26,677,821,0.14372716199756394,0.8246041412911084,0.031668696711327646
2012,COLORADO,KIT CARSON,838,79,2785,3702,0.22636412749864937,0.7522960561858455,0.021339816315505133
2012,COLORADO,LA PLATA,15489,901,12794,29184,0.5307360197368421,0.43839089912280704,0.030873081140350877
2012,COLORADO,LAKE,1839,103,1098,3040,0.6049342105263158,0.3611842105263158,0.03388157894736842
2012,COLORADO,LARIMER,92747,5057,82376,180180,0.5147463647463647,0.45718725718725717,0.028066378066378066
2012,COLORADO,LAS ANIMAS,3445,154,3263,6862,0.5020402215097639,0.475517341882833,0.02244243660740309
2012,COLORADO,LINCOLN,552,48,1687,2287,0.24136423261915171,0.7376475732400525,0.020988194140795804
2012,COLORADO,LOGAN,2712,233,6179,9124,0.29723805348531346,0.677224901359053,0.025537045155633493
2012,COLORADO,MESA,23846,1629,47472,72947,0.32689486887740415,0.6507738495071764,0.022331281615419415
2012,COLORADO,MINERAL,291,15,344,650,0.44769230769230767,0.5292307692307693,0.023076923076923078
2012,COLORADO,MOFFAT,1330,143,4695,6168,0.21562905317769132,0.7611867704280155,0.023184176394293127
2012,COLORADO,MONTEZUMA,4542,375,7401,12318,0.3687286897223575,0.600828056502679,0.03044325377496347
2012,COLORADO,MONTROSE,6138,440,13552,20130,0.30491803278688523,0.673224043715847,0.02185792349726776
2012,COLORADO,MORGAN,3912,263,6602,10777,0.3629952676997309,0.6126009093439733,0.024403822956295815
2012,COLORADO,OTERO,3647,163,4382,8192,0.4451904296875,0.534912109375,0.0198974609375
2012,COLORADO,OURAY,1646,75,1481,3202,0.514053716427233,0.4625234228607121,0.023422860712054967
2012,COLORADO,PARK,3862,268,5236,9366,0.41234251548152895,0.5590433482810164,0.028614136237454624
2012,COLORADO,PHILLIPS,588,40,1637,2265,0.2596026490066225,0.7227373068432671,0.017660044150110375
2012,COLORADO,PITKIN,6849,202,3024,10075,0.6798014888337469,0.3001488833746898,0.020049627791563277
2012,COLORADO,PROWERS,1519,114,3230,4863,0.3123586263623278,0.6641990540818424,0.023442319555829736
2012,COLORADO,PUEBLO,42551,1749,31894,76194,0.5584560464078536,0.41858939024070135,0.022954563351444995
2012,COLORADO,RIO BLANCO,568,77,2724,3369,0.16859602255862274,0.8085485307212823,0.022855446720094985
2012,COLORADO,RIO GRANDE,2478,137,2918,5533,0.44785830471715166,0.5273811675402132,0.0247605277426351
2012,COLORADO,ROUTT,7547,301,5469,13317,0.5667192310580461,0.4106780806487948,0.02260268829315912
2012,COLORADO,SAGUACHE,1864,102,964,2930,0.6361774744027304,0.3290102389078498,0.0348122866894198
2012,COLORADO,SAN JUAN,266,28,212,506,0.525691699604743,0.4189723320158103,0.05533596837944664
2012,COLORADO,SAN MIGUEL,2992,110,1154,4256,0.7030075187969925,0.27114661654135336,0.025845864661654134
2012,COLORADO,SEDGWICK,419,38,881,1338,0.3131539611360239,0.6584454409566517,0.028400597907324365
2012,COLORADO,SUMMIT,9347,394,5571,15312,0.6104362591431557,0.3638322884012539,0.025731452455590387
2012,COLORADO,TELLER,4333,372,8702,13407,0.32318937868277764,0.6490639218318789,0.027746699485343477
2012,COLORADO,WASHINGTON,468,47,2076,2591,0.18062524121960633,0.8012350443844075,0.018139714395986106
2012,COLORADO,WELD,49050,3041,63775,115866,0.4233338511729066,0.5504203131203287,0.02624583570676471
2012,COLORADO,YUMA,987,100,3490,4577,0.21564343456412496,0.762508193139611,0.021848372296263928
2012,CONNECTICUT,FAIRFIELD,217294,3668,175168,396130,0.5485421452553455,0.44219826824527303,0.009259586499381516
2012,CONNECTICUT,HARTFORD,244639,4363,143238,392240,0.6236972261880481,0.36517948194982663,0.01112329186212523
2012,CONNECTICUT,LITCHFIELD,43856,1370,47201,92427,0.47449338396788815,0.5106841074577775,0.01482250857433434
2012,CONNECTICUT,MIDDLESEX,47855,1092,34591,83538,0.5728530728530729,0.41407503172209054,0.013071895424836602
2012,CONNECTICUT,NEW HAVEN,218972,3697,138357,361026,0.606526953737404,0.38323278655830884,0.010240259704287226
2012,CONNECTICUT,NEW LONDON,67144,1839,46119,115102,0.5833434692707338,0.4006793974040416,0.015977133325224584
2012,CONNECTICUT,STATEWIDE WRITEIN,0,918,0,918,0.0,0.0,1.0
2012,CONNECTICUT,TOLLAND,39366,1112,30450,70928,0.5550135348522446,0.42930859463117527,0.015677870516580195
2012,CONNECTICUT,WINDHAM,25957,769,19768,46494,0.558287090807416,0.4251731406202951,0.016539768572288897
2012,DELAWARE,KENT,35527,1034,32135,68696,0.5171625713287528,0.46778560614882964,0.015051822522417609
2012,DELAWARE,NEW CASTLE,167082,3700,81230,252012,0.662992238464835,0.3223259209878895,0.014681840547275527
2012,DELAWARE,SUSSEX,39975,1135,52119,93229,0.4287828894442716,0.5590427871155971,0.01217432344013129
2012,DISTRICT OF COLUMBIA,DISTRICT OF COLUMBIA,267070,5313,21381,293764,0.9091311392818725,0.07278291417600523,0.01808594654212225
2012,FLORIDA,ALACHUA,69699,1922,48797,120418,0.5788088159577471,0.4052301150990716,0.01596106894318125
2012,FLORIDA,BAKER,2311,82,8975,11368,0.2032899366643209,0.789496833216045,0.007213230119634061
2012,FLORIDA,BAY,22051,934,56876,79861,0.276117253728353,0.7121874256520705,0.011695320619576514
2012,FLORIDA,BRADFORD,3325,91,8219,11635,0.28577567683712934,0.7064030941125913,0.00782122905027933
2012,FLORIDA,BREVARD,122993,3266,159300,285559,0.43070959066252507,0.5578531932105099,0.011437216126965006
2012,FLORIDA,BROWARD,508312,4009,244101,756422,0.6719952619040694,0.32270478648162004,0.00529995161431053
2012,FLORIDA,CALHOUN,1664,122,4366,6152,0.270481144343303,0.7096879063719116,0.019830949284785435
2012,FLORIDA,CHARLOTTE,35906,780,47996,84682,0.4240098249923242,0.5667792447037151,0.0092109303039607
2012,FLORIDA,CITRUS,28460,813,44662,73935,0.38493271116521266,0.6040711435720565,0.010996145262730777
2012,FLORIDA,CLAY,25759,808,70022,96589,0.26668668274855317,0.7249479754423381,0.008365341809108699
2012,FLORIDA,COLLIER,51698,894,96520,149112,0.3467058318579323,0.6472986748216106,0.005995493320457106
2012,FLORIDA,COLUMBIA,8462,272,18429,27163,0.31152670912638514,0.6784596694032323,0.010013621470382506
2012,FLORIDA,DESOTO,4174,104,5587,9865,0.42311201216421696,0.5663456664977192,0.010542321338063862
2012,FLORIDA,DIXIE,1798,91,5052,6941,0.2590404840801037,0.7278490131105028,0.01311050280939346
2012,FLORIDA,DUVAL,196737,3496,211615,411848,0.4776932266272994,0.5138182047745771,0.00848856859812358
2012,FLORIDA,ESCAMBIA,58185,1606,88711,148502,0.391812904876702,0.5973724259605931,0.01081466916270488
2012,FLORIDA,FLAGLER,23207,419,26969,50595,0.45868168791382546,0.5330368613499358,0.008281450736238758
2012,FLORIDA,FRANKLIN,1845,59,3570,5474,0.3370478626233102,0.6521739130434783,0.010778224333211546
2012,FLORIDA,GADSDEN,15770,99,6630,22499,0.7009200408907063,0.29467976354504644,0.0044001955642473
2012,FLORIDA,GILCHRIST,1885,107,5917,7909,0.2383360728284233,0.748135036034897,0.013528891136679731
2012,FLORIDA,GLADES,1603,42,2344,3989,0.40185510152920534,0.5876159438455754,0.010528954625219354
2012,FLORIDA,GULF,2014,99,4995,7108,0.28334271243669107,0.7027293190770962,0.013927968486212718
2012,FLORIDA,HAMILTON,2228,41,3138,5407,0.41205844275938597,0.5803587941557241,0.007582763084889957
2012,FLORIDA,HARDEE,2463,67,4696,7226,0.3408524771657902,0.6498754497647384,0.009272073069471353
2012,FLORIDA,HENDRY,4751,79,5355,10185,0.4664702994599902,0.5257731958762887,0.007756504663721159
2012,FLORIDA,HERNANDO,37830,899,44938,83667,0.45214959302950986,0.5371054298588451,0.010744977111644974
2012,FLORIDA,HIGHLANDS,16148,381,25915,42444,0.3804542455941947,0.6105692206201112,0.008976533785694091
2012,FLORIDA,HILLSBOROUGH,286467,5449,250186,542102,0.528437452730298,0.4615109333667834,0.010051613902918638
2012,FLORIDA,HOLMES,1264,91,6919,8274,0.15276770606719844,0.8362339859801788,0.010998307952622674
2012,FLORIDA,INDIAN RIVER,27492,522,43450,71464,0.38469719019366394,0.6079984327773424,0.007304377028993619
2012,FLORIDA,JACKSON,7342,181,13418,20941,0.35060407812425387,0.6407525906117186,0.008643331264027505
2012,FLORIDA,JEFFERSON,3945,55,3808,7808,0.5052510245901639,0.48770491803278687,0.00704405737704918
2012,FLORIDA,LAFAYETTE,687,44,2668,3399,0.20211827007943514,0.7849367461017946,0.012944983818770227
2012,FLORIDA,LAKE,61799,1369,87643,150811,0.40977780135401265,0.5811446114673333,0.009077587178654077
2012,FLORIDA,LEE,110157,1846,154163,266166,0.41386578300759674,0.5791986955508968,0.006935521441506429
2012,FLORIDA,LEON,90881,1667,55805,148353,0.6125996777955283,0.3761636097685925,0.011236712435879289
2012,FLORIDA,LEVY,6119,226,12054,18399,0.33257242241426166,0.655144301320724,0.012283276265014404
2012,FLORIDA,LIBERTY,942,41,2301,3284,0.2868453105968331,0.7006699147381242,0.012484774665042631
2012,FLORIDA,MADISON,4176,65,4474,8715,0.47917383820998277,0.5133677567412507,0.007458405048766495
2012,FLORIDA,MANATEE,66503,1361,85627,153491,0.4332697031096286,0.5578633274915141,0.008866969398857262
2012,FLORIDA,MARION,66831,1511,93043,161385,0.41410911794776467,0.5765281779595377,0.009362704092697587
2012,FLORIDA,MARTIN,30107,583,48183,78873,0.38171490877740166,0.6108934616408657,0.007391629581732659
2012,FLORIDA,MIAMI-DADE,541440,3893,332981,878314,0.6164537967059617,0.37911384766723516,0.004432355626803171
2012,FLORIDA,MONROE,19404,419,19234,39057,0.496812351179046,0.492459738331157,0.010727910489796964
2012,FLORIDA,NASSAU,10251,348,29929,40528,0.25293624161073824,0.7384771022502961,0.008586656138965653
2012,FLORIDA,OKALOOSA,23421,1209,70168,94798,0.24706217430747485,0.7401843920757822,0.012753433616742969
2012,FLORIDA,OKEECHOBEE,4856,140,7328,12324,0.3940279130152548,0.5946121389159363,0.011359948068808828
2012,FLORIDA,ORANGE,273665,4105,188589,466359,0.5868118766872731,0.404385891555647,0.008802231757079846
2012,FLORIDA,OSCEOLA,67239,867,40592,108698,0.6185854385545272,0.37343833373199137,0.00797622771348139
2012,FLORIDA,PALM BEACH,349651,3672,247398,600721,0.5820522338989315,0.4118351114743783,0.006112654626690261
2012,FLORIDA,PASCO,98263,2883,112427,213573,0.4600909290968428,0.5264101735706292,0.013498897332527989
2012,FLORIDA,PINELLAS,239104,5340,213258,457702,0.5224010382301147,0.465931981944584,0.011666979825301179
2012,FLORIDA,POLK,114622,2484,131577,248683,0.4609161060466538,0.5290952739029205,0.009988620050425643
2012,FLORIDA,PUTNAM,11667,331,19326,31324,0.37246200996041373,0.6169710126420636,0.010566977397522666
2012,FLORIDA,SANTA ROSA,17768,892,58186,76846,0.2312156781094657,0.7571766910444265,0.011607630846107801
2012,FLORIDA,SARASOTA,95119,1857,110504,207480,0.4584490071332177,0.5326007326007326,0.00895026026604974
2012,FLORIDA,SEMINOLE,96445,2232,109943,208620,0.4622998753714888,0.5270012462851117,0.010698878343399483
2012,FLORIDA,ST. JOHNS,35190,1092,78513,114795,0.306546452371619,0.6839409381941722,0.009512609434208808
2012,FLORIDA,ST. LUCIE,65869,956,56202,123027,0.5354027977598413,0.45682655026945307,0.007770651970705617
2012,FLORIDA,SUMTER,19524,309,40646,60479,0.3228227979959986,0.6720679905421717,0.005109211461829726
2012,FLORIDA,SUWANNEE,4751,206,12672,17629,0.2694991207669181,0.7188155879516706,0.011685291281411311
2012,FLORIDA,TAYLOR,2764,107,6249,9120,0.3030701754385965,0.6851973684210526,0.011732456140350877
2012,FLORIDA,UNION,1339,74,3980,5393,0.2482848136473206,0.7379936955312442,0.013721490821435194
2012,FLORIDA,VOLUSIA,114748,2298,117490,234536,0.489255380837057,0.5009465497834021,0.009798069379540881
2012,FLORIDA,WAKULLA,5175,195,9290,14660,0.3530013642564802,0.6336971350613916,0.01330150068212824
2012,FLORIDA,WALTON,6671,333,21490,28494,0.23411946374675371,0.7541938653751667,0.011686670878079595
2012,FLORIDA,WASHINGTON,2820,141,8038,10999,0.2563869442676607,0.7307937085189563,0.012819347213383035
2012,GEORGIA,APPLING,1758,95,5233,7086,0.2480948348856901,0.7384984476432402,0.013406717471069715
2012,GEORGIA,ATKINSON,930,34,1938,2902,0.32046864231564437,0.667815299793246,0.01171605789110958
2012,GEORGIA,BACON,791,47,3093,3931,0.2012210633426609,0.7868226914271178,0.011956245230221318
2012,GEORGIA,BAKER,794,10,785,1589,0.49968533668974197,0.49402139710509757,0.0062932662051604785
2012,GEORGIA,BALDWIN,8483,166,7589,16238,0.5224165537627786,0.46736051237837173,0.010222933858849611
2012,GEORGIA,BANKS,780,61,5354,6195,0.12590799031476999,0.8642453591606134,0.009846650524616626
2012,GEORGIA,BARROW,6028,446,18725,25199,0.23921584189848805,0.7430850430572642,0.017699115044247787
2012,GEORGIA,BARTOW,8396,530,26876,35802,0.23451203843360707,0.7506843193117703,0.014803642254622646
2012,GEORGIA,BEN HILL,2512,48,3396,5956,0.42175957018132976,0.570181329751511,0.008059100067159167
2012,GEORGIA,BERRIEN,1273,85,4843,6201,0.20528946944041285,0.781003064021932,0.013707466537655217
2012,GEORGIA,BIBB,38585,510,25623,64718,0.5962019839920888,0.39591767359930774,0.00788034240860348
2012,GEORGIA,BLECKLEY,1269,51,3587,4907,0.25861014876706745,0.7309965355614428,0.010393315671489708
2012,GEORGIA,BRANTLEY,939,99,4964,6002,0.15644785071642786,0.8270576474508498,0.016494501832722427
2012,GEORGIA,BROOKS,3138,50,3554,6742,0.465440522100267,0.5271432809255414,0.007416196974191634
2012,GEORGIA,BRYAN,3707,186,9560,13453,0.27555192150449714,0.7106221660596149,0.013825912435887907
2012,GEORGIA,BULLOCH,9593,318,14174,24085,0.39829769566119994,0.5884990658085946,0.013203238530205523
2012,GEORGIA,BURKE,5405,73,4301,9779,0.5527150015338992,0.4398200224971879,0.007464975968912977
2012,GEORGIA,BUTTS,2968,107,6306,9381,0.3163841807909605,0.6722097857371282,0.01140603347191131
2012,GEORGIA,CALHOUN,1298,7,883,2188,0.593235831809872,0.40356489945155394,0.0031992687385740404
2012,GEORGIA,CAMDEN,6377,263,11343,17983,0.3546126897625535,0.6307623866985487,0.014624923538897848
2012,GEORGIA,CANDLER,1157,27,2344,3528,0.32794784580498865,0.6643990929705216,0.007653061224489796
2012,GEORGIA,CARROLL,12688,581,28280,41549,0.30537437724132954,0.6806421333846784,0.013983489373992153
2012,GEORGIA,CATOOSA,5365,455,17858,23678,0.2265816369625813,0.7542022130247487,0.019216150012669988
2012,GEORGIA,CHARLTON,1197,40,2527,3764,0.31801275239107335,0.6713602550478215,0.010626992561105207
2012,GEORGIA,CHATHAM,60246,1178,47204,108628,0.5546083882608536,0.43454726221600326,0.010844349523143204
2012,GEORGIA,CHATTAHOOCHEE,729,26,735,1490,0.489261744966443,0.49328859060402686,0.0174496644295302
2012,GEORGIA,CHATTOOGA,2232,138,5452,7822,0.285349015597034,0.6970084377397086,0.01764254666325748
2012,GEORGIA,CHEROKEE,19841,1865,76514,98220,0.20200570148645897,0.7790063123600082,0.018987986153532886
2012,GEORGIA,CLARKE,25431,1122,13815,40368,0.6299791914387634,0.3422265160523187,0.027794292508917955
2012,GEORGIA,CLAY,862,3,537,1402,0.6148359486447932,0.3830242510699001,0.0021398002853067048
2012,GEORGIA,CLAYTON,81479,424,14164,96067,0.8481476469547296,0.1474387666940781,0.004413586351192397
2012,GEORGIA,CLINCH,852,22,1598,2472,0.3446601941747573,0.6464401294498382,0.00889967637540453
2012,GEORGIA,COBB,133124,5270,171722,310116,0.42927162739104074,0.5537347315198183,0.016993641089140837
2012,GEORGIA,COFFEE,5057,149,9248,14454,0.3498685484986855,0.6398228863982288,0.010308565103085652
2012,GEORGIA,COLQUITT,3973,112,9243,13328,0.29809423769507803,0.6935024009603842,0.008403361344537815
2012,GEORGIA,COLUMBIA,16451,707,41765,58923,0.27919488145545884,0.7088064083634574,0.011998710181083788
2012,GEORGIA,COOK,2042,54,3935,6031,0.3385839827557619,0.6524622782291494,0.008953739015088709
2012,GEORGIA,COWETA,15168,734,39653,55555,0.2730267302673027,0.7137611376113762,0.013212132121321213
2012,GEORGIA,CRAWFORD,1706,59,3368,5133,0.33235924410676015,0.6561465030196766,0.011494252873563218
2012,GEORGIA,CRISP,3167,47,4182,7396,0.42820443482963766,0.565440778799351,0.006354786371011357
2012,GEORGIA,DADE,1411,138,4471,6020,0.23438538205980067,0.7426910299003322,0.02292358803986711
2012,GEORGIA,DAWSON,1241,156,8847,10244,0.12114408434205388,0.863627489262007,0.015228426395939087
2012,GEORGIA,DECATUR,4591,70,5824,10485,0.437863614687649,0.5554601812112542,0.006676204101096805
2012,GEORGIA,DEKALB,238224,3649,64392,306265,0.7778361876153005,0.21024929391213493,0.01191451847256461
2012,GEORGIA,DODGE,2442,77,5214,7733,0.3157894736842105,0.6742532005689901,0.00995732574679943
2012,GEORGIA,DOOLY,2285,28,1985,4298,0.5316426244765007,0.4618427175430433,0.006514657980456026
2012,GEORGIA,DOUGHERTY,26295,175,11449,37919,0.6934518315356417,0.30193306785516494,0.0046151006091932805
2012,GEORGIA,DOUGLAS,28441,585,26241,55267,0.5146108889572439,0.47480413266506233,0.010584978377693741
2012,GEORGIA,EARLY,2765,31,2557,5353,0.5165327853540072,0.4776760694937418,0.005791145152251074
2012,GEORGIA,ECHOLS,173,12,917,1102,0.1569872958257713,0.8321234119782214,0.010889292196007259
2012,GEORGIA,EFFINGHAM,4947,273,15596,20816,0.23765372790161415,0.7492313604919293,0.013114911606456572
2012,GEORGIA,ELBERT,3181,103,4859,8143,0.3906422694338696,0.5967088296696549,0.0126489008964755
2012,GEORGIA,EMANUEL,2927,56,5100,8083,0.362118025485587,0.6309538537671656,0.0069281207472473095
2012,GEORGIA,EVANS,1268,27,2268,3563,0.3558798765085602,0.6365422396856582,0.007577883805781645
2012,GEORGIA,FANNIN,2028,132,7857,10017,0.20245582509733454,0.784366576819407,0.013177598083258461
2012,GEORGIA,FAYETTE,19736,757,38075,58568,0.3369758229750034,0.6500990301871329,0.01292514683786368
2012,GEORGIA,FLOYD,9640,456,22733,32829,0.2936428158031009,0.6924670261049681,0.013890158091930914
2012,GEORGIA,FORSYTH,14571,1252,65908,81731,0.17827996720950434,0.8064014878075638,0.015318544982931812
2012,GEORGIA,FRANKLIN,1499,149,6114,7762,0.19312032981190416,0.7876835867044576,0.019196083483638236
2012,GEORGIA,FULTON,255470,4819,137124,397413,0.6428325193186937,0.3450415562651448,0.012125924416161525
2012,GEORGIA,GILMER,1958,134,8926,11018,0.17770920312216373,0.8101288800145217,0.012161916863314576
2012,GEORGIA,GLASCOCK,176,22,1135,1333,0.13203300825206302,0.8514628657164292,0.016504126031507877
2012,GEORGIA,GLYNN,11950,290,20893,33133,0.3606676123502249,0.6305797845048743,0.008752603144900855
2012,GEORGIA,GORDON,3440,260,13197,16897,0.20358643546191632,0.781026217671776,0.015387346866307628
2012,GEORGIA,GRADY,3419,53,5924,9396,0.36387824606215413,0.6304810557684121,0.005640698169433802
2012,GEORGIA,GREENE,3201,51,5071,8323,0.3845969001561937,0.6092755016220113,0.006127598221795026
2012,GEORGIA,GWINNETT,132509,4364,159855,296728,0.4465672265509153,0.5387257016526921,0.014707071796392655
2012,GEORGIA,HABERSHAM,2301,174,12166,14641,0.15716139607950277,0.830954169797145,0.01188443412335223
2012,GEORGIA,HALL,12999,884,47481,61364,0.21183430024118374,0.7737598592008343,0.014405840557981879
2012,GEORGIA,HANCOCK,3308,11,769,4088,0.8091976516634051,0.18811154598825833,0.0026908023483365948
2012,GEORGIA,HARALSON,1789,141,8446,10376,0.1724171164225135,0.813993831919815,0.01358905165767155
2012,GEORGIA,HARRIS,4145,146,11197,15488,0.26762654958677684,0.7229467975206612,0.009426652892561983
2012,GEORGIA,HART,2870,124,6517,9511,0.3017558616338976,0.6852066028808748,0.013037535485227632
2012,GEORGIA,HEARD,948,64,3160,4172,0.22722914669223393,0.7574304889741131,0.015340364333652923
2012,GEORGIA,HENRY,43761,843,46774,91378,0.478900829521329,0.5118737551708289,0.00922541530784215
2012,GEORGIA,HOUSTON,22702,692,34662,58056,0.3910362408708833,0.597044233154196,0.011919525974920766
2012,GEORGIA,IRWIN,1141,30,2538,3709,0.30763008897276894,0.6842814774871934,0.008088433540037746
2012,GEORGIA,JACKSON,4238,331,19135,23704,0.17878839014512318,0.8072477219034762,0.013963887951400607
2012,GEORGIA,JASPER,1845,50,4136,6031,0.3059194163488642,0.6857900845630907,0.0082904990880451
2012,GEORGIA,JEFF DAVIS,1275,65,3996,5336,0.23894302848575713,0.7488755622188905,0.012181409295352323
2012,GEORGIA,JEFFERSON,4261,38,2999,7298,0.5838585913949027,0.410934502603453,0.005206906001644286
2012,GEORGIA,JENKINS,1488,15,1887,3390,0.4389380530973451,0.5566371681415929,0.004424778761061947
2012,GEORGIA,JOHNSON,1305,27,2440,3772,0.34597030752916225,0.6468716861081655,0.0071580063626723225
2012,GEORGIA,JONES,4274,87,7744,12105,0.3530772408095828,0.6397356464270962,0.007187112763320942
2012,GEORGIA,LAMAR,2602,91,4899,7592,0.34272918861959956,0.6452845100105374,0.011986301369863013
2012,GEORGIA,LANIER,1114,38,1820,2972,0.37483176312247646,0.6123822341857336,0.01278600269179004
2012,GEORGIA,LAURENS,7513,141,11950,19604,0.3832381146704754,0.609569475617221,0.007192409712303611
2012,GEORGIA,LEE,3196,118,10314,13628,0.23451717053125917,0.7568241855004403,0.008658643968300558
2012,GEORGIA,LIBERTY,10457,148,5565,16170,0.6466914038342609,0.34415584415584416,0.009152752009894866
2012,GEORGIA,LINCOLN,1586,33,2807,4426,0.35833709896068683,0.6342069588793493,0.00745594215996385
2012,GEORGIA,LONG,1442,54,2306,3802,0.37927406628090476,0.6065228826933193,0.014203051025775907
2012,GEORGIA,LOWNDES,17470,340,21327,39137,0.446380662799908,0.5449319058691264,0.008687431330965582
2012,GEORGIA,LUMPKIN,2055,203,8647,10905,0.18844566712517194,0.7929390187987162,0.018615314076111875
2012,GEORGIA,MACON,3211,25,1545,4781,0.671616816565572,0.32315415185107715,0.005229031583350764
2012,GEORGIA,MADISON,2494,167,8443,11104,0.22460374639769454,0.760356628242075,0.015039625360230548
2012,GEORGIA,MARION,1412,25,1733,3170,0.44542586750788643,0.5466876971608833,0.007886435331230283
2012,GEORGIA,MCDUFFIE,4044,73,5475,9592,0.4216013344453711,0.5707881567973311,0.007610508757297748
2012,GEORGIA,MCINTOSH,2864,68,3409,6341,0.45166377542974295,0.5376123639804448,0.010723860589812333
2012,GEORGIA,MERIWETHER,4331,77,4856,9264,0.46750863557858374,0.5241796200345423,0.008311744386873921
2012,GEORGIA,MILLER,852,18,1905,2775,0.307027027027027,0.6864864864864865,0.006486486486486486
2012,GEORGIA,MITCHELL,4081,39,4155,8275,0.49317220543806645,0.5021148036253776,0.004712990936555891
2012,GEORGIA,MONROE,3785,131,8361,12277,0.30830007330781134,0.681029567483913,0.010670359208275637
2012,GEORGIA,MONTGOMERY,1135,35,2662,3832,0.2961899791231733,0.6946764091858038,0.009133611691022964
2012,GEORGIA,MORGAN,2753,88,6186,9027,0.3049739669879251,0.6852775008308408,0.009748532181234075
2012,GEORGIA,MURRAY,2542,232,8443,11217,0.22662030846037265,0.7526967995007577,0.020682892038869572
2012,GEORGIA,MUSCOGEE,42573,520,27510,70603,0.602991374304208,0.38964349956800703,0.0073651261277849385
2012,GEORGIA,NEWTON,21851,401,20982,43234,0.5054124069019753,0.485312485543785,0.00927510755423972
2012,GEORGIA,OCONEE,4421,298,13098,17817,0.24813380479317507,0.7351405960599428,0.01672559914688219
2012,GEORGIA,OGLETHORPE,1914,108,4251,6273,0.305117168818747,0.6776661884265901,0.01721664275466284
2012,GEORGIA,PAULDING,15825,728,40846,57399,0.27570166727643336,0.7116151849335355,0.012683147790031185
2012,GEORGIA,PEACH,6148,81,5287,11516,0.5338659256686349,0.4591003820771101,0.00703369225425495
2012,GEORGIA,PICKENS,1975,158,10547,12680,0.1557570977917981,0.831782334384858,0.012460567823343848
2012,GEORGIA,PIERCE,1124,55,5667,6846,0.16418346479696172,0.8277826468010517,0.008033888401986562
2012,GEORGIA,PIKE,1356,85,6668,8109,0.16722160562338143,0.8222962140831175,0.010482180293501049
2012,GEORGIA,POLK,3615,182,9811,13608,0.265652557319224,0.7209729570840682,0.013374485596707819
2012,GEORGIA,PULASKI,1219,19,2444,3682,0.33107007061379684,0.6637696903856599,0.005160239000543183
2012,GEORGIA,PUTNAM,2926,81,6215,9222,0.31728475384949034,0.6739319019735416,0.00878334417696812
2012,GEORGIA,QUITMAN,612,6,510,1128,0.5425531914893617,0.4521276595744681,0.005319148936170213
2012,GEORGIA,RABUN,1559,150,5754,7463,0.2088972263164947,0.7710036178480504,0.02009915583545491
2012,GEORGIA,RANDOLPH,1770,17,1271,3058,0.578809679529104,0.4156311314584696,0.005559189012426423
2012,GEORGIA,RICHMOND,52560,615,25845,79020,0.6651480637813212,0.32706909643128323,0.007782839787395596
2012,GEORGIA,ROCKDALE,22023,346,15716,38085,0.5782591571484836,0.41265590127346724,0.0090849415780491
2012,GEORGIA,SCHLEY,448,14,1286,1748,0.2562929061784897,0.7356979405034325,0.008009153318077803
2012,GEORGIA,SCREVEN,2774,39,3287,6100,0.4547540983606557,0.5388524590163934,0.0063934426229508194
2012,GEORGIA,SEMINOLE,1478,46,2245,3769,0.3921464579464049,0.5956487131865216,0.012204828867073494
2012,GEORGIA,SPALDING,9898,279,14911,25088,0.39453125,0.5943478954081632,0.011120854591836735
2012,GEORGIA,STEPHENS,2131,146,7221,9498,0.22436302379448306,0.7602653190145294,0.015371657190987577
2012,GEORGIA,STEWART,1323,8,745,2076,0.6372832369942196,0.3588631984585742,0.0038535645472061657
2012,GEORGIA,SUMTER,6375,78,5378,11831,0.5388386442397093,0.4545685064660637,0.00659284929422703
2012,GEORGIA,TALBOT,2265,24,1202,3491,0.648811228874248,0.34431395015754795,0.006874820968203953
2012,GEORGIA,TALIAFERRO,636,4,323,963,0.660436137071651,0.3354101765316719,0.004153686396677051
2012,GEORGIA,TATTNALL,1897,64,4706,6667,0.28453577321133944,0.7058647067646617,0.0095995200239988
2012,GEORGIA,TAYLOR,1572,18,1948,3538,0.44431882419446017,0.5505935556811759,0.005087620124364048
2012,GEORGIA,TELFAIR,1805,51,2480,4336,0.41628228782287824,0.5719557195571956,0.0117619926199262
2012,GEORGIA,TERRELL,2544,20,1834,4398,0.5784447476125512,0.41700773078672126,0.004547521600727604
2012,GEORGIA,THOMAS,7653,144,11156,18953,0.4037883184720097,0.5886139397456867,0.007597741782303593
2012,GEORGIA,TIFT,4660,82,9185,13927,0.33460185251669416,0.6595103037265743,0.005887843756731528
2012,GEORGIA,TOOMBS,2746,74,6524,9344,0.2938784246575342,0.6982020547945206,0.007919520547945206
2012,GEORGIA,TOWNS,1273,62,4876,6211,0.20495894380937046,0.7850587667042345,0.009982289486395105
2012,GEORGIA,TREUTLEN,1074,24,1652,2750,0.39054545454545453,0.6007272727272728,0.008727272727272728
2012,GEORGIA,TROUP,10547,260,15179,25986,0.4058723928269068,0.5841222196567383,0.01000538751635496
2012,GEORGIA,TURNER,1510,21,2028,3559,0.42427648215790953,0.5698229839842652,0.005900533857825232
2012,GEORGIA,TWIGGS,2270,25,1907,4202,0.5402189433603046,0.4538315088053308,0.005949547834364588
2012,GEORGIA,UNION,2139,167,8773,11079,0.19306796642296237,0.7918584709811355,0.015073562595902158
2012,GEORGIA,UPSON,3959,74,7230,11263,0.3515049276391725,0.6419248867974785,0.0065701855633490186
2012,GEORGIA,WALKER,5274,375,16247,21896,0.2408659115820241,0.7420076726342711,0.017126415783704788
2012,GEORGIA,WALTON,8148,428,29036,37612,0.21663298947144527,0.7719876635116453,0.011379347016909498
2012,GEORGIA,WARE,3900,98,7941,11939,0.3266605243320211,0.6651310830052768,0.008208392662702069
2012,GEORGIA,WARREN,1529,7,990,2526,0.605304829770388,0.3919239904988123,0.0027711797307996833
2012,GEORGIA,WASHINGTON,4714,59,4035,8808,0.5351952770208901,0.45810626702997276,0.006698455949137148
2012,GEORGIA,WAYNE,2596,116,7557,10269,0.2527996883825105,0.735904177621969,0.0112961339955205
2012,GEORGIA,WEBSTER,582,4,601,1187,0.4903117101937658,0.506318449873631,0.003369839932603201
2012,GEORGIA,WHEELER,772,22,1366,2160,0.3574074074074074,0.6324074074074074,0.010185185185185186
2012,GEORGIA,WHITE,1671,166,8651,10488,0.15932494279176201,0.8248474446987033,0.015827612509534707
2012,GEORGIA,WHITFIELD,7210,361,19305,26876,0.2682690876618544,0.7182988539961304,0.01343205834201518
2012,GEORGIA,WILCOX,1060,16,2053,3129,0.3387663790348354,0.6561201661872803,0.005113454777884308
2012,GEORGIA,WILKES,2087,39,2635,4761,0.4383532871245537,0.5534551564797312,0.008191556395715185
2012,GEORGIA,WILKINSON,2181,23,2246,4450,0.4901123595505618,0.5047191011235955,0.005168539325842696
2012,GEORGIA,WORTH,2487,63,5869,8419,0.2954032545432949,0.6971136714574178,0.007483073999287326
2012,HAWAII,HAWAII,47224,1477,14753,63454,0.74422416238535,0.2324991332303716,0.023276704384278375
2012,HAWAII,HONOLULU,204349,3932,88461,296742,0.6886419852936221,0.29810744687304125,0.013250567833336703
2012,HAWAII,KAUAI,18641,610,6121,25372,0.73470755163172,0.24125019706763362,0.024042251300646383
2012,HAWAII,MAUI,36052,999,11602,48653,0.7410026103220767,0.23846422625531827,0.02053316342260498
2012,IDAHO,ADA,77137,5855,97554,180546,0.427242918702159,0.5403276727260643,0.03242940857177672
2012,IDAHO,ADAMS,577,70,1413,2060,0.28009708737864075,0.6859223300970874,0.03398058252427184
2012,IDAHO,BANNOCK,13214,1036,21010,35260,0.374758933635848,0.5958593306863301,0.029381735677821895
2012,IDAHO,BEAR LAKE,302,31,2489,2822,0.10701630049610206,0.8819985825655563,0.010985116938341602
2012,IDAHO,BENEWAH,1164,124,2596,3884,0.2996910401647786,0.6683831101956745,0.03192584963954686
2012,IDAHO,BINGHAM,3822,341,13440,17603,0.21712208146338693,0.7635062205305914,0.0193716980060217
2012,IDAHO,BLAINE,5992,263,3939,10194,0.587796743182264,0.3864037669217187,0.025799489896017266
2012,IDAHO,BOISE,1053,108,2284,3445,0.30566037735849055,0.6629898403483309,0.03134978229317852
2012,IDAHO,BONNER,6500,669,11367,18536,0.3506689684937419,0.6132391022874406,0.03609192921881744
2012,IDAHO,BONNEVILLE,9903,1034,32276,43213,0.22916714877467428,0.7469048665910721,0.02392798463425358
2012,IDAHO,BOUNDARY,1225,181,3138,4544,0.2695862676056338,0.690580985915493,0.03983274647887324
2012,IDAHO,BUTTE,258,27,1001,1286,0.2006220839813375,0.7783825816485226,0.020995334370139968
2012,IDAHO,CAMAS,159,17,402,578,0.2750865051903114,0.6955017301038062,0.029411764705882353
2012,IDAHO,CANYON,19866,1855,44369,66090,0.3005901044030867,0.671342109244969,0.028067786351944318
2012,IDAHO,CARIBOU,386,58,2608,3052,0.12647444298820446,0.854521625163827,0.019003931847968544
2012,IDAHO,CASSIA,1098,144,7154,8396,0.1307765602667937,0.8520724154359218,0.01715102429728442
2012,IDAHO,CLARK,66,27,235,328,0.20121951219512196,0.7164634146341463,0.08231707317073171
2012,IDAHO,CLEARWATER,1032,123,2541,3696,0.2792207792207792,0.6875,0.033279220779220776
2012,IDAHO,CUSTER,530,78,1744,2352,0.22534013605442177,0.7414965986394558,0.03316326530612245
2012,IDAHO,ELMORE,2513,261,5227,8001,0.31408573928258965,0.6532933383327084,0.03262092238470191
2012,IDAHO,FRANKLIN,325,80,5195,5600,0.05803571428571429,0.9276785714285715,0.014285714285714285
2012,IDAHO,FREMONT,810,85,4907,5802,0.13960703205791106,0.8457428472940366,0.014650120648052396
2012,IDAHO,GEM,1957,222,5311,7490,0.26128170894526037,0.7090787716955941,0.02963951935914553
2012,IDAHO,GOODING,1287,135,3696,5118,0.2514654161781946,0.7221570926143025,0.02637749120750293
2012,IDAHO,IDAHO,1708,208,5921,7837,0.21794053847135383,0.7555186933775679,0.02654076815107822
2012,IDAHO,JEFFERSON,1303,183,9895,11381,0.11448906071522713,0.8694315086547755,0.016079430629997365
2012,IDAHO,JEROME,1699,178,4804,6681,0.25430324801676396,0.7190540338272714,0.026642718155964674
2012,IDAHO,KOOTENAI,18851,1596,39381,59828,0.31508658153373004,0.6582369459116133,0.02667647255465668
2012,IDAHO,LATAH,8306,864,7589,16759,0.49561429679575153,0.45283131451757264,0.05155438868667581
2012,IDAHO,LEMHI,960,121,3029,4110,0.23357664233576642,0.7369829683698297,0.029440389294403894
2012,IDAHO,LEWIS,396,45,1173,1614,0.24535315985130113,0.7267657992565055,0.027881040892193308
2012,IDAHO,LINCOLN,469,52,1141,1662,0.2821901323706378,0.6865222623345367,0.031287605294825514
2012,IDAHO,MADISON,832,135,13445,14412,0.057729669719678044,0.9329031362753262,0.009367194004995838
2012,IDAHO,MINIDOKA,1390,141,5442,6973,0.19934031263444715,0.7804388355083896,0.020220851857163345
2012,IDAHO,NEZ PERCE,6451,430,9967,16848,0.3828941120607787,0.5915835707502374,0.025522317188983856
2012,IDAHO,ONEIDA,217,34,1838,2089,0.1038774533269507,0.8798468166586884,0.016275730014360938
2012,IDAHO,OWYHEE,833,97,2794,3724,0.2236842105263158,0.7502685284640171,0.026047261009667026
2012,IDAHO,PAYETTE,2271,220,6004,8495,0.2673337257210124,0.7067686874632136,0.025897586815773983
2012,IDAHO,POWER,982,51,1870,2903,0.33827075439200827,0.644161212538753,0.01756803306923872
2012,IDAHO,SHOSHONE,2277,172,2699,5148,0.4423076923076923,0.5242812742812742,0.03341103341103341
2012,IDAHO,TETON,1926,139,2458,4523,0.4258235684280345,0.5434446164050409,0.03073181516692461
2012,IDAHO,TWIN FALLS,7541,828,19773,28142,0.2679624760144979,0.7026153080804491,0.029422215905052947
2012,IDAHO,VALLEY,2095,160,2664,4919,0.42589957308396015,0.5415734905468591,0.03252693636918073
2012,IDAHO,WASHINGTON,1104,98,3128,4330,0.25496535796766745,0.7224018475750578,0.022632794457274827
2012,ILLINOIS,ADAMS,9648,543,20416,30607,0.31522200803737704,0.6670369523311661,0.017741039631456856
2012,ILLINOIS,ALEXANDER,1965,49,1487,3501,0.5612682090831191,0.42473578977435017,0.013996001142530705
2012,ILLINOIS,BOND,3020,221,4095,7336,0.4116684841875682,0.558206106870229,0.030125408942202836
2012,ILLINOIS,BOONE,9883,386,11096,21365,0.46257898432014977,0.5193540837818863,0.018066931897963958
2012,ILLINOIS,BROWN,787,64,1513,2364,0.3329103214890017,0.6400169204737732,0.02707275803722504
2012,ILLINOIS,BUREAU,8134,333,8164,16631,0.4890866454212014,0.4908905056821598,0.020022848896638808
2012,ILLINOIS,CALHOUN,1080,56,1440,2576,0.4192546583850932,0.5590062111801242,0.021739130434782608
2012,ILLINOIS,CARROLL,3665,166,3555,7386,0.49620904413755756,0.4813160032493907,0.02247495261305172
2012,ILLINOIS,CASS,2053,102,2707,4862,0.42225421637186344,0.5567667626491156,0.02097902097902098
2012,ILLINOIS,CHAMPAIGN,40831,2216,35312,78359,0.5210760729463112,0.45064383159560484,0.028280095458083947
2012,ILLINOIS,CHRISTIAN,5494,322,8885,14701,0.3737160737364805,0.6043806543772533,0.02190327188626624
2012,ILLINOIS,CLARK,2591,125,5144,7860,0.3296437659033079,0.6544529262086514,0.015903307888040712
2012,ILLINOIS,CLAY,1584,134,4190,5908,0.26811103588354773,0.7092078537576167,0.022681110358835476
2012,ILLINOIS,CLINTON,5596,330,10524,16450,0.3401823708206687,0.6397568389057751,0.02006079027355623
2012,ILLINOIS,COLES,9262,465,11631,21358,0.43365483659518683,0.5445734619346381,0.02177170147017511
2012,ILLINOIS,COOK,1488537,27518,495542,2011597,0.7399777390799449,0.24634258253516983,0.013679678384885242
2012,ILLINOIS,CRAWFORD,2858,166,5585,8609,0.3319781623881984,0.6487396910210245,0.019282146590777094
2012,ILLINOIS,CUMBERLAND,1641,145,3509,5295,0.30991501416430595,0.6627006610009443,0.027384324834749764
2012,ILLINOIS,DE WITT,2601,165,4579,7345,0.3541184479237577,0.6234172906739278,0.0224642614023145
2012,ILLINOIS,DEKALB,21207,951,18934,41092,0.5160858561277134,0.4607709529835491,0.023143190888737467
2012,ILLINOIS,DOUGLAS,2430,133,5334,7897,0.30771178928707105,0.6754463720400152,0.016841838672913764
2012,ILLINOIS,DUPAGE,199460,6573,195046,401079,0.49730851029348333,0.48630319712575326,0.01638829258076339
2012,ILLINOIS,EDGAR,2565,122,5132,7819,0.32804706484205143,0.6563499168691649,0.015603018288783733
2012,ILLINOIS,EDWARDS,754,69,2405,3228,0.23358116480793062,0.7450433705080545,0.02137546468401487
2012,ILLINOIS,EFFINGHAM,3861,251,12501,16613,0.23240835490278697,0.7524829952446879,0.01510864985252513
2012,ILLINOIS,FAYETTE,2853,167,5951,8971,0.31802474640508305,0.6633597146360495,0.018615538958867462
2012,ILLINOIS,FORD,1656,121,4229,6006,0.2757242757242757,0.7041292041292041,0.020146520146520148
2012,ILLINOIS,FRANKLIN,7254,393,10267,17914,0.40493468795355586,0.5731271631126493,0.021938148933794796
2012,ILLINOIS,FULTON,8328,396,6632,15356,0.5423287314404793,0.4318833029434749,0.025787965616045846
2012,ILLINOIS,GALLATIN,1029,52,1492,2573,0.39992226972405753,0.5798678585308978,0.020209871745044693
2012,ILLINOIS,GREENE,2023,148,3451,5622,0.3598363571682675,0.6138384916399857,0.02632515119174671
2012,ILLINOIS,GRUNDY,9451,450,11343,21244,0.4448785539446432,0.5339389945396347,0.021182451515722085
2012,ILLINOIS,HAMILTON,1269,106,2566,3941,0.3219994925145902,0.6511037807663029,0.026896726719106825
2012,ILLINOIS,HANCOCK,3650,190,5271,9111,0.40061464164197125,0.578531445505433,0.020853912852595764
2012,ILLINOIS,HARDIN,742,53,1535,2330,0.3184549356223176,0.6587982832618026,0.022746781115879827
2012,ILLINOIS,HENDERSON,1978,49,1541,3568,0.554372197309417,0.4318946188340807,0.013733183856502242
2012,ILLINOIS,HENRY,12332,407,11583,24322,0.5070306718197517,0.47623550694844174,0.016733821231806594
2012,ILLINOIS,IROQUOIS,3413,251,9120,12784,0.26697434292866085,0.7133917396745932,0.019633917396745932
2012,ILLINOIS,JACKSON,13319,829,9864,24012,0.5546809928369149,0.4107946026986507,0.03452440446443445
2012,ILLINOIS,JASPER,1436,93,3514,5043,0.2847511401943288,0.6968074558794368,0.018441403926234383
2012,ILLINOIS,JEFFERSON,6089,420,9811,16320,0.37310049019607844,0.6011642156862745,0.025735294117647058
2012,ILLINOIS,JERSEY,3667,253,6039,9959,0.36820965960437796,0.6063861833517421,0.025404157043879907
2012,ILLINOIS,JO DAVIESS,5667,228,5534,11429,0.4958439058535305,0.48420684224341587,0.019949251903053637
2012,ILLINOIS,JOHNSON,1572,137,3963,5672,0.2771509167842031,0.6986953455571228,0.02415373765867419
2012,ILLINOIS,KANE,90332,2975,88335,181642,0.497307891346715,0.48631373801213373,0.016378370641151274
2012,ILLINOIS,KANKAKEE,21595,778,23136,45509,0.4745215232151882,0.5083829572172537,0.017095519567558067
2012,ILLINOIS,KENDALL,22471,777,24047,47295,0.47512422031927265,0.5084469817105403,0.016428797970187124
2012,ILLINOIS,KNOX,13451,419,9408,23278,0.5778417389810121,0.40415843285505626,0.01799982816393161
2012,ILLINOIS,LAKE,153757,3972,129764,287493,0.5348199782255568,0.4513640332112434,0.013815988563199799
2012,ILLINOIS,LASALLE,23073,930,23256,47259,0.4882244651812353,0.4920967434774329,0.01967879134133181
2012,ILLINOIS,LAWRENCE,2011,121,3857,5989,0.3357822674903991,0.6440140257138086,0.020203706795792285
2012,ILLINOIS,LEE,6937,305,8059,15301,0.45336906084569634,0.5266976014639566,0.019933337690347035
2012,ILLINOIS,LIVINGSTON,5020,266,9753,15039,0.3337987898131525,0.6485138639537203,0.0176873462331272
2012,ILLINOIS,LOGAN,3978,231,7844,12053,0.3300423131170663,0.6507923338587903,0.019165353024143367
2012,ILLINOIS,MACON,22780,810,25309,48899,0.46585819750915153,0.5175770465653694,0.016564755925479048
2012,ILLINOIS,MACOUPIN,9464,600,10946,21010,0.4504521656354117,0.5209900047596383,0.028557829604950024
2012,ILLINOIS,MADISON,58922,2943,60608,122473,0.48110195716606924,0.49486825667698187,0.02402978615694888
2012,ILLINOIS,MARION,6225,291,9248,15764,0.3948870844963207,0.5866531337224055,0.018459781781273787
2012,ILLINOIS,MARSHALL,2455,105,3290,5850,0.41965811965811967,0.5623931623931624,0.017948717948717947
2012,ILLINOIS,MASON,2867,140,3265,6272,0.4571109693877551,0.5205676020408163,0.022321428571428572
2012,ILLINOIS,MASSAC,2092,125,4278,6495,0.3220939183987683,0.6586605080831409,0.01924557351809084
2012,ILLINOIS,MCDONOUGH,5967,340,6147,12454,0.4791231732776618,0.4935763610085113,0.027300465713826882
2012,ILLINOIS,MCHENRY,59797,2449,71598,133844,0.4467663847464212,0.5349361943755416,0.018297420878037117
2012,ILLINOIS,MCLEAN,31883,1552,39947,73382,0.43447984519364424,0.5443705540868333,0.021149600719522498
2012,ILLINOIS,MENARD,2100,103,3948,6151,0.3414079011542839,0.6418468541700536,0.016745244675662494
2012,ILLINOIS,MERCER,4507,151,3876,8534,0.528122802906023,0.4541832669322709,0.017693930161706117
2012,ILLINOIS,MONROE,6215,329,10888,17432,0.3565282239559431,0.6245984396512162,0.018873336392840754
2012,ILLINOIS,MONTGOMERY,5058,299,6776,12133,0.4168795846039726,0.5584768812330009,0.024643534163026455
2012,ILLINOIS,MORGAN,5806,318,7972,14096,0.41188989784335983,0.565550510783201,0.022559591373439273
2012,ILLINOIS,MOULTRIE,2144,129,3784,6057,0.3539706125144461,0.6247317153706455,0.02129767211490837
2012,ILLINOIS,OGLE,9514,431,13422,23367,0.4071553900800274,0.574399794582103,0.018444815337869645
2012,ILLINOIS,PEORIA,40209,1428,36774,78411,0.5127979492673221,0.4689903202356812,0.018211730496996596
2012,ILLINOIS,PERRY,3819,223,5507,9549,0.39993716619541314,0.576709603099801,0.02335323070478584
2012,ILLINOIS,PIATT,3090,204,5413,8707,0.35488687263121627,0.6216837027678879,0.02342942460089583
2012,ILLINOIS,PIKE,2278,148,4860,7286,0.31265440570958003,0.6670326653856712,0.020312928904748832
2012,ILLINOIS,POPE,650,60,1512,2222,0.2925292529252925,0.6804680468046804,0.027002700270027002
2012,ILLINOIS,PULASKI,1389,50,1564,3003,0.46253746253746253,0.5208125208125208,0.016650016650016652
2012,ILLINOIS,PUTNAM,1559,74,1502,3135,0.49728867623604467,0.4791068580542265,0.023604465709728868
2012,ILLINOIS,RANDOLPH,5759,343,8290,14392,0.40015286270150086,0.5760144524735964,0.023832684824902722
2012,ILLINOIS,RICHLAND,2362,164,4756,7282,0.32436143916506455,0.653117275473771,0.022521285361164517
2012,ILLINOIS,ROCK ISLAND,39157,925,24934,65016,0.6022671342438785,0.3835055986218777,0.014227267134243878
2012,ILLINOIS,SALINE,3701,213,6806,10720,0.34524253731343285,0.6348880597014925,0.019869402985074627
2012,ILLINOIS,SANGAMON,42107,1965,50225,94297,0.4465359449399239,0.5326256402642714,0.020838414795804745
2012,ILLINOIS,SCHUYLER,1727,94,2069,3890,0.44395886889460157,0.5318766066838047,0.02416452442159383
2012,ILLINOIS,SCOTT,910,58,1587,2555,0.3561643835616438,0.6211350293542074,0.022700587084148727
2012,ILLINOIS,SHELBY,3342,210,6843,10395,0.3215007215007215,0.6582972582972583,0.020202020202020204
2012,ILLINOIS,ST. CLAIR,67285,2056,50125,119466,0.563214638474545,0.4195754440593977,0.017209917466057288
2012,ILLINOIS,STARK,1095,39,1528,2662,0.4113448534936138,0.5740045078888054,0.014650638617580767
2012,ILLINOIS,STEPHENSON,10165,378,10512,21055,0.4827831868914747,0.4992638328188079,0.017952980289717407
2012,ILLINOIS,TAZEWELL,24438,1275,35335,61048,0.40030795439654043,0.5788068405189359,0.020885205084523652
2012,ILLINOIS,UNION,3137,188,4957,8282,0.37877324317797634,0.598526925863318,0.022699830958705626
2012,ILLINOIS,VERMILION,12878,544,16892,30314,0.42482021508214024,0.5572342811902091,0.01794550372765059
2012,ILLINOIS,WABASH,1590,66,3478,5134,0.30970003895597975,0.6774444877288663,0.012855473315153876
2012,ILLINOIS,WARREN,4044,131,3618,7793,0.5189272423970229,0.46426279994867187,0.016809957654305145
2012,ILLINOIS,WASHINGTON,2450,163,4792,7405,0.33085752869682644,0.6471303173531398,0.02201215395003376
2012,ILLINOIS,WAYNE,1514,178,5988,7680,0.19713541666666667,0.7796875,0.023177083333333334
2012,ILLINOIS,WHITE,2188,145,4731,7064,0.30973952434881086,0.6697338618346546,0.02052661381653454
2012,ILLINOIS,WHITESIDE,14833,487,10334,25654,0.57819443361659,0.40282217198097764,0.01898339440243237
2012,ILLINOIS,WILL,144229,4189,128969,277387,0.5199558739234355,0.4649424810823867,0.015101644994177809
2012,ILLINOIS,WILLIAMSON,10647,587,17909,29143,0.365336444429194,0.6145214974436399,0.020142058127166042
2012,ILLINOIS,WINNEBAGO,61732,2114,55138,118984,0.5188260606468097,0.4634068446177637,0.017767094735426613
2012,ILLINOIS,WOODFORD,5572,341,12961,18874,0.2952209388576878,0.6867118787750345,0.018067182367277737
2012,INDIANA,ADAMS,3806,268,8937,13011,0.29252171239720237,0.6868803320267466,0.020597955576051034
2012,INDIANA,ALLEN,60036,2290,84613,146939,0.40857770911738883,0.5758375924703448,0.015584698412266314
2012,INDIANA,BARTHOLOMEW,10625,618,18083,29326,0.3623064857123372,0.6166200641069358,0.021073450180727
2012,INDIANA,BENTON,1159,90,2329,3578,0.32392397987702626,0.6509223029625489,0.02515371716042482
2012,INDIANA,BLACKFORD,1927,105,2711,4743,0.4062829432848408,0.5715791693021295,0.022137887413029727
2012,INDIANA,BOONE,8328,601,18808,27737,0.30024876518729493,0.678083426470058,0.021667808342647005
2012,INDIANA,BROWN,3060,212,4332,7604,0.40241977906365073,0.569700157811678,0.027880063124671225
2012,INDIANA,CARROLL,2635,176,4999,7810,0.3373879641485275,0.6400768245838668,0.022535211267605635
2012,INDIANA,CASS,5371,347,8443,14161,0.37928112421439164,0.5962149565708637,0.02450391921474472
2012,INDIANA,CLARK,20807,889,25450,47146,0.4413311839816739,0.5398124973486617,0.018856318669664446
2012,INDIANA,CLAY,3460,228,7096,10784,0.32084569732937684,0.6580118694362018,0.021142433234421366
2012,INDIANA,CLINTON,3308,237,6338,9883,0.3347161792977841,0.641303248001619,0.023980572700596985
2012,INDIANA,CRAWFORD,2041,128,2421,4590,0.44466230936819173,0.5274509803921569,0.027886710239651415
2012,INDIANA,DAVIESS,2437,175,7638,10250,0.2377560975609756,0.7451707317073171,0.01707317073170732
2012,INDIANA,DEARBORN,6528,434,15394,22356,0.29200214707461086,0.6885847199856862,0.01941313293970299
2012,INDIANA,DECATUR,2941,248,7119,10308,0.2853123787349631,0.690628637951106,0.02405898331393093
2012,INDIANA,DEKALB,5419,322,10587,16328,0.33188388045075945,0.6483953944145027,0.019720725134737875
2012,INDIANA,DELAWARE,22654,1063,21251,44968,0.5037804661092332,0.47258050169009075,0.023639032200676036
2012,INDIANA,DUBOIS,6522,366,11654,18542,0.3517419911552152,0.6285190378599935,0.019738970984791285
2012,INDIANA,ELKHART,24399,1075,42378,67852,0.35959146377409656,0.6245652302069209,0.01584330601898249
2012,INDIANA,FAYETTE,3555,237,5045,8837,0.4022858436120855,0.5708951001471088,0.026819056240805703
2012,INDIANA,FLOYD,14812,615,19878,35305,0.41954397394136805,0.5630363971108908,0.017419628947741114
2012,INDIANA,FOUNTAIN,2237,210,4664,7111,0.3145830403600056,0.6558852482070032,0.02953171143299114
2012,INDIANA,FRANKLIN,2909,227,7424,10560,0.27547348484848483,0.703030303030303,0.02149621212121212
2012,INDIANA,FULTON,2621,188,5317,8126,0.3225449175486094,0.6543194683731233,0.02313561407826729
2012,INDIANA,GIBSON,4928,306,9487,14721,0.33475986685687115,0.6444535018001495,0.020786631342979416
2012,INDIANA,GRANT,9589,545,15151,25285,0.37923670160174017,0.5992090172038759,0.02155428119438402
2012,INDIANA,GREENE,4350,304,8457,13111,0.33178247273281974,0.6450308900922889,0.023186637174891313
2012,INDIANA,HAMILTON,43796,2320,90747,136863,0.31999883094773607,0.6630499112250937,0.016951257827170236
2012,INDIANA,HANCOCK,9319,728,22796,32843,0.2837438723624517,0.6940900648540024,0.02216606278354596
2012,INDIANA,HARRISON,6607,424,10640,17671,0.3738894233489899,0.6021164619998868,0.02399411465112331
2012,INDIANA,HENDRICKS,21112,1220,44312,66644,0.316787707820659,0.6649060680631415,0.018306224116199508
2012,INDIANA,HENRY,7613,556,10838,19007,0.4005366443941706,0.5702109749039828,0.029252380701846686
2012,INDIANA,HOWARD,15135,828,20327,36290,0.41705704050702674,0.5601267566822816,0.02281620281069165
2012,INDIANA,HUNTINGTON,4596,307,10862,15765,0.29153187440532824,0.6889946083095465,0.019473517285125277
2012,INDIANA,JACKSON,5838,455,10419,16712,0.3493298228817616,0.6234442316898038,0.027225945428434657
2012,INDIANA,JASPER,4672,269,7955,12896,0.36228287841191065,0.6168579404466501,0.020859181141439205
2012,INDIANA,JAY,3063,193,4645,7901,0.3876724465257562,0.5879002657891406,0.02442728768510315
2012,INDIANA,JEFFERSON,5728,302,7096,13126,0.43638579917720555,0.5406064299862867,0.023007770836507693
2012,INDIANA,JENNINGS,3821,309,6120,10250,0.37278048780487805,0.5970731707317073,0.030146341463414633
2012,INDIANA,JOHNSON,17260,1191,39513,57964,0.2977710302946657,0.6816817334897523,0.020547236215582087
2012,INDIANA,KNOX,5228,305,9612,15145,0.34519643446682075,0.634664905909541,0.020138659623638165
2012,INDIANA,KOSCIUSKO,6862,640,22558,30060,0.22827677977378577,0.7504324683965402,0.021290751829673986
2012,INDIANA,LAGRANGE,2898,187,6231,9316,0.311077715757836,0.6688492915414341,0.020072992700729927
2012,INDIANA,LAKE,130897,2430,68431,201758,0.6487822044231207,0.3391736634978539,0.012044132079025367
2012,INDIANA,LAPORTE,24107,959,18615,43681,0.5518875483619881,0.4261578260570958,0.02195462558091619
2012,INDIANA,LAWRENCE,5779,421,11622,17822,0.32426214790708113,0.6521153630344518,0.023622489058467065
2012,INDIANA,MADISON,24407,1194,26769,52370,0.46604926484628606,0.5111514225701738,0.022799312583540194
2012,INDIANA,MARION,216336,6164,136509,359009,0.6025921355732029,0.3802383784250534,0.01716948600174369
2012,INDIANA,MARSHALL,6137,368,11260,17765,0.34545454545454546,0.6338305657191106,0.020714888826343935
2012,INDIANA,MARTIN,1351,130,3262,4743,0.28484081804764916,0.6877503689647902,0.027408812987560614
2012,INDIANA,MIAMI,4222,385,8174,12781,0.3303340896643455,0.6395430717471247,0.03012283858852985
2012,INDIANA,MONROE,33436,1306,22481,57223,0.5843105045174143,0.3928665047271202,0.02282299075546546
2012,INDIANA,MONTGOMERY,4271,345,9824,14440,0.29577562326869805,0.6803324099722992,0.02389196675900277
2012,INDIANA,MORGAN,7969,706,19591,28266,0.2819288190759216,0.6930941767494516,0.02497700417462676
2012,INDIANA,NEWTON,2212,151,3291,5654,0.3912274495932083,0.5820657941280509,0.026706756278740716
2012,INDIANA,NOBLE,5229,335,10680,16244,0.3219034720512189,0.6574735286875154,0.0206229992612657
2012,INDIANA,OHIO,994,66,1759,2819,0.3526073075558709,0.6239801347995744,0.023412557644554806
2012,INDIANA,ORANGE,2939,220,4617,7776,0.37795781893004116,0.59375,0.028292181069958847
2012,INDIANA,OWEN,2823,228,5062,8113,0.3479600640946629,0.62393689140885,0.02810304449648712
2012,INDIANA,PARKE,2110,171,4234,6515,0.32386799693016116,0.6498848810437452,0.02624712202609363
2012,INDIANA,PERRY,4316,156,3403,7875,0.548063492063492,0.43212698412698414,0.019809523809523808
2012,INDIANA,PIKE,2125,174,3627,5926,0.35858926763415455,0.6120485993925076,0.029362132973337833
2012,INDIANA,PORTER,37252,1381,34406,73039,0.5100288886759129,0.47106340448253675,0.018907706841550406
2012,INDIANA,POSEY,4533,263,7430,12226,0.3707672174055292,0.6077212497955178,0.02151153279895305
2012,INDIANA,PULASKI,1899,134,3366,5399,0.3517318021855899,0.6234487868123727,0.024819411002037415
2012,INDIANA,PUTNAM,4507,317,9005,13829,0.325909320992118,0.6511678357075711,0.02292284330031094
2012,INDIANA,RANDOLPH,3769,202,6218,10189,0.36990872509569145,0.610265973108254,0.01982530179605457
2012,INDIANA,RIPLEY,3241,258,7484,10983,0.29509241555130655,0.6814167349540199,0.023490849494673588
2012,INDIANA,RUSH,2221,172,4633,7026,0.316111585539425,0.6594079134642755,0.02448050099629946
2012,INDIANA,SCOTT,3998,183,4539,8720,0.45848623853211007,0.5205275229357799,0.020986238532110093
2012,INDIANA,SHELBY,5359,423,10978,16760,0.31974940334128876,0.6550119331742243,0.025238663484486872
2012,INDIANA,SPENCER,4026,187,5515,9728,0.41385690789473684,0.5669202302631579,0.019222861842105265
2012,INDIANA,ST. JOSEPH,56460,1666,52578,110704,0.5100086717733776,0.4749421881774823,0.015049140049140049
2012,INDIANA,STARKE,3809,207,4738,8754,0.4351153758281928,0.5412382910669409,0.023646333104866347
2012,INDIANA,STEUBEN,4853,295,8547,13695,0.3543629061701351,0.6240963855421687,0.02154070828769624
2012,INDIANA,SULLIVAN,3191,197,4902,8290,0.38492159227985523,0.5913148371531967,0.02376357056694813
2012,INDIANA,SWITZERLAND,1437,88,1872,3397,0.4230203120400353,0.5510744774801295,0.02590521047983515
2012,INDIANA,TIPPECANOE,26711,1428,28757,56896,0.46947061304836896,0.5054309617547806,0.025098425196850394
2012,INDIANA,TIPTON,2432,160,4773,7365,0.3302104548540394,0.6480651731160896,0.02172437202987101
2012,INDIANA,UNION,1018,60,2022,3100,0.32838709677419353,0.652258064516129,0.01935483870967742
2012,INDIANA,VANDERBURGH,31725,1290,39389,72404,0.4381663996464284,0.5440169051433622,0.01781669521020938
2012,INDIANA,VERMILLION,2979,176,3426,6581,0.45266676796839384,0.5205895760522717,0.02674365597933445
2012,INDIANA,VIGO,19712,796,19369,39877,0.49432003410487246,0.48571858464779194,0.01996138124733556
2012,INDIANA,WABASH,3973,257,8644,12874,0.30860649370824916,0.6714307907410284,0.019962715550722387
2012,INDIANA,WARREN,1324,99,2377,3800,0.34842105263157896,0.6255263157894737,0.02605263157894737
2012,INDIANA,WARRICK,8793,486,15351,24630,0.35700365408038975,0.62326431181486,0.019732034104750305
2012,INDIANA,WASHINGTON,3909,295,6533,10737,0.36406817546800785,0.6084567383812983,0.027475086150693863
2012,INDIANA,WAYNE,10591,565,14321,25477,0.41570828590493386,0.5621148486870511,0.022176865408015074
2012,INDIANA,WELLS,3436,243,9256,12935,0.2656358716660224,0.7155778894472362,0.0187862388867414
2012,INDIANA,WHITE,3637,296,5970,9903,0.3672624457235181,0.6028476219327477,0.029889932343734223
2012,INDIANA,WHITLEY,4420,333,10258,15011,0.2944507361268403,0.6833655319432417,0.02218373192991806
2012,IOWA,ADAIR,1790,92,2114,3996,0.44794794794794796,0.529029029029029,0.023023023023023025
2012,IOWA,ADAMS,1028,49,1108,2185,0.47048054919908466,0.5070938215102975,0.022425629290617848
2012,IOWA,ALLAMAKEE,3553,117,3264,6934,0.5124026535910009,0.47072396884914913,0.016873377559850015
2012,IOWA,APPANOOSE,2951,133,3161,6245,0.47253803042433945,0.5061649319455565,0.021297037630104085
2012,IOWA,AUDUBON,1611,44,1802,3457,0.4660109921897599,0.5212612091408736,0.012727798669366503
2012,IOWA,BENTON,6862,221,6940,14023,0.4893389431648007,0.4949012336875134,0.015759823147685946
2012,IOWA,BLACK HAWK,39821,1085,26235,67141,0.5930951281631194,0.39074485038947887,0.016160021447401737
2012,IOWA,BOONE,7512,320,6556,14388,0.5221017514595496,0.45565749235474007,0.022240756185710316
2012,IOWA,BREMER,6763,178,6405,13346,0.5067435935860932,0.4799190768769669,0.013337329536939908
2012,IOWA,BUCHANAN,5911,174,4450,10535,0.5610821072615092,0.4224015187470337,0.01651637399145705
2012,IOWA,BUENA VISTA,3700,129,4554,8383,0.44136943814863416,0.5432422760348324,0.01538828581653346
2012,IOWA,BUTLER,3329,110,4106,7545,0.4412193505632869,0.5442014579191518,0.0145791915175613
2012,IOWA,CALHOUN,2238,101,2891,5230,0.42791586998087955,0.552772466539197,0.019311663479923517
2012,IOWA,CARROLL,4947,126,5601,10674,0.4634626194491287,0.5247329960652052,0.011804384485666104
2012,IOWA,CASS,2858,130,4217,7205,0.39666897987508676,0.5852879944482998,0.018043025676613464
2012,IOWA,CEDAR,4972,148,4529,9649,0.5152865581925589,0.4693750647735517,0.015338377033889522
2012,IOWA,CERRO GORDO,13316,380,10128,23824,0.5589321692411015,0.42511752854264606,0.01595030221625252
2012,IOWA,CHEROKEE,2634,119,3662,6415,0.4106001558846454,0.5708495713172252,0.018550272798129385
2012,IOWA,CHICKASAW,3554,94,2836,6484,0.5481184454040715,0.43738433066008636,0.014497223935842072
2012,IOWA,CLARKE,2189,117,2124,4430,0.49413092550790066,0.47945823927765235,0.026410835214446954
2012,IOWA,CLAY,3385,166,4951,8502,0.398141613737944,0.5823335685721007,0.019524817689955305
2012,IOWA,CLAYTON,4806,168,4164,9138,0.525935653315824,0.4556795797767564,0.018384766907419567
2012,IOWA,CLINTON,15141,427,9432,25000,0.60564,0.37728,0.01708
2012,IOWA,CRAWFORD,3066,91,3595,6752,0.4540876777251185,0.5324348341232228,0.013477488151658768
2012,IOWA,DALLAS,16576,552,20988,38116,0.43488298877111975,0.5506349039773324,0.014482107251547907
2012,IOWA,DAVIS,1520,115,2138,3773,0.4028624436787702,0.5666578319639544,0.03047972435727538
2012,IOWA,DECATUR,1791,95,1947,3833,0.46725802243673364,0.507957213670754,0.02478476389251239
2012,IOWA,DELAWARE,4616,126,4636,9378,0.49221582426956706,0.49434847515461716,0.013435700575815739
2012,IOWA,DES MOINES,11888,361,8136,20385,0.5831739023792004,0.3991169977924945,0.017709099828305125
2012,IOWA,DICKINSON,4095,152,5912,10159,0.40309085539915346,0.581947042031696,0.014962102569150508
2012,IOWA,DUBUQUE,28768,846,21280,50894,0.565253271505482,0.41812394388336543,0.016622784611152592
2012,IOWA,EMMET,2099,81,2507,4687,0.44783443567313846,0.5348837209302325,0.017281843396628974
2012,IOWA,FAYETTE,5732,142,4492,10366,0.5529616052479259,0.4333397646150878,0.0136986301369863
2012,IOWA,FLOYD,4680,105,3472,8257,0.5667918130071454,0.4204917040087199,0.012716482984134674
2012,IOWA,FRANKLIN,2266,97,2823,5186,0.43694562283069804,0.5443501735441574,0.01870420362514462
2012,IOWA,FREMONT,1637,59,1972,3668,0.4462922573609597,0.5376226826608506,0.01608505997818975
2012,IOWA,GREENE,2375,91,2380,4846,0.49009492364836976,0.49112670243499795,0.018778373916632275
2012,IOWA,GRUNDY,2635,112,4215,6962,0.3784831944843436,0.6054294742889974,0.016087331226659007
2012,IOWA,GUTHRIE,2569,148,3171,5888,0.43631114130434784,0.5385529891304348,0.025135869565217392
2012,IOWA,HAMILTON,3782,154,3991,7927,0.4771035700769522,0.5034691560489466,0.019427273874101172
2012,IOWA,HANCOCK,2521,87,3317,5925,0.42548523206751054,0.559831223628692,0.014683544303797468
2012,IOWA,HARDIN,4075,153,4670,8898,0.4579680827152169,0.5248370420319173,0.017194875252865813
2012,IOWA,HARRISON,3136,121,4065,7322,0.42829827915869984,0.55517618137121,0.01652553947009014
2012,IOWA,HENRY,4460,202,5035,9697,0.4599360626998041,0.5192327523976488,0.02083118490254718
2012,IOWA,HOWARD,2768,82,1795,4645,0.5959095801937567,0.38643702906350913,0.017653390742734122
2012,IOWA,HUMBOLDT,1972,87,3099,5158,0.38231872818922064,0.600814269096549,0.016867002714230323
2012,IOWA,IDA,1321,56,2286,3663,0.36063336063336066,0.6240786240786241,0.015288015288015287
2012,IOWA,IOWA,4144,153,4569,8866,0.46740356417775775,0.515339499210467,0.017256936611775322
2012,IOWA,JACKSON,5907,158,4177,10242,0.5767428236672525,0.40783050185510644,0.015426674477641086
2012,IOWA,JASPER,10257,381,8877,19515,0.5255956956187549,0.454880860876249,0.019523443504996157
2012,IOWA,JEFFERSON,4798,296,3436,8530,0.5624853458382181,0.40281359906213365,0.0347010550996483
2012,IOWA,JOHNSON,50666,1613,23698,75977,0.6668597075430722,0.3119101833449597,0.021230109111968095
2012,IOWA,JONES,5534,194,4721,10449,0.5296200593358216,0.45181357067661976,0.018566369987558617
2012,IOWA,KEOKUK,2303,120,2843,5266,0.43733383972654766,0.5398784656285606,0.02278769464489176
2012,IOWA,KOSSUTH,3850,136,4937,8923,0.43146923680376553,0.553289252493556,0.01524151070267847
2012,IOWA,LEE,10714,412,7785,18911,0.5665485696155677,0.411665168420496,0.021786261963936335
2012,IOWA,LINN,68581,2250,47622,118453,0.5789722505972833,0.4020328737980465,0.018994875604670208
2012,IOWA,LOUISA,2452,96,2420,4968,0.49355877616747185,0.48711755233494364,0.01932367149758454
2012,IOWA,LUCAS,1987,82,2254,4323,0.45963451306962755,0.5213971778857275,0.018968309044644922
2012,IOWA,LYON,1423,108,4978,6509,0.21862037179290214,0.7647872176985712,0.016592410508526657
2012,IOWA,MADISON,3630,190,4638,8458,0.4291794750532041,0.5483565854812013,0.022463939465594704
2012,IOWA,MAHASKA,4213,222,6448,10883,0.38711752274189104,0.5924836901589635,0.020398787099145457
2012,IOWA,MARION,7507,352,9828,17687,0.42443602646011197,0.5556623508791768,0.019901622660711257
2012,IOWA,MARSHALL,10257,335,8472,19064,0.538029794376836,0.4443978178766261,0.017572387746537976
2012,IOWA,MILLS,2848,148,4216,7212,0.3948973932334997,0.5845812534664449,0.020521353300055462
2012,IOWA,MITCHELL,2831,112,2643,5586,0.5068027210884354,0.4731471535982814,0.020050125313283207
2012,IOWA,MONONA,2101,84,2557,4742,0.44306199915647404,0.5392239561366512,0.017714044706874738
2012,IOWA,MONROE,1731,73,2026,3830,0.45195822454308093,0.528981723237598,0.01906005221932115
2012,IOWA,MONTGOMERY,1922,102,3001,5025,0.3824875621890547,0.5972139303482588,0.020298507462686566
2012,IOWA,MUSCATINE,11323,374,8168,19865,0.5699974830103196,0.41117543418071983,0.018827082808960484
2012,IOWA,O'BRIEN,1969,106,5266,7341,0.26821958861190576,0.7173409617218363,0.014439449666258004
2012,IOWA,OSCEOLA,912,52,2230,3194,0.2855353788353162,0.6981840951784596,0.01628052598622417
2012,IOWA,PAGE,2613,118,4348,7079,0.36911993219381267,0.6142110467580166,0.016669021048170647
2012,IOWA,PALO ALTO,2139,88,2660,4887,0.4376918354818907,0.5443012072846327,0.018006957233476572
2012,IOWA,PLYMOUTH,4164,189,8597,12950,0.32154440154440156,0.6638610038610039,0.014594594594594595
2012,IOWA,POCAHONTAS,1523,113,2396,4032,0.3777281746031746,0.5942460317460317,0.028025793650793652
2012,IOWA,POLK,128465,4321,96096,228882,0.561271747013745,0.4198495294518573,0.018878723534397637
2012,IOWA,POTTAWATTAMIE,19644,797,21860,42301,0.4643861847237654,0.5167726531287676,0.018841162147466964
2012,IOWA,POWESHIEK,5357,194,4424,9975,0.5370426065162908,0.4435087719298246,0.01944862155388471
2012,IOWA,RINGGOLD,1186,45,1368,2599,0.4563293574451712,0.5263562908811081,0.01731435167372066
2012,IOWA,SAC,2122,75,3094,5291,0.40105840105840107,0.5847665847665847,0.014175014175014175
2012,IOWA,SCOTT,50652,1360,38251,90263,0.5611601652947498,0.42377275295525296,0.01506708174999723
2012,IOWA,SHELBY,2469,103,3911,6483,0.38084220268394264,0.6032700910072497,0.01588770630880765
2012,IOWA,SIOUX,2700,201,14407,17308,0.1559972267159695,0.8323896464062861,0.011613126877744396
2012,IOWA,STORY,26192,1290,19668,47150,0.5555037115588547,0.4171367974549311,0.02735949098621421
2012,IOWA,TAMA,4768,151,4098,9017,0.5287789730509038,0.4544748807807475,0.016746146168348675
2012,IOWA,TAYLOR,1262,50,1683,2995,0.4213689482470785,0.5619365609348915,0.01669449081803005
2012,IOWA,UNION,3043,101,2813,5957,0.5108275977841196,0.4722175591740809,0.016954843041799565
2012,IOWA,VAN BUREN,1402,103,2064,3569,0.3928271224432614,0.5783132530120482,0.02885962454469039
2012,IOWA,WAPELLO,8663,318,6789,15770,0.5493341788205454,0.4305009511731135,0.020164870006341155
2012,IOWA,WARREN,12551,469,13052,26072,0.4813976679963179,0.5006136851795029,0.017988646824179198
2012,IOWA,WASHINGTON,5115,327,5562,11004,0.4648309705561614,0.5054525627044711,0.0297164667393675
2012,IOWA,WAYNE,1251,66,1583,2900,0.43137931034482757,0.5458620689655173,0.022758620689655173
2012,IOWA,WEBSTER,9537,286,8469,18292,0.5213754646840149,0.46298928493330416,0.015635250382680953
2012,IOWA,WINNEBAGO,2903,109,2906,5918,0.490537343697195,0.4910442717134167,0.01841838458938831
2012,IOWA,WINNESHIEK,6256,206,4622,11084,0.5644171779141104,0.4169974738361602,0.01858534824972934
2012,IOWA,WOODBURY,22302,876,21841,45019,0.4953908349807859,0.48515071414291744,0.019458450876296676
2012,IOWA,WORTH,2350,78,1744,4172,0.5632790028763183,0.41802492809204217,0.018696069031639503
2012,IOWA,WRIGHT,2836,93,3349,6278,0.45173622172666456,0.5334501433577572,0.01481363491557821
2012,KANSAS,ALLEN,1869,125,3316,5310,0.3519774011299435,0.624482109227872,0.023540489642184557
2012,KANSAS,ANDERSON,944,95,2276,3315,0.28476621417797887,0.6865761689291101,0.02865761689291101
2012,KANSAS,ATCHISON,2567,190,3917,6674,0.38462691039856156,0.5869044051543303,0.02846868444710818
2012,KANSAS,BARBER,482,60,1772,2314,0.20829732065687123,0.7657735522904062,0.02592912705272256
2012,KANSAS,BARTON,2297,170,7874,10341,0.22212551977565032,0.7614350643071269,0.016439415917222706
2012,KANSAS,BOURBON,1996,156,4102,6254,0.31915574032619126,0.6559002238567317,0.02494403581707707
2012,KANSAS,BROWN,1076,88,2829,3993,0.26947157525669924,0.7084898572501879,0.02203856749311295
2012,KANSAS,BUTLER,7282,646,18157,26085,0.27916427065363236,0.6960705386237301,0.024765190722637533
2012,KANSAS,CHASE,358,38,875,1271,0.2816679779701023,0.6884343036978757,0.02989771833202203
2012,KANSAS,CHAUTAUQUA,280,46,1304,1630,0.17177914110429449,0.8,0.02822085889570552
2012,KANSAS,CHEROKEE,2930,185,5456,8571,0.34185042585462605,0.6365651615914129,0.02158441255396103
2012,KANSAS,CHEYENNE,233,34,1159,1426,0.16339410939691446,0.8127629733520336,0.023842917251051893
2012,KANSAS,CLARK,174,38,805,1017,0.1710914454277286,0.7915437561455261,0.03736479842674533
2012,KANSAS,CLAY,834,64,2788,3686,0.22626153011394465,0.7563754747693977,0.017362995116657624
2012,KANSAS,CLOUD,974,130,2954,4058,0.24001971414489898,0.7279448003942829,0.032035485460818136
2012,KANSAS,COFFEY,898,105,2903,3906,0.22990271377368152,0.743215565796211,0.026881720430107527
2012,KANSAS,COMANCHE,143,18,767,928,0.1540948275862069,0.8265086206896551,0.01939655172413793
2012,KANSAS,COWLEY,4319,310,8081,12710,0.3398111723052714,0.6357985837922895,0.024390243902439025
2012,KANSAS,CRAWFORD,6826,411,7708,14945,0.4567413850786216,0.5157577785212446,0.027500836400133823
2012,KANSAS,DECATUR,266,48,1218,1532,0.17362924281984335,0.7950391644908616,0.031331592689295036
2012,KANSAS,DICKINSON,2020,190,5832,8042,0.2511812981845312,0.7251927381248445,0.023625963690624224
2012,KANSAS,DONIPHAN,902,87,2414,3403,0.26506024096385544,0.7093740816926242,0.025565677343520422
2012,KANSAS,DOUGLAS,29267,1477,17401,48145,0.6078928237615536,0.3614290165126181,0.030678159725828227
2012,KANSAS,EDWARDS,298,28,1059,1385,0.21516245487364621,0.7646209386281588,0.020216606498194945
2012,KANSAS,ELK,281,39,1049,1369,0.20525931336742148,0.7662527392257122,0.028487947406866325
2012,KANSAS,ELLIS,3057,258,8399,11714,0.2609697797507256,0.7170052928120199,0.022024927437254566
2012,KANSAS,ELLSWORTH,702,80,1930,2712,0.2588495575221239,0.7116519174041298,0.029498525073746312
2012,KANSAS,FINNEY,2682,183,6219,9084,0.2952443857331572,0.6846103038309115,0.020145310435931308
2012,KANSAS,FORD,2600,160,5602,8362,0.31093039942597467,0.6699354221478115,0.019134178426213823
2012,KANSAS,FRANKLIN,3694,312,6984,10990,0.3361237488626024,0.6354868061874431,0.028389444949954504
2012,KANSAS,GEARY,3332,141,4372,7845,0.4247291268323773,0.5572976418100701,0.01797323135755258
2012,KANSAS,GOVE,176,39,1168,1383,0.1272595806218366,0.8445408532176428,0.028199566160520606
2012,KANSAS,GRAHAM,256,28,1056,1340,0.191044776119403,0.7880597014925373,0.020895522388059702
2012,KANSAS,GRANT,456,39,1811,2306,0.19774501300954034,0.7853425845620121,0.016912402428447527
2012,KANSAS,GRAY,324,31,1603,1958,0.16547497446373852,0.8186925434116445,0.015832482124616958
2012,KANSAS,GREELEY,113,14,543,670,0.16865671641791044,0.8104477611940298,0.020895522388059702
2012,KANSAS,GREENWOOD,478,55,1590,2123,0.2251530852567122,0.7489401789919925,0.025906735751295335
2012,KANSAS,HAMILTON,163,21,693,877,0.18586088939566706,0.790193842645382,0.02394526795895097
2012,KANSAS,HARPER,550,80,1759,2389,0.23022185014650481,0.7362913352867309,0.033486814566764334
2012,KANSAS,HARVEY,5373,333,8588,14294,0.37589198265006296,0.6008115293129984,0.023296488036938574
2012,KANSAS,HASKELL,215,22,1159,1396,0.15401146131805157,0.8302292263610315,0.015759312320916905
2012,KANSAS,HODGEMAN,179,13,868,1060,0.16886792452830188,0.8188679245283019,0.012264150943396227
2012,KANSAS,JACKSON,1901,133,3527,5561,0.3418449919079302,0.6342384463226038,0.023916561769465924
2012,KANSAS,JEFFERSON,2977,209,4827,8013,0.3715212779233745,0.6023961063272183,0.026082615749407213
2012,KANSAS,JEWELL,229,33,1235,1497,0.15297261189044756,0.8249832999331997,0.022044088176352707
2012,KANSAS,JOHNSON,110526,5438,158401,274365,0.40284292821606255,0.5773367594263117,0.01982031235762579
2012,KANSAS,KEARNY,268,21,1097,1386,0.19336219336219337,0.7914862914862915,0.015151515151515152
2012,KANSAS,KINGMAN,733,101,2397,3231,0.22686474775611265,0.7418755803156918,0.031259671928195606
2012,KANSAS,KIOWA,163,5,976,1144,0.14248251748251747,0.8531468531468531,0.004370629370629371
2012,KANSAS,LABETTE,3117,178,4742,8037,0.3878312803284808,0.5900211521712082,0.02214756750031106
2012,KANSAS,LANE,172,17,739,928,0.1853448275862069,0.7963362068965517,0.018318965517241378
2012,KANSAS,LEAVENWORTH,11357,669,17059,29085,0.3904761904761905,0.5865222623345367,0.02300154718927282
2012,KANSAS,LINCOLN,289,29,1165,1483,0.19487525286581253,0.7855697909642616,0.019554956169925825
2012,KANSAS,LINN,1170,120,3177,4467,0.2619207521826729,0.7112155809267965,0.026863666890530557
2012,KANSAS,LOGAN,197,27,1126,1350,0.14592592592592593,0.8340740740740741,0.02
2012,KANSAS,LYON,5111,294,6470,11875,0.4304,0.5448421052631579,0.024757894736842104
2012,KANSAS,MARION,1385,135,3889,5409,0.25605472360880016,0.7189868737289702,0.024958402662229616
2012,KANSAS,MARSHALL,1469,109,3195,4773,0.30777288916823803,0.6693903205531112,0.022836790278650744
2012,KANSAS,MCPHERSON,3449,303,8545,12297,0.28047491258030416,0.694884931284053,0.02464015613564284
2012,KANSAS,MEADE,258,23,1428,1709,0.15096547688706846,0.8355763604447045,0.013458162668227034
2012,KANSAS,MIAMI,4712,286,9858,14856,0.31717824448034465,0.6635702746365105,0.019251480883144857
2012,KANSAS,MITCHELL,584,54,2327,2965,0.196964586846543,0.784822934232715,0.01821247892074199
2012,KANSAS,MONTGOMERY,3501,286,8630,12417,0.2819521623580575,0.6950148989288878,0.023032938713054684
2012,KANSAS,MORRIS,718,71,1773,2562,0.28024980483996875,0.6920374707259953,0.02771272443403591
2012,KANSAS,MORTON,189,17,1072,1278,0.14788732394366197,0.838810641627543,0.013302034428794992
2012,KANSAS,NEMAHA,1000,96,3930,5026,0.19896538002387584,0.781933943493832,0.01910067648229208
2012,KANSAS,NEOSHO,2050,158,4272,6480,0.31635802469135804,0.6592592592592592,0.024382716049382715
2012,KANSAS,NESS,218,17,1209,1444,0.15096952908587258,0.8372576177285319,0.011772853185595568
2012,KANSAS,NORTON,398,49,1878,2325,0.17118279569892472,0.807741935483871,0.021075268817204302
2012,KANSAS,OSAGE,2268,211,4427,6906,0.32841007819287577,0.6410367796119316,0.030553142195192586
2012,KANSAS,OSBORNE,324,35,1479,1838,0.176278563656148,0.8046789989118607,0.019042437431991296
2012,KANSAS,OTTAWA,558,80,2295,2933,0.1902488919195363,0.7824752812819639,0.02727582679849983
2012,KANSAS,PAWNEE,718,54,1836,2608,0.2753067484662577,0.7039877300613497,0.020705521472392636
2012,KANSAS,PHILLIPS,382,48,2135,2565,0.14892787524366471,0.8323586744639376,0.01871345029239766
2012,KANSAS,POTTAWATOMIE,2335,340,6804,9479,0.24633400147694903,0.7177972359953582,0.0358687625276928
2012,KANSAS,PRATT,980,50,2771,3801,0.2578268876611418,0.7290186792949224,0.013154433043935806
2012,KANSAS,RAWLINS,190,31,1223,1444,0.13157894736842105,0.8469529085872576,0.02146814404432133
2012,KANSAS,RENO,8085,619,15718,24422,0.3310539677340103,0.6436000327573499,0.02534599950863975
2012,KANSAS,REPUBLIC,477,75,2134,2686,0.17758749069247953,0.7944899478778853,0.027922561429635145
2012,KANSAS,RICE,911,94,2676,3681,0.24748709589785384,0.7269763651181744,0.025536538983971745
2012,KANSAS,RILEY,8977,617,11507,21101,0.42543007440405667,0.5453296052319795,0.029240320363963793
2012,KANSAS,ROOKS,361,61,2038,2460,0.1467479674796748,0.8284552845528456,0.024796747967479674
2012,KANSAS,RUSH,367,37,1166,1570,0.2337579617834395,0.7426751592356687,0.02356687898089172
2012,KANSAS,RUSSELL,593,54,2553,3200,0.1853125,0.7978125,0.016875
2012,KANSAS,SALINE,7040,616,13840,21496,0.3275027912169706,0.6438407145515445,0.028656494231484926
2012,KANSAS,SCOTT,277,47,1728,2052,0.13499025341130605,0.8421052631578947,0.02290448343079922
2012,KANSAS,SEDGWICK,71977,4412,106506,182895,0.39354274310396675,0.582334126137948,0.02412313075808524
2012,KANSAS,SEWARD,1490,69,3617,5176,0.28786707882534773,0.6988021638330757,0.013330757341576507
2012,KANSAS,SHAWNEE,36975,1751,37782,76508,0.48328279395618756,0.4938307105139332,0.022886495529879227
2012,KANSAS,SHERIDAN,168,20,1154,1342,0.12518628912071536,0.8599105812220567,0.014903129657228018
2012,KANSAS,SHERMAN,577,70,1976,2623,0.21997712542889822,0.7533358749523447,0.02668699961875715
2012,KANSAS,SMITH,358,41,1624,2023,0.17696490360850223,0.8027681660899654,0.020266930301532378
2012,KANSAS,STAFFORD,404,50,1385,1839,0.21968461120174007,0.7531266992930941,0.027188689505165852
2012,KANSAS,STANTON,143,11,605,759,0.18840579710144928,0.7971014492753623,0.014492753623188406
2012,KANSAS,STEVENS,252,33,1749,2034,0.12389380530973451,0.859882005899705,0.016224188790560472
2012,KANSAS,SUMNER,2658,223,6260,9141,0.29077781424351823,0.6848266054042227,0.024395580352259052
2012,KANSAS,THOMAS,598,88,2788,3474,0.17213586643638457,0.8025331030512378,0.025331030512377662
2012,KANSAS,TREGO,291,27,1261,1579,0.18429385687143762,0.798606713109563,0.017099430018999367
2012,KANSAS,WABAUNSEE,918,93,2256,3267,0.2809917355371901,0.6905417814508723,0.028466483011937556
2012,KANSAS,WALLACE,68,11,719,798,0.08521303258145363,0.9010025062656641,0.013784461152882205
2012,KANSAS,WASHINGTON,524,49,2316,2889,0.18137763932156456,0.8016614745586709,0.016960886119764623
2012,KANSAS,WICHITA,157,9,821,987,0.1590678824721378,0.8318135764944276,0.00911854103343465
2012,KANSAS,WILSON,818,74,2825,3717,0.2200699488835082,0.7600215227333872,0.019908528383104654
2012,KANSAS,WOODSON,380,32,1035,1447,0.2626123013130615,0.7152729785763648,0.0221147201105736
2012,KANSAS,WYANDOTTE,34302,940,15496,50738,0.6760613346998305,0.3054121171508534,0.018526548149316095
2012,KENTUCKY,ADAIR,1660,99,5841,7600,0.21842105263157896,0.7685526315789474,0.013026315789473684
2012,KENTUCKY,ALLEN,1808,108,5184,7100,0.25464788732394367,0.7301408450704225,0.015211267605633802
2012,KENTUCKY,ANDERSON,3315,183,6822,10320,0.32122093023255816,0.661046511627907,0.017732558139534883
2012,KENTUCKY,BALLARD,1189,59,2647,3895,0.30526315789473685,0.679589216944801,0.015147625160462131
2012,KENTUCKY,BARREN,5400,246,10922,16568,0.32592950265572185,0.6592225977788508,0.01484789956542733
2012,KENTUCKY,BATH,1770,77,2275,4122,0.4294032023289665,0.5519165453663271,0.018680252304706452
2012,KENTUCKY,BELL,2224,131,7127,9482,0.23454967306475427,0.7516346762286438,0.013815650706601982
2012,KENTUCKY,BOONE,15629,960,35922,52511,0.2976328769210261,0.6840852392831978,0.018281883795776124
2012,KENTUCKY,BOURBON,3075,156,4692,7923,0.38811056418023476,0.5921999242711095,0.01968951154865581
2012,KENTUCKY,BOYD,7776,389,10884,19049,0.40821040474565595,0.5713685757782561,0.020421019476087984
2012,KENTUCKY,BOYLE,4471,199,7703,12373,0.36135132950779925,0.6225652630728199,0.01608340741938091
2012,KENTUCKY,BRACKEN,1147,56,2029,3232,0.35488861386138615,0.6277846534653465,0.017326732673267328
2012,KENTUCKY,BREATHITT,1562,128,3318,5008,0.31190095846645366,0.6625399361022364,0.025559105431309903
2012,KENTUCKY,BRECKINRIDGE,2825,119,5025,7969,0.35449868239427784,0.6305684527544234,0.014932864851298782
2012,KENTUCKY,BULLITT,9971,502,21306,31779,0.31376065955505206,0.6704427452091003,0.01579659523584757
2012,KENTUCKY,BUTLER,1293,51,3716,5060,0.2555335968379447,0.7343873517786561,0.01007905138339921
2012,KENTUCKY,CALDWELL,1852,104,3904,5860,0.31604095563139933,0.6662116040955631,0.017747440273037544
2012,KENTUCKY,CALLOWAY,5317,315,9440,15072,0.35277335456475584,0.6263269639065817,0.02089968152866242
2012,KENTUCKY,CAMPBELL,15080,857,24240,40177,0.37533912437464223,0.6033302635836424,0.021330612041715408
2012,KENTUCKY,CARLISLE,750,34,1835,2619,0.286368843069874,0.7006491027109584,0.012982054219167621
2012,KENTUCKY,CARROLL,1629,52,1999,3680,0.44266304347826085,0.5432065217391304,0.014130434782608696
2012,KENTUCKY,CARTER,3383,246,5279,8908,0.3797709923664122,0.5926133812303548,0.02761562640323305
2012,KENTUCKY,CASEY,1086,101,4904,6091,0.1782958463306518,0.8051223116072894,0.016581842062058774
2012,KENTUCKY,CHRISTIAN,8252,228,13475,21955,0.3758597130494193,0.6137554087907082,0.010384878159872466
2012,KENTUCKY,CLARK,5228,257,9931,15416,0.3391281785158277,0.6442008303061754,0.016670991177996888
2012,KENTUCKY,CLAY,1111,96,6176,7383,0.15048083434918055,0.8365163212786131,0.01300284437220642
2012,KENTUCKY,CLINTON,752,72,3569,4393,0.17118142499430913,0.8124288641019805,0.01638971090371045
2012,KENTUCKY,CRITTENDEN,960,55,2839,3854,0.24909185262065386,0.7366372599896212,0.014270887389724962
2012,KENTUCKY,CUMBERLAND,599,39,2216,2854,0.20988086895585142,0.7764540995094604,0.013665031534688158
2012,KENTUCKY,DAVIESS,16208,787,25092,42087,0.38510704017867753,0.5961935989735547,0.01869936084776772
2012,KENTUCKY,EDMONSON,1374,62,3232,4668,0.2943444730077121,0.6923736075407027,0.013281919451585262
2012,KENTUCKY,ELLIOTT,1186,87,1126,2399,0.4943726552730304,0.46936223426427676,0.03626511046269279
2012,KENTUCKY,ESTILL,1356,79,3749,5184,0.26157407407407407,0.7231867283950617,0.015239197530864198
2012,KENTUCKY,FAYETTE,62080,2991,60795,125866,0.493222951392751,0.4830136812165319,0.023763367390717112
2012,KENTUCKY,FLEMING,1911,91,3780,5782,0.3305084745762712,0.6537530266343826,0.015738498789346248
2012,KENTUCKY,FLOYD,4733,373,9784,14890,0.3178643384822028,0.6570852921423774,0.025050369375419743
2012,KENTUCKY,FRANKLIN,11535,457,11345,23337,0.49427947036894204,0.4861378926168745,0.019582637014183484
2012,KENTUCKY,FULTON,1022,34,1425,2481,0.41193067311567916,0.5743651753325272,0.013704151551793631
2012,KENTUCKY,GALLATIN,1238,65,1758,3061,0.40444299248611565,0.5743221169552434,0.021234890558640966
2012,KENTUCKY,GARRARD,1661,106,5310,7077,0.23470397060901513,0.7503179313268334,0.014978098064151476
2012,KENTUCKY,GRANT,2810,134,5664,8608,0.32644052044609667,0.6579925650557621,0.015566914498141264
2012,KENTUCKY,GRAVES,4547,257,10699,15503,0.29329807134103075,0.6901244920337999,0.016577436625169324
2012,KENTUCKY,GRAYSON,2744,123,6404,9271,0.29597670154244415,0.6907561212382699,0.013267177219285945
2012,KENTUCKY,GREEN,1165,57,3634,4856,0.23990939044481055,0.7483525535420099,0.011738056013179572
2012,KENTUCKY,GREENUP,6027,286,8855,15168,0.3973496835443038,0.5837948312236287,0.01885548523206751
2012,KENTUCKY,HANCOCK,1833,89,2212,4134,0.44339622641509435,0.5350749879051766,0.021528785679729077
2012,KENTUCKY,HARDIN,15214,647,23357,39218,0.3879341118873986,0.5955683614666735,0.01649752664592789
2012,KENTUCKY,HARLAN,1830,175,8652,10657,0.1717181195458384,0.8118607488036033,0.016421131650558318
2012,KENTUCKY,HARRISON,2471,136,4556,7163,0.3449671925171018,0.6360463492949882,0.018986458187910095
2012,KENTUCKY,HART,2283,82,4257,6622,0.3447598912715192,0.6428571428571429,0.012382965871337965
2012,KENTUCKY,HENDERSON,8091,235,10296,18622,0.4344860917194716,0.5528944259478037,0.012619482332724734
2012,KENTUCKY,HENRY,2530,120,3940,6590,0.38391502276176026,0.5978755690440061,0.018209408194233688
2012,KENTUCKY,HICKMAN,686,22,1431,2139,0.32071061243571763,0.6690042075736325,0.010285179990649837
2012,KENTUCKY,HOPKINS,5789,297,13681,19767,0.2928618404411393,0.6921131178226336,0.015025041736227046
2012,KENTUCKY,JACKSON,612,84,4365,5061,0.12092471843509188,0.8624777711914642,0.016597510373443983
2012,KENTUCKY,JEFFERSON,186181,4975,148423,339579,0.5482700638143112,0.4370794424861372,0.014650493699551504
2012,KENTUCKY,JESSAMINE,6001,399,14233,20633,0.290844763243348,0.6898172829932632,0.019337953763388746
2012,KENTUCKY,JOHNSON,1723,217,7095,9035,0.1907028223574986,0.7852794687327062,0.02401770890979524
2012,KENTUCKY,KENTON,24920,1395,41389,67704,0.3680727874276261,0.6113228169679783,0.020604395604395604
2012,KENTUCKY,KNOTT,1420,143,4130,5693,0.24942912348498156,0.725452309854207,0.025118566660811522
2012,KENTUCKY,KNOX,2484,149,8467,11100,0.22378378378378377,0.7627927927927928,0.013423423423423423
2012,KENTUCKY,LARUE,1733,120,3911,5764,0.3006592643997224,0.6785218598195697,0.020818875780707843
2012,KENTUCKY,LAUREL,3905,352,18151,22408,0.17426811852909674,0.8100232059978579,0.01570867547304534
2012,KENTUCKY,LAWRENCE,1520,77,3995,5592,0.2718168812589413,0.7144134477825465,0.01376967095851216
2012,KENTUCKY,LEE,595,51,1977,2623,0.22683949675943577,0.7537171178040412,0.019443385436523065
2012,KENTUCKY,LESLIE,433,78,4439,4950,0.08747474747474747,0.8967676767676768,0.01575757575757576
2012,KENTUCKY,LETCHER,1702,245,6811,8758,0.1943366065311715,0.7776889700844942,0.027974423384334323
2012,KENTUCKY,LEWIS,1342,101,3326,4769,0.2814007129377228,0.6974208429440134,0.021178444118263785
2012,KENTUCKY,LINCOLN,2582,154,6416,9152,0.2821241258741259,0.701048951048951,0.016826923076923076
2012,KENTUCKY,LIVINGSTON,1346,76,3089,4511,0.298381733540235,0.6847705608512525,0.016847705608512526
2012,KENTUCKY,LOGAN,3469,142,6899,10510,0.3300666032350143,0.6564224548049477,0.01351094196003806
2012,KENTUCKY,LYON,1373,54,2412,3839,0.35764522010940347,0.6282886168272988,0.014066163063297733
2012,KENTUCKY,MADISON,11512,682,21128,33322,0.3454774623371946,0.634055578896825,0.020466958765980432
2012,KENTUCKY,MAGOFFIN,1433,82,3391,4906,0.2920913167549939,0.6911944557684468,0.016714227476559314
2012,KENTUCKY,MARION,3418,100,3800,7318,0.4670675047827275,0.5192675594424706,0.013664935774801858
2012,KENTUCKY,MARSHALL,5022,295,10402,15719,0.3194859723901011,0.6617469304663146,0.018767097143584197
2012,KENTUCKY,MARTIN,574,70,3180,3824,0.15010460251046026,0.8315899581589958,0.018305439330543932
2012,KENTUCKY,MASON,2592,92,4197,6881,0.37668943467519256,0.609940415637262,0.013370149687545414
2012,KENTUCKY,MCCRACKEN,10062,510,19979,30551,0.32935092141010114,0.6539556806651173,0.016693397924781514
2012,KENTUCKY,MCCREARY,1069,74,4564,5707,0.18731382512703698,0.7997196425442439,0.012966532328719117
2012,KENTUCKY,MCLEAN,1432,63,2705,4200,0.34095238095238095,0.6440476190476191,0.015
2012,KENTUCKY,MEADE,4122,188,6606,10916,0.3776108464639062,0.6051667277390985,0.017222425796995237
2012,KENTUCKY,MENIFEE,1048,66,1484,2598,0.403387220939184,0.5712086220169361,0.025404157043879907
2012,KENTUCKY,MERCER,2966,153,6820,9939,0.29842036422175267,0.6861857329711238,0.015393902807123452
2012,KENTUCKY,METCALFE,1425,83,2676,4184,0.3405831739961759,0.6395793499043977,0.019837476099426387
2012,KENTUCKY,MONROE,936,48,3762,4746,0.1972187104930468,0.7926675094816688,0.010113780025284451
2012,KENTUCKY,MONTGOMERY,3701,149,6398,10248,0.36114363778298203,0.6243169398907104,0.014539422326307573
2012,KENTUCKY,MORGAN,1369,82,3021,4472,0.30612701252236135,0.6755366726296959,0.018336314847942754
2012,KENTUCKY,MUHLENBERG,4771,206,7762,12739,0.37451919302928016,0.6093099929350813,0.01617081403563859
2012,KENTUCKY,NELSON,7611,249,10673,18533,0.41067285382830626,0.575891652727567,0.013435493444126693
2012,KENTUCKY,NICHOLAS,948,50,1583,2581,0.3672994963192561,0.6133281673769857,0.019372336303758234
2012,KENTUCKY,OHIO,2987,189,6470,9646,0.30966203607713044,0.6707443499896331,0.019593613933236574
2012,KENTUCKY,OLDHAM,9240,465,20179,29884,0.3091955561504484,0.6752442778744479,0.015560165975103735
2012,KENTUCKY,OWEN,1501,85,2971,4557,0.3293833662497257,0.651964011411016,0.018652622339258285
2012,KENTUCKY,OWSLEY,283,18,1279,1580,0.17911392405063292,0.8094936708860759,0.01139240506329114
2012,KENTUCKY,PENDLETON,1859,119,3556,5534,0.3359233827249729,0.6425731839537405,0.021503433321286593
2012,KENTUCKY,PERRY,2047,154,8040,10241,0.19988282394297432,0.7850795820720633,0.015037593984962405
2012,KENTUCKY,PIKE,5646,400,17590,23636,0.23887290573701134,0.7442037569808766,0.016923337282112032
2012,KENTUCKY,POWELL,1620,95,2766,4481,0.3615264449899576,0.6172729301495202,0.021200624860522203
2012,KENTUCKY,PULASKI,4976,313,20714,26003,0.19136253509210477,0.7966003922624313,0.012037072645463985
2012,KENTUCKY,ROBERTSON,340,16,579,935,0.36363636363636365,0.6192513368983957,0.017112299465240642
2012,KENTUCKY,ROCKCASTLE,1097,91,5028,6216,0.17648005148005147,0.8088803088803089,0.01463963963963964
2012,KENTUCKY,ROWAN,3438,192,4035,7665,0.44853228962818004,0.5264187866927593,0.025048923679060666
2012,KENTUCKY,RUSSELL,1445,118,6346,7909,0.1827032494626375,0.8023770388165381,0.014919711720824378
2012,KENTUCKY,SCOTT,7532,362,12679,20573,0.3661109220823409,0.6162931998250134,0.0175958780926457
2012,KENTUCKY,SHELBY,6634,239,11790,18663,0.355462680169319,0.6317312329207523,0.012806086909928736
2012,KENTUCKY,SIMPSON,2650,88,4355,7093,0.37360778232059777,0.6139856196249823,0.01240659805441985
2012,KENTUCKY,SPENCER,2549,156,5726,8431,0.30233661487368046,0.6791602419641798,0.01850314316213972
2012,KENTUCKY,TAYLOR,3285,114,7551,10950,0.3,0.6895890410958904,0.010410958904109589
2012,KENTUCKY,TODD,1403,68,3247,4718,0.2973717676981772,0.6882153454853751,0.014412886816447647
2012,KENTUCKY,TRIGG,2115,107,4520,6742,0.31370513200830613,0.6704242064669238,0.015870661524770097
2012,KENTUCKY,TRIMBLE,1355,55,2133,3543,0.38244425627998874,0.6020321761219306,0.015523567598080722
2012,KENTUCKY,UNION,1942,82,3955,5979,0.32480347884261584,0.6614818531527011,0.013714668004683057
2012,KENTUCKY,WARREN,16805,714,26384,43903,0.3827756645331754,0.6009612099400952,0.016263125526729382
2012,KENTUCKY,WASHINGTON,1669,55,3495,5219,0.3197930638053267,0.6696685188733473,0.010538417321325924
2012,KENTUCKY,WAYNE,1855,66,5289,7210,0.25728155339805825,0.7335644937586685,0.009153952843273232
2012,KENTUCKY,WEBSTER,1765,98,3607,5470,0.3226691042047532,0.6594149908592322,0.017915904936014627
2012,KENTUCKY,WHITLEY,2683,157,10232,13072,0.20524785801713585,0.7827417380660955,0.012010403916768666
2012,KENTUCKY,WOLFE,976,41,1542,2559,0.38139898397811645,0.6025791324736225,0.016021883548261038
2012,KENTUCKY,WOODFORD,4883,230,7219,12332,0.39596172559195586,0.5853876094712942,0.018650664936749918
2012,LOUISIANA,ACADIA,6560,344,19931,26835,0.24445686603316563,0.7427240544065586,0.012819079560275759
2012,LOUISIANA,ALLEN,2617,195,6495,9307,0.2811862039325239,0.6978618244332223,0.020951971634253788
2012,LOUISIANA,ASCENSION,16349,868,33856,51073,0.3201104301685822,0.6628942885673448,0.016995281264072994
2012,LOUISIANA,ASSUMPTION,4754,155,6083,10992,0.43249636098981076,0.5534024745269287,0.014101164483260552
2012,LOUISIANA,AVOYELLES,6077,285,10670,17032,0.35679896665100985,0.6264678252700798,0.016733208078910287
2012,LOUISIANA,BEAUREGARD,2828,285,11112,14225,0.19880492091388402,0.7811599297012303,0.020035149384885764
2012,LOUISIANA,BIENVILLE,3490,72,3641,7203,0.484520338747744,0.5054838261835346,0.009995835068721367
2012,LOUISIANA,BOSSIER,12956,618,34988,48562,0.2667929656933405,0.7204810345537663,0.012725999752893208
2012,LOUISIANA,CADDO,58042,1264,52459,111765,0.519321791258444,0.46936876481903994,0.011309443922515993
2012,LOUISIANA,CALCASIEU,28359,1517,51850,81726,0.3470009544086337,0.6344370212661821,0.01856202432518415
2012,LOUISIANA,CALDWELL,1016,60,3640,4716,0.2154368108566582,0.7718405428329093,0.01272264631043257
2012,LOUISIANA,CAMERON,408,76,3260,3744,0.10897435897435898,0.8707264957264957,0.0202991452991453
2012,LOUISIANA,CATAHOULA,1408,41,2744,4193,0.33579775816837587,0.654424040066778,0.009778201764846173
2012,LOUISIANA,CLAIBORNE,3014,69,3649,6732,0.4477124183006536,0.542038027332145,0.010249554367201427
2012,LOUISIANA,CONCORDIA,3833,97,5450,9380,0.40863539445629,0.5810234541577826,0.010341151385927505
2012,LOUISIANA,DE SOTO,5553,145,7353,13051,0.4254846371925523,0.563405103057237,0.011110259750210712
2012,LOUISIANA,EAST BATON ROUGE,102656,3223,92292,198171,0.5180172679150834,0.4657190002573535,0.016263731827563063
2012,LOUISIANA,EAST CARROLL,2478,22,1508,4008,0.6182634730538922,0.37624750499001997,0.0054890219560878245
2012,LOUISIANA,EAST FELICIANA,4648,164,5397,10209,0.45528455284552843,0.5286511901263591,0.01606425702811245
2012,LOUISIANA,EVANGELINE,5330,259,10181,15770,0.3379835129993659,0.6455928979074191,0.016423589093214966
2012,LOUISIANA,FRANKLIN,2921,121,6294,9336,0.31287489288774634,0.6741645244215938,0.012960582690659812
2012,LOUISIANA,GRANT,1422,163,7082,8667,0.1640706126687435,0.8171224183685243,0.018806968962732203
2012,LOUISIANA,IBERIA,12132,373,20892,33397,0.3632661616312842,0.6255651705242986,0.011168667844417163
2012,LOUISIANA,IBERVILLE,9548,195,7271,17014,0.561184906547549,0.4273539438109792,0.011461149641471729
2012,LOUISIANA,JACKSON,2305,92,5132,7529,0.306149555053792,0.6816310266967724,0.012219418249435517
2012,LOUISIANA,JEFFERSON,70384,3423,102536,176343,0.3991312385521399,0.5814577272701497,0.019411034177710486
2012,LOUISIANA,JEFFERSON DAVIS,3484,236,10014,13734,0.25367700597058396,0.7291393621668851,0.017183631862530944
2012,LOUISIANA,LA SALLE,764,82,5726,6572,0.1162507608034084,0.8712720632988435,0.012477175897748022
2012,LOUISIANA,LAFAYETTE,31768,1882,64992,98642,0.3220534863445591,0.6588674195575921,0.019079094097848786
2012,LOUISIANA,LAFOURCHE,9623,860,28592,39075,0.24626999360204735,0.7317210492642354,0.02200895713371721
2012,LOUISIANA,LINCOLN,7956,298,10739,18993,0.4188911704312115,0.5654188385194545,0.015689991049333964
2012,LOUISIANA,LIVINGSTON,7451,1098,45513,54062,0.1378232399837224,0.8418667455883985,0.0203100144278791
2012,LOUISIANA,MADISON,3154,33,2000,5187,0.608058608058608,0.385579332947754,0.006362058993637941
2012,LOUISIANA,MOREHOUSE,5888,135,6591,12614,0.4667829395909307,0.522514666243856,0.010702394165213255
2012,LOUISIANA,NATCHITOCHES,7942,239,9077,17258,0.4601923745509329,0.5259589755475721,0.01384864990149496
2012,LOUISIANA,ORLEANS,126722,3088,28003,157813,0.8029883469676136,0.1774441902758328,0.019567462756553643
2012,LOUISIANA,OUACHITA,26645,881,40948,68474,0.38912579957356075,0.5980080030376493,0.012866197388789906
2012,LOUISIANA,PLAQUEMINES,3599,169,6471,10239,0.35149916984080476,0.6319953120421916,0.016505518117003612
2012,LOUISIANA,POINTE COUPEE,5436,163,6548,12147,0.4475179056557175,0.5390631431629209,0.013418951181361653
2012,LOUISIANA,RAPIDES,20045,781,37193,58019,0.34549027042865266,0.641048622003137,0.013461107568210414
2012,LOUISIANA,RED RIVER,2253,71,2483,4807,0.4686914915747868,0.5165383815269399,0.014770126898273351
2012,LOUISIANA,RICHLAND,3387,96,5846,9329,0.36306142137420944,0.6266480866116411,0.010290492014149426
2012,LOUISIANA,SABINE,2194,121,7738,10053,0.21824331045459067,0.7697204814483238,0.012036208097085447
2012,LOUISIANA,ST. BERNARD,5059,395,8501,13955,0.36252239340738085,0.6091723396632032,0.02830526692941598
2012,LOUISIANA,ST. CHARLES,8896,500,15937,25333,0.3511625152962539,0.629100382899775,0.019737101803971105
2012,LOUISIANA,ST. HELENA,3780,85,2529,6394,0.5911792305286205,0.3955270566155771,0.013293712855802315
2012,LOUISIANA,ST. JAMES,7059,127,5209,12395,0.5695038321903994,0.4202501008471158,0.010246066962484873
2012,LOUISIANA,ST. JOHN THE BAPTIST,13179,324,7620,21123,0.6239170572361881,0.36074421246981964,0.01533873029399233
2012,LOUISIANA,ST. LANDRY,19668,504,21475,41647,0.4722549043148366,0.5156433836770956,0.012101712008067807
2012,LOUISIANA,ST. MARTIN,9422,358,15653,25433,0.3704635709511265,0.6154602288365509,0.014076200212322573
2012,LOUISIANA,ST. MARY,9450,305,13885,23640,0.399746192893401,0.5873519458544839,0.012901861252115059
2012,LOUISIANA,ST. TAMMANY,25728,2451,84723,112902,0.22787904554392305,0.7504118616144976,0.021709092841579423
2012,LOUISIANA,TANGIPAHOA,17722,787,31590,50099,0.3537395956007106,0.6305515080141321,0.01570889638515739
2012,LOUISIANA,TENSAS,1564,18,1230,2812,0.5561877667140825,0.43741109530583216,0.006401137980085348
2012,LOUISIANA,TERREBONNE,12074,764,29503,42341,0.2851609551026192,0.6967950686096219,0.01804397628775891
2012,LOUISIANA,UNION,3075,130,7561,10766,0.28562140070592607,0.7023035482073193,0.012075051086754598
2012,LOUISIANA,VERMILION,5720,357,18910,24987,0.22891903789970786,0.7567935326369712,0.014287429463320928
2012,LOUISIANA,VERNON,3173,287,12150,15610,0.20326713645099295,0.7783472133247918,0.018385650224215247
2012,LOUISIANA,WASHINGTON,6466,317,11798,18581,0.3479898821376675,0.6349496797804208,0.01706043808191163
2012,LOUISIANA,WEBSTER,6802,214,11400,18416,0.3693527367506516,0.6190269331016507,0.011620330147697654
2012,LOUISIANA,WEST BATON ROUGE,5692,160,6922,12774,0.4455926099890402,0.5418819477062784,0.012525442304681384
2012,LOUISIANA,WEST CARROLL,853,67,3628,4548,0.18755496921723835,0.7977132805628848,0.014731750219876869
2012,LOUISIANA,WEST FELICIANA,2441,79,3257,5777,0.4225376492989441,0.5637874329236628,0.01367491777739311
2012,LOUISIANA,WINN,1919,74,4541,6534,0.29369452096724824,0.6949801040710132,0.011325374961738598
2012,MAINE,ANDROSCOGGIN,28989,1641,22232,52862,0.5483901479323522,0.4205667587302788,0.031043093337368998
2012,MAINE,AROOSTOOK,17777,887,15196,33860,0.5250147666863556,0.44878913171884227,0.026196101594802127
2012,MAINE,CUMBERLAND,101950,4015,57821,163786,0.6224585739928932,0.3530277313079262,0.02451369469918064
2012,MAINE,FRANKLIN,9367,546,6369,16282,0.5752978749539369,0.3911681611595627,0.03353396388650043
2012,MAINE,HANCOCK,17569,906,12324,30799,0.5704405987207377,0.40014286178122666,0.02941653949803565
2012,MAINE,KENNEBEC,35068,1910,26519,63497,0.5522780603808054,0.41764177835173316,0.030080161267461453
2012,MAINE,KNOX,13223,596,8248,22067,0.5992205555807314,0.37377078896089183,0.027008655458376763
2012,MAINE,LINCOLN,11315,543,8899,20757,0.5451173098231922,0.4287228404875464,0.026159849689261452
2012,MAINE,MAINE UOCAVA,2071,125,858,3054,0.6781270464963982,0.28094302554027506,0.040929927963326784
2012,MAINE,OXFORD,16330,1094,11996,29420,0.5550645819170632,0.4077498300475867,0.0371855880353501
2012,MAINE,PENOBSCOT,38811,1948,36547,77306,0.5020438258349934,0.47275761260445504,0.025198561560551575
2012,MAINE,PISCATAQUIS,4149,276,4530,8955,0.46331658291457284,0.5058626465661642,0.03082077051926298
2012,MAINE,SAGADAHOC,11821,544,8429,20794,0.5684812926805809,0.40535731460998364,0.026161392709435415
2012,MAINE,SOMERSET,12216,771,11800,24787,0.4928389881792875,0.47605599709525154,0.031105014725460928
2012,MAINE,WALDO,11296,707,9058,21061,0.5363468021461469,0.4300840415934666,0.03356915626038649
2012,MAINE,WASHINGTON,7803,483,7550,15836,0.4927380651679717,0.4767618085375095,0.030500126294518818
2012,MAINE,YORK,61551,2606,43900,108057,0.5696160359810101,0.40626706275391694,0.024116901265073064
2012,MARYLAND,ALLEGANY,9805,815,19230,29850,0.32847571189279734,0.6442211055276382,0.02730318257956449
2012,MARYLAND,ANNE ARUNDEL,126635,6688,126832,260155,0.48676750398800717,0.487524744863639,0.025707751148353865
2012,MARYLAND,BALTIMORE,220322,9552,154908,384782,0.5725891543783234,0.40258639957170556,0.024824446049971152
2012,MARYLAND,BALTIMORE CITY,221478,4356,28171,254005,0.8719434656798094,0.11090726560500777,0.017149268715182773
2012,MARYLAND,CALVERT,20529,1037,23952,45518,0.451008392284371,0.5262094116613208,0.022782196054308188
2012,MARYLAND,CAROLINE,4970,289,8098,13357,0.37208954106461034,0.6062738638915924,0.02163659504379726
2012,MARYLAND,CARROLL,27939,2836,56761,87536,0.31917154085176386,0.6484303600804241,0.0323980990678121
2012,MARYLAND,CECIL,16557,1117,24806,42480,0.38975988700564973,0.5839453860640301,0.02629472693032015
2012,MARYLAND,CHARLES,48774,1270,25178,75222,0.6484007338278696,0.3347159075802292,0.016883358591901307
2012,MARYLAND,DORCHESTER,7257,211,7976,15444,0.4698912198912199,0.5164465164465164,0.013662263662263661
2012,MARYLAND,FREDERICK,55146,3171,58798,117115,0.4708705118900226,0.5020535371216326,0.02707595098834479
2012,MARYLAND,GARRETT,3124,290,9743,13157,0.23744014592992324,0.7405183552481569,0.02204149882191989
2012,MARYLAND,HARFORD,49729,3314,72911,125954,0.3948187433507471,0.5788700636740397,0.026311192975213175
2012,MARYLAND,HOWARD,91393,3957,57758,153108,0.5969185150351386,0.3772369830446482,0.025844501920213182
2012,MARYLAND,KENT,4842,192,4870,9904,0.4888933764135703,0.4917205169628433,0.01938610662358643
2012,MARYLAND,MONTGOMERY,323400,9239,123353,455992,0.7092229688240145,0.2705157108019439,0.02026132037404165
2012,MARYLAND,PRINCE GEORGE'S,347938,4072,35734,387744,0.8973394817198976,0.09215874391350995,0.01050177436659239
2012,MARYLAND,QUEEN ANNE'S,8556,509,15823,24888,0.3437801350048216,0.6357682417229187,0.020451623272259724
2012,MARYLAND,SOMERSET,5240,117,5042,10399,0.5038946052505049,0.4848543129147033,0.011251081834791806
2012,MARYLAND,ST. MARY'S,19711,1316,26797,47824,0.4121570759451322,0.5603253596520575,0.027517564402810304
2012,MARYLAND,TALBOT,8808,312,11339,20459,0.4305195757368395,0.5542304120435994,0.015250012219561073
2012,MARYLAND,WASHINGTON,25042,1639,36074,62755,0.3990439008843917,0.5748386582742411,0.02611744084136722
2012,MARYLAND,WICOMICO,19635,860,21764,42259,0.46463475236044394,0.5150145531129463,0.020350694526609717
2012,MARYLAND,WORCESTER,11014,455,15951,27420,0.40167760758570387,0.5817286652078775,0.016593727206418673
2012,MASSACHUSETTS,BARNSTABLE,70822,1847,60446,133115,0.5320362092927168,0.45408857003342973,0.013875220673853435
2012,MASSACHUSETTS,BERKSHIRE,48843,1391,14252,64486,0.7574202152405173,0.2210092113016779,0.021570573457804793
2012,MASSACHUSETTS,BRISTOL,142962,4795,93752,241509,0.5919530949157175,0.3881925725335288,0.019854332550753803
2012,MASSACHUSETTS,DUKES,7978,198,2792,10968,0.7273887673231219,0.25455871626549964,0.018052516411378557
2012,MASSACHUSETTS,ESSEX,210302,5575,150480,366357,0.5740357083391336,0.41074689442265333,0.015217397238213
2012,MASSACHUSETTS,FRANKLIN,27072,1342,9344,37758,0.7169871285555379,0.2474707346787436,0.035542136765718525
2012,MASSACHUSETTS,HAMPDEN,123619,3388,73392,200399,0.616864355610557,0.3662293724020579,0.016906271987385167
2012,MASSACHUSETTS,HAMPSHIRE,57359,2782,21480,81621,0.7027480672866052,0.26316756717021356,0.03408436554318129
2012,MASSACHUSETTS,MIDDLESEX,471804,15045,267321,754170,0.6255936990333745,0.3544572178686503,0.01994908309797526
2012,MASSACHUSETTS,NANTUCKET,3830,103,2187,6120,0.6258169934640523,0.3573529411764706,0.016830065359477123
2012,MASSACHUSETTS,NORFOLK,202714,5416,148393,356523,0.5685860379274268,0.4162227962852327,0.015191165787340508
2012,MASSACHUSETTS,PLYMOUTH,131845,3600,121086,256531,0.5139534793065945,0.47201312901754566,0.014033391675859838
2012,MASSACHUSETTS,SUFFOLK,223896,5203,59999,289098,0.7744640225805782,0.2075386201218964,0.017997357297525406
2012,MASSACHUSETTS,WORCESTER,198244,7478,163390,369112,0.5370835952231301,0.44265697132577647,0.020259433451093434
2012,MICHIGAN,ALCONA,2472,61,3571,6104,0.40498034076015726,0.5850262123197904,0.009993446920052424
2012,MICHIGAN,ALGER,2212,76,2330,4618,0.47899523603291466,0.5045474231268947,0.01645734084019056
2012,MICHIGAN,ALLEGAN,20806,690,31123,52619,0.39540850263212907,0.5914783633288356,0.013113134039035329
2012,MICHIGAN,ALPENA,6549,167,7298,14014,0.46731839588982443,0.520764949336378,0.01191665477379763
2012,MICHIGAN,ANTRIM,5107,171,7917,13195,0.3870405456612353,0.6,0.012959454338764683
2012,MICHIGAN,ARENAC,3669,115,4057,7841,0.46792500956510646,0.5174084938145644,0.01466649662032904
2012,MICHIGAN,BARAGA,1574,50,1866,3490,0.4510028653295129,0.5346704871060172,0.014326647564469915
2012,MICHIGAN,BARRY,11491,366,16655,28512,0.4030232884399551,0.5841400112233446,0.012836700336700337
2012,MICHIGAN,BAY,27877,593,24911,53381,0.5222270096101609,0.4666641688990465,0.011108821490792604
2012,MICHIGAN,BENZIE,4685,141,5075,9901,0.4731845268154732,0.5125744874255126,0.014240985759014241
2012,MICHIGAN,BERRIEN,33465,823,38209,72497,0.46160530780584025,0.5270424983102749,0.01135219388388485
2012,MICHIGAN,BRANCH,6913,199,10035,17147,0.4031609027818277,0.585233568554266,0.011605528663906222
2012,MICHIGAN,CALHOUN,29267,727,28333,58327,0.5017744783719376,0.4857613112280762,0.012464210399986284
2012,MICHIGAN,CASS,9591,240,12659,22490,0.4264562027567808,0.5628723877278791,0.01067140951534015
2012,MICHIGAN,CHARLEVOIX,5939,151,8000,14090,0.42150461320085164,0.5677785663591199,0.010716820440028389
2012,MICHIGAN,CHEBOYGAN,5831,194,7286,13311,0.438058748403576,0.547366839456089,0.014574412140335061
2012,MICHIGAN,CHIPPEWA,7100,186,8278,15564,0.45618093035209456,0.5318684142893858,0.011950655358519661
2012,MICHIGAN,CLARE,6338,178,6988,13504,0.4693424170616114,0.5174763033175356,0.013181279620853081
2012,MICHIGAN,CLINTON,18191,394,20650,39235,0.46364215623805277,0.5263157894736842,0.01004205428826303
2012,MICHIGAN,CRAWFORD,2994,76,3744,6814,0.4393894922218961,0.5494570002935134,0.011153507484590548
2012,MICHIGAN,DELTA,8330,186,9534,18050,0.4614958448753463,0.5281994459833795,0.010304709141274238
2012,MICHIGAN,DICKINSON,4952,170,7688,12810,0.3865729898516784,0.6001561280249805,0.01327088212334114
2012,MICHIGAN,EATON,27913,678,26197,54788,0.5094728772723954,0.4781521501058626,0.012374972621741987
2012,MICHIGAN,EMMET,7225,231,10253,17709,0.4079846405782371,0.5789711446157321,0.013044214806030833
2012,MICHIGAN,GENESEE,128978,2147,71808,202933,0.6355693751139538,0.3538507783357069,0.010579846550339275
2012,MICHIGAN,GLADWIN,5760,162,6661,12583,0.4577604704760391,0.5293650162918223,0.012874513232138599
2012,MICHIGAN,GOGEBIC,4058,74,3444,7576,0.5356388595564942,0.4545934530095037,0.009767687434002113
2012,MICHIGAN,GRAND TRAVERSE,20875,590,26534,47999,0.43490489385195524,0.5528031833996542,0.012291922748390591
2012,MICHIGAN,GRATIOT,7610,184,8241,16035,0.47458684128468975,0.5139382600561272,0.011474898659183037
2012,MICHIGAN,HILLSDALE,7106,267,11727,19100,0.37204188481675393,0.6139790575916231,0.013979057591623037
2012,MICHIGAN,HOUGHTON,6801,285,8196,15282,0.44503337259521003,0.536317235963879,0.018649391440910875
2012,MICHIGAN,HURON,6518,160,8806,15484,0.4209506587445105,0.5687160940325497,0.01033324722293981
2012,MICHIGAN,INGHAM,80847,1757,45306,127910,0.6320616058165898,0.3542021734031741,0.013736220780236104
2012,MICHIGAN,IONIA,11018,428,14315,25761,0.4277007880128877,0.555684950118396,0.016614261868716278
2012,MICHIGAN,IOSCO,6242,193,6909,13344,0.4677757793764988,0.5177607913669064,0.014463429256594725
2012,MICHIGAN,IRON,2687,77,3224,5988,0.4487307949231797,0.5384101536406145,0.012859051436205745
2012,MICHIGAN,ISABELLA,13038,281,10800,24119,0.5405696753596749,0.44777975869646336,0.011650565943861687
2012,MICHIGAN,JACKSON,32301,847,36298,69446,0.4651239812228206,0.5226794919793797,0.01219652679779973
2012,MICHIGAN,KALAMAZOO,69051,1465,52662,123178,0.5605789994966633,0.4275276429232493,0.011893357580087353
2012,MICHIGAN,KALKASKA,3272,126,4901,8299,0.3942643692011086,0.5905530786841788,0.015182552114712616
2012,MICHIGAN,KENT,133408,3652,155925,292985,0.4553407171015581,0.5321944809461235,0.012464801952318378
2012,MICHIGAN,KEWEENAW,582,36,774,1392,0.41810344827586204,0.5560344827586207,0.02586206896551724
2012,MICHIGAN,LAKE,2752,48,2487,5287,0.5205220351806318,0.47039909211272934,0.009078872706638926
2012,MICHIGAN,LAPEER,18796,585,23734,43115,0.435950365302099,0.5504812710193668,0.013568363678534152
2012,MICHIGAN,LEELANAU,6576,117,7483,14176,0.463882618510158,0.5278639954853274,0.008253386004514673
2012,MICHIGAN,LENAWEE,21776,597,22351,44724,0.486897415258027,0.49975404704409265,0.013348537697880332
2012,MICHIGAN,LIVINGSTON,37216,1038,60083,98337,0.37845368477785574,0.6109907766151093,0.010555538607034991
2012,MICHIGAN,LUCE,991,25,1580,2596,0.3817411402157165,0.6086286594761171,0.00963020030816641
2012,MICHIGAN,MACKINAC,2652,50,3397,6099,0.43482538121003445,0.5569765535333662,0.008198065256599442
2012,MICHIGAN,MACOMB,208016,4157,191913,404086,0.5147815069069456,0.47493107902773174,0.010287414065322728
2012,MICHIGAN,MANISTEE,6473,192,5737,12402,0.5219319464602483,0.46258667956781163,0.015481373971940009
2012,MICHIGAN,MARQUETTE,18115,473,13606,32194,0.5626824874200161,0.42262533391315155,0.014692178666832329
2012,MICHIGAN,MASON,6856,168,7580,14604,0.46946042180224595,0.5190358805806629,0.011503697617091208
2012,MICHIGAN,MECOSTA,7515,222,9176,16913,0.4443327617808786,0.5425412404659138,0.013125997753207592
2012,MICHIGAN,MENOMINEE,5242,117,5564,10923,0.47990478806188774,0.5093838689004853,0.010711343037627026
2012,MICHIGAN,MIDLAND,17450,385,23919,41754,0.4179240312305408,0.572855295301049,0.009220673468410212
2012,MICHIGAN,MISSAUKEE,2274,88,4665,7027,0.32360893695744986,0.6638679379536075,0.01252312508894265
2012,MICHIGAN,MONROE,36310,950,35593,72853,0.49840088946234196,0.48855915336362266,0.013039957174035386
2012,MICHIGAN,MONTCALM,11430,380,13621,25431,0.4494514568833314,0.5356061499744407,0.01494239314222799
2012,MICHIGAN,MONTMORENCY,2049,74,2928,5051,0.4056622450999802,0.5796871906553158,0.014650564244704019
2012,MICHIGAN,MUSKEGON,44436,843,30884,76163,0.5834329004897391,0.40549873298058114,0.011068366529679765
2012,MICHIGAN,NEWAYGO,8728,293,12457,21478,0.40636930812924854,0.5799888257752118,0.013641866095539622
2012,MICHIGAN,OAKLAND,349002,6091,296514,651607,0.5356019809486393,0.455050360109698,0.009347658941662689
2012,MICHIGAN,OCEANA,5063,148,6239,11450,0.4421834061135371,0.5448908296943231,0.012925764192139737
2012,MICHIGAN,OGEMAW,4791,133,5437,10361,0.4624071035614323,0.5247562976546666,0.012836598783901167
2012,MICHIGAN,ONTONAGON,1586,47,1906,3539,0.44814919468776493,0.5385702175755863,0.013280587736648771
2012,MICHIGAN,OSCEOLA,3981,156,6141,10278,0.38733216579100993,0.5974897840046701,0.015178050204319907
2012,MICHIGAN,OSCODA,1657,77,2308,4042,0.4099455714992578,0.5710044532409698,0.01904997525977239
2012,MICHIGAN,OTSEGO,4681,140,7011,11832,0.3956220419202164,0.5925456389452333,0.011832319134550372
2012,MICHIGAN,OTTAWA,42737,1409,88166,132312,0.3230016929681359,0.6663492351411815,0.01064907189068263
2012,MICHIGAN,PRESQUE ISLE,3192,94,3794,7080,0.45084745762711864,0.5358757062146893,0.01327683615819209
2012,MICHIGAN,ROSCOMMON,6198,133,6701,13032,0.47559852670349906,0.5141958256599141,0.010205647636586863
2012,MICHIGAN,SAGINAW,54381,961,42720,98062,0.5545573208786279,0.4356427566233607,0.009799922498011463
2012,MICHIGAN,SANILAC,7212,194,10963,18369,0.3926179977135391,0.5968207305786923,0.010561271707768523
2012,MICHIGAN,SCHOOLCRAFT,1865,41,2142,4048,0.46072134387351776,0.5291501976284585,0.010128458498023716
2012,MICHIGAN,SHIAWASSEE,17197,520,15962,33679,0.5106149232459396,0.47394518839633004,0.015439888357730337
2012,MICHIGAN,ST. CLAIR,33983,927,39271,74181,0.45810921934188,0.5293943193000903,0.012496461358029684
2012,MICHIGAN,ST. JOSEPH,10112,251,12978,23341,0.43322908187309883,0.5560173085986033,0.010753609528297845
2012,MICHIGAN,TUSCOLA,11425,338,14240,26003,0.4393723801099873,0.5476291197169557,0.012998500173056956
2012,MICHIGAN,VAN BUREN,16290,406,16141,32837,0.4960867314310077,0.49154916709809054,0.012364101470901726
2012,MICHIGAN,WASHTENAW,120890,2290,56412,179592,0.6731368880573745,0.31411198717092076,0.012751124771704753
2012,MICHIGAN,WAYNE,595846,6165,213814,815825,0.7303600649649128,0.2620831673459382,0.007556767689149021
2012,MICHIGAN,WEXFORD,6184,219,8450,14853,0.41634686595300613,0.5689086379855921,0.014744496061401737
2012,MINNESOTA,AITKIN,4412,197,4533,9142,0.48260774447604465,0.4958433603150295,0.021548895208925837
2012,MINNESOTA,ANOKA,88614,4421,93430,186465,0.47523127664709197,0.5010591800069718,0.023709543345936234
2012,MINNESOTA,BECKER,6829,349,9204,16382,0.416859968257844,0.5618361616408253,0.021303870101330728
2012,MINNESOTA,BELTRAMI,11818,596,9637,22051,0.5359394131785407,0.4370323341345064,0.027028252686952973
2012,MINNESOTA,BENTON,8173,597,10849,19619,0.4165859625872878,0.5529843519037667,0.03042968550894541
2012,MINNESOTA,BIG STONE,1345,59,1385,2789,0.48225170311939763,0.49659376120473286,0.021154535675869487
2012,MINNESOTA,BLUE EARTH,18164,1194,14916,34274,0.5299644045048725,0.4351986928867363,0.0348369026083912
2012,MINNESOTA,BROWN,5630,361,7938,13929,0.404192691506928,0.5698901572259315,0.025917151267140497
2012,MINNESOTA,CARLTON,11389,461,6586,18436,0.6177587329138642,0.35723584291603383,0.025005424170101976
2012,MINNESOTA,CARVER,20745,999,31155,52899,0.3921624227301083,0.5889525321839733,0.01888504508591845
2012,MINNESOTA,CASS,6858,326,8957,16141,0.4248807384920389,0.5549222476922124,0.020197013815748715
2012,MINNESOTA,CHIPPEWA,3083,151,2967,6201,0.4971778745363651,0.4784712143202709,0.024350911143363973
2012,MINNESOTA,CHISAGO,12524,690,16227,29441,0.42539315919975546,0.5511701368839373,0.02343670391630719
2012,MINNESOTA,CLAY,15208,758,12920,28886,0.5264834175725265,0.44727549678044726,0.026241085647026242
2012,MINNESOTA,CLEARWATER,1753,85,2359,4197,0.4176792947343341,0.5620681439123183,0.020252561353347628
2012,MINNESOTA,COOK,1993,108,1221,3322,0.5999397953040337,0.3675496688741722,0.0325105358217941
2012,MINNESOTA,COTTONWOOD,2433,113,3316,5862,0.4150460593654043,0.5656772432616854,0.01927669737291027
2012,MINNESOTA,CROW WING,14760,745,19415,34920,0.422680412371134,0.5559851088201604,0.021334478808705613
2012,MINNESOTA,DAKOTA,116255,5050,109516,230821,0.5036586792362914,0.47446289549044496,0.021878425273263696
2012,MINNESOTA,DODGE,4487,318,5522,10327,0.4344921080662341,0.5347148252154547,0.030793066718311224
2012,MINNESOTA,DOUGLAS,8653,416,11884,20953,0.4129718894669021,0.5671741516727915,0.0198539588603064
2012,MINNESOTA,FARIBAULT,3407,202,4104,7713,0.44172176844288863,0.5320886814469078,0.026189550110203554
2012,MINNESOTA,FILLMORE,5713,266,4913,10892,0.5245134043334557,0.45106500183621007,0.02442159383033419
2012,MINNESOTA,FREEBORN,9326,411,6969,16706,0.5582425475876931,0.41715551298934517,0.02460193942296181
2012,MINNESOTA,GOODHUE,12212,603,12986,25801,0.47331498779117087,0.5033138250455409,0.023371187163288246
2012,MINNESOTA,GRANT,1647,92,1748,3487,0.47232578147404647,0.5012905075996559,0.02638371092629768
2012,MINNESOTA,HENNEPIN,423982,16010,240073,680065,0.6234433473270937,0.35301478535140024,0.02354186732150603
2012,MINNESOTA,HOUSTON,5281,214,4951,10446,0.5055523645414512,0.4739613249090561,0.02048631054949263
2012,MINNESOTA,HUBBARD,4676,222,6622,11520,0.4059027777777778,0.5748263888888889,0.019270833333333334
2012,MINNESOTA,ISANTI,8024,518,11675,20217,0.396893703318989,0.5774842953949646,0.025622001286046397
2012,MINNESOTA,ITASCA,12852,566,10501,23919,0.5373134328358209,0.43902337054224677,0.023663196621932354
2012,MINNESOTA,JACKSON,2268,118,3044,5430,0.4176795580110497,0.5605893186003683,0.021731123388581953
2012,MINNESOTA,KANABEC,3593,229,4328,8150,0.44085889570552145,0.531042944785276,0.028098159509202456
2012,MINNESOTA,KANDIYOHI,9805,420,11240,21465,0.4567901234567901,0.5236431399953413,0.019566736547868623
2012,MINNESOTA,KITTSON,1241,84,1095,2420,0.5128099173553718,0.4524793388429752,0.03471074380165289
2012,MINNESOTA,KOOCHICHING,3451,166,2841,6458,0.534375967791886,0.43991947971508205,0.0257045524930319
2012,MINNESOTA,LAC QUI PARLE,1974,72,1938,3984,0.4954819277108434,0.4864457831325301,0.018072289156626505
2012,MINNESOTA,LAKE,4043,167,2610,6820,0.5928152492668621,0.38269794721407624,0.024486803519061583
2012,MINNESOTA,LAKE OF THE WOODS,859,69,1306,2234,0.3845120859444942,0.5846016114592659,0.03088630259623993
2012,MINNESOTA,LE SUEUR,6753,327,7715,14795,0.4564379858060155,0.5214599526867185,0.022102061507265968
2012,MINNESOTA,LINCOLN,1429,96,1595,3120,0.4580128205128205,0.5112179487179487,0.03076923076923077
2012,MINNESOTA,LYON,5465,329,6594,12388,0.4411527284468841,0.5322893122376493,0.02655795931546658
2012,MINNESOTA,MAHNOMEN,1276,35,871,2182,0.5847846012832264,0.39917506874427133,0.016040329972502293
2012,MINNESOTA,MARSHALL,1998,131,2569,4698,0.42528735632183906,0.5468284376330353,0.027884206045125585
2012,MINNESOTA,MARTIN,4054,257,6657,10968,0.36962071480671044,0.6069474835886215,0.023431801604668127
2012,MINNESOTA,MCLEOD,6968,516,11069,18553,0.37557268366301944,0.596615102678812,0.02781221365816849
2012,MINNESOTA,MEEKER,4969,332,6913,12214,0.40682822990011464,0.565989847715736,0.027181922384149338
2012,MINNESOTA,MILLE LACS,5829,311,6951,13091,0.4452677411962417,0.530975479336949,0.023756779466809257
2012,MINNESOTA,MORRISON,6153,402,10159,16714,0.36813449802560727,0.6078138087830561,0.024051693191336605
2012,MINNESOTA,MOWER,11129,472,6938,18539,0.6003020659150979,0.3742380926695075,0.025459841415394573
2012,MINNESOTA,MURRAY,2160,103,2504,4767,0.45311516677155445,0.525277952590728,0.02160688063771764
2012,MINNESOTA,NICOLLET,9652,491,8214,18357,0.5257939750503895,0.4474587350874326,0.026747289862177916
2012,MINNESOTA,NOBLES,3793,146,4581,8520,0.44518779342723,0.5376760563380282,0.017136150234741784
2012,MINNESOTA,NORMAN,1730,93,1384,3207,0.5394449641409417,0.43155597131275336,0.028999064546304958
2012,MINNESOTA,OLMSTED,39338,2146,36832,78316,0.5022983809183309,0.4702998110220134,0.027401808059655752
2012,MINNESOTA,OTTER TAIL,12165,645,18860,31670,0.3841174613198611,0.5955162614461635,0.020366277233975372
2012,MINNESOTA,PENNINGTON,3024,188,3305,6517,0.4640171858216971,0.507135184901028,0.02884762927727482
2012,MINNESOTA,PINE,6750,370,6845,13965,0.4833512352309345,0.49015395631936987,0.026494808449695668
2012,MINNESOTA,PIPESTONE,1725,95,2826,4646,0.3712871287128713,0.6082651743435213,0.020447696943607405
2012,MINNESOTA,POLK,6773,305,7615,14693,0.4609678077996325,0.5182740080310352,0.020758184169332335
2012,MINNESOTA,POPE,2981,123,3142,6246,0.4772654498879283,0.5030419468459815,0.0196926032660903
2012,MINNESOTA,RAMSEY,184938,7084,86800,278822,0.6632833850987369,0.3113097244837208,0.025406890417542374
2012,MINNESOTA,RED LAKE,928,69,978,1975,0.46987341772151897,0.4951898734177215,0.034936708860759495
2012,MINNESOTA,REDWOOD,3008,212,4570,7790,0.38613607188703464,0.5866495507060334,0.027214377406931965
2012,MINNESOTA,RENVILLE,3394,167,4149,7710,0.44020752269779506,0.5381322957198443,0.02166018158236057
2012,MINNESOTA,RICE,17054,829,14384,32267,0.528527597855394,0.44578051879629343,0.025691883348312516
2012,MINNESOTA,ROCK,1946,90,2810,4846,0.40156830375567476,0.5798596780850186,0.018572018159306643
2012,MINNESOTA,ROSEAU,2772,171,4409,7352,0.37704026115342765,0.5997007616974973,0.023258977149075082
2012,MINNESOTA,SAINT LOUIS,73378,3085,39131,115594,0.634790733083032,0.33852103050331334,0.026688236413654687
2012,MINNESOTA,SCOTT,29712,1612,40323,71647,0.4146998478652281,0.5628009546805868,0.0224991974541851
2012,MINNESOTA,SHERBURNE,17597,1064,27848,46509,0.37835687716355976,0.5987658302694102,0.022877292567030038
2012,MINNESOTA,SIBLEY,2916,206,4693,7815,0.3731285988483685,0.600511836212412,0.02635956493921945
2012,MINNESOTA,STEARNS,33551,1911,43015,78477,0.42752653643742755,0.5481223798055481,0.024351083757024352
2012,MINNESOTA,STEELE,8706,515,9903,19124,0.45523948964651745,0.5178309976992261,0.026929512654256433
2012,MINNESOTA,STEVENS,2742,144,2766,5652,0.4851380042462845,0.4893842887473461,0.025477707006369428
2012,MINNESOTA,SWIFT,2751,120,2248,5119,0.5374096503223286,0.43914827114670835,0.023442078530963077
2012,MINNESOTA,TODD,4819,265,6719,11803,0.40828602897568417,0.5692620520206727,0.022451919003643142
2012,MINNESOTA,TRAVERSE,943,43,861,1847,0.5105576610720086,0.466161342717921,0.023280996210070383
2012,MINNESOTA,WABASHA,5415,299,6049,11763,0.4603417495536853,0.5142395647368868,0.025418685709427867
2012,MINNESOTA,WADENA,2492,156,4143,6791,0.36695626564570755,0.6100721543218967,0.022971580032395817
2012,MINNESOTA,WASECA,4370,261,5116,9747,0.44834307992202727,0.5248794500872063,0.02677746999076639
2012,MINNESOTA,WASHINGTON,70203,2793,69137,142133,0.49392470432622965,0.48642468673707023,0.019650608936700134
2012,MINNESOTA,WATONWAN,2494,133,2517,5144,0.4848367029548989,0.4893079315707621,0.025855365474339035
2012,MINNESOTA,WILKIN,1258,80,1884,3222,0.3904407200496586,0.5847299813780261,0.024829298572315334
2012,MINNESOTA,WINONA,14980,772,11480,27232,0.5500881316098707,0.4215628672150411,0.02834900117508813
2012,MINNESOTA,WRIGHT,25741,1609,40466,67816,0.37957119263890526,0.5967028429869058,0.02372596437418898
2012,MINNESOTA,YELLOW MEDICINE,2465,143,2806,5414,0.4553010712966383,0.5182859253786479,0.026413003324713705
2012,MISSISSIPPI,ADAMS,9061,93,6293,15447,0.5865863921797113,0.40739302129863403,0.0060205865216546904
2012,MISSISSIPPI,ALCORN,3511,208,11111,14830,0.23674983142279163,0.7492245448415374,0.014025623735670937
2012,MISSISSIPPI,AMITE,3242,50,4414,7706,0.4207111341811575,0.5728004152608357,0.006488450558006748
2012,MISSISSIPPI,ATTALA,3927,39,5126,9092,0.43191816981962167,0.5637923449186097,0.004289485261768588
2012,MISSISSIPPI,BENTON,2051,24,2041,4116,0.49829931972789115,0.4958697764820214,0.0058309037900874635
2012,MISSISSIPPI,BOLIVAR,10582,145,4701,15428,0.6858957739175525,0.304705729841846,0.009398496240601503
2012,MISSISSIPPI,CALHOUN,2586,70,4412,7068,0.36587436332767403,0.624221844934918,0.009903791737408036
2012,MISSISSIPPI,CARROLL,2007,25,3960,5992,0.33494659546061417,0.6608811748998665,0.004172229639519359
2012,MISSISSIPPI,CHICKASAW,4378,131,3994,8503,0.5148771021992238,0.46971657062213334,0.015406327178642832
2012,MISSISSIPPI,CHOCTAW,1428,33,2812,4273,0.3341914345892815,0.6580856541071847,0.007722911303533817
2012,MISSISSIPPI,CLAIBORNE,4838,21,625,5484,0.8822027716994895,0.11396790663749089,0.0038293216630196935
2012,MISSISSIPPI,CLARKE,3111,93,5049,8253,0.3769538349691021,0.6117775354416576,0.011268629589240277
2012,MISSISSIPPI,CLAY,6712,69,4291,11072,0.6062138728323699,0.3875541907514451,0.0062319364161849715
2012,MISSISSIPPI,COAHOMA,7792,45,2712,10549,0.7386482131007679,0.25708597971371694,0.004265807185515215
2012,MISSISSIPPI,COPIAH,7749,92,6282,14123,0.548679459038448,0.4448063442611343,0.006514196700417758
2012,MISSISSIPPI,COVINGTON,3878,65,5405,9348,0.41484809584937954,0.5781985451433461,0.006953359007274283
2012,MISSISSIPPI,DESOTO,21575,660,43559,65794,0.3279174392801775,0.6620512508739399,0.010031309845882604
2012,MISSISSIPPI,FORREST,13272,390,16574,30236,0.4389469506548485,0.5481545177933589,0.012898531551792564
2012,MISSISSIPPI,FRANKLIN,1726,32,2735,4493,0.3841531270865791,0.6087246828399733,0.007122190073447585
2012,MISSISSIPPI,GEORGE,1359,121,8376,9856,0.13788555194805194,0.8498376623376623,0.012276785714285714
2012,MISSISSIPPI,GREENE,1325,66,4531,5922,0.223741979061128,0.765113137453563,0.011144883485309016
2012,MISSISSIPPI,GRENADA,5288,61,5986,11335,0.46651962946625497,0.5280988089986767,0.005381561535068372
2012,MISSISSIPPI,HANCOCK,3917,286,12964,17167,0.22817032678977106,0.7551698025281063,0.016659870682122678
2012,MISSISSIPPI,HARRISON,23119,739,39470,63328,0.3650675846387064,0.6232630116220313,0.011669403739262254
2012,MISSISSIPPI,HINDS,76112,715,29664,106491,0.7147270661370444,0.278558751443784,0.006714182419171573
2012,MISSISSIPPI,HOLMES,7812,41,1435,9288,0.8410852713178295,0.15450043066322136,0.004414298018949182
2012,MISSISSIPPI,HUMPHREYS,3903,16,1293,5212,0.748848810437452,0.2480813507290867,0.0030698388334612432
2012,MISSISSIPPI,ISSAQUENA,479,6,302,787,0.6086404066073697,0.38373570520965694,0.007623888182973317
2012,MISSISSIPPI,ITAWAMBA,1706,219,7393,9318,0.18308649924876583,0.7934106031337197,0.02350289761751449
2012,MISSISSIPPI,JACKSON,17299,609,35747,53655,0.3224117044077905,0.6662380020501352,0.011350293542074364
2012,MISSISSIPPI,JASPER,5097,50,4193,9340,0.5457173447537473,0.44892933618843683,0.0053533190578158455
2012,MISSISSIPPI,JEFFERSON,3951,14,468,4433,0.8912700203022784,0.10557184750733138,0.003158132190390255
2012,MISSISSIPPI,JEFFERSON DAVIS,4267,90,2507,6864,0.6216491841491841,0.36523892773892774,0.013111888111888112
2012,MISSISSIPPI,JONES,9211,261,20687,30159,0.30541463576378525,0.6859312311416161,0.008654133094598627
2012,MISSISSIPPI,KEMPER,3239,24,1789,5052,0.6411322248614411,0.35411718131433095,0.004750593824228029
2012,MISSISSIPPI,LAFAYETTE,8091,339,11075,19505,0.4148167136631633,0.5678031274032299,0.017380158933606768
2012,MISSISSIPPI,LAMAR,5494,294,19101,24889,0.220740085981759,0.7674474667523806,0.01181244726586042
2012,MISSISSIPPI,LAUDERDALE,13814,263,18700,32777,0.4214540684016231,0.5705220123867346,0.00802391921164231
2012,MISSISSIPPI,LAWRENCE,2468,38,4192,6698,0.3684681994625261,0.6258584652134965,0.005673335323977307
2012,MISSISSIPPI,LEAKE,4079,41,4863,8983,0.4540799287543137,0.5413558944673271,0.0045641767783591225
2012,MISSISSIPPI,LEE,12563,328,22415,35306,0.3558318699371212,0.6348779244321079,0.009290205630770973
2012,MISSISSIPPI,LEFLORE,9119,67,3587,12773,0.7139278164879042,0.2808267439129414,0.005245439599154467
2012,MISSISSIPPI,LINCOLN,5471,104,10839,16414,0.33331302546606556,0.6603509199463873,0.0063360545875472156
2012,MISSISSIPPI,LOWNDES,13388,252,13518,27158,0.49296708152293983,0.4977538846748656,0.009279033802194565
2012,MISSISSIPPI,MADISON,20722,342,28507,49571,0.4180266688184624,0.5750741360876319,0.006899195093905711
2012,MISSISSIPPI,MARION,4393,99,8237,12729,0.3451174483462959,0.6471050357451489,0.007777515908555267
2012,MISSISSIPPI,MARSHALL,9650,117,6473,16240,0.5942118226600985,0.39858374384236456,0.007204433497536946
2012,MISSISSIPPI,MONROE,7056,139,9723,16918,0.41707057571817,0.5747133230878354,0.008216101193994562
2012,MISSISSIPPI,MONTGOMERY,2675,23,2947,5645,0.4738706820194863,0.5220549158547387,0.004074402125775022
2012,MISSISSIPPI,NESHOBA,3089,89,7837,11015,0.2804357694053563,0.711484339536995,0.00807989105764866
2012,MISSISSIPPI,NEWTON,3319,64,6394,9777,0.33947018512836247,0.6539838396236064,0.006545975248031094
2012,MISSISSIPPI,NOXUBEE,4920,19,1325,6264,0.7854406130268199,0.21152618135376755,0.003033205619412516
2012,MISSISSIPPI,OKTIBBEHA,9095,261,8761,18117,0.5020146823425512,0.48357895898879505,0.014406358668653751
2012,MISSISSIPPI,PANOLA,9079,118,7629,16826,0.5395815999049091,0.4534054439557827,0.007012956139308213
2012,MISSISSIPPI,PEARL RIVER,4366,309,17549,22224,0.1964542836573074,0.7896418286537077,0.013903887688984881
2012,MISSISSIPPI,PERRY,1527,58,4137,5722,0.2668647326109752,0.722998951415589,0.010136315973435861
2012,MISSISSIPPI,PIKE,9650,143,8181,17974,0.5368866139979971,0.45515744964949373,0.00795593635250918
2012,MISSISSIPPI,PONTOTOC,2804,159,9448,12411,0.22592861171541376,0.7612601724276851,0.012811215856901136
2012,MISSISSIPPI,PRENTISS,2817,141,7075,10033,0.2807734476228446,0.7051729293332004,0.014053623043954949
2012,MISSISSIPPI,QUITMAN,2837,26,1116,3979,0.7129932143754713,0.2804724805227444,0.006534305101784368
2012,MISSISSIPPI,RANKIN,14988,713,48444,64145,0.2336581183256684,0.755226440096656,0.01111544157767558
2012,MISSISSIPPI,SCOTT,5031,82,6089,11202,0.44911622924477773,0.5435636493483307,0.007320121406891627
2012,MISSISSIPPI,SHARKEY,1782,13,737,2532,0.7037914691943128,0.2910742496050553,0.005134281200631911
2012,MISSISSIPPI,SIMPSON,4723,102,7424,12249,0.385582496530329,0.6060902930851498,0.008327210384521186
2012,MISSISSIPPI,SMITH,1979,71,6049,8099,0.24435115446351402,0.7468823311519941,0.008766514384491912
2012,MISSISSIPPI,STONE,2003,109,5420,7532,0.2659320233669676,0.7195963887413701,0.014471587891662242
2012,MISSISSIPPI,SUNFLOWER,8199,100,2929,11228,0.7302280014250089,0.2608656929105807,0.008906305664410403
2012,MISSISSIPPI,TALLAHATCHIE,3959,45,2499,6503,0.6087959403352299,0.38428417653390745,0.006919883130862679
2012,MISSISSIPPI,TATE,4933,141,7332,12406,0.39763017894567143,0.5910043527325488,0.011365468321779783
2012,MISSISSIPPI,TIPPAH,2317,130,6717,9164,0.2528371890004365,0.7329768659973811,0.014185945002182452
2012,MISSISSIPPI,TISHOMINGO,1643,160,6133,7936,0.20703125,0.7728074596774194,0.020161290322580645
2012,MISSISSIPPI,TUNICA,3475,24,883,4382,0.7930168872660885,0.20150616157005932,0.005476951163852123
2012,MISSISSIPPI,UNION,2742,125,8498,11365,0.2412670479542455,0.7477342718873735,0.010998680158380994
2012,MISSISSIPPI,WALTHALL,3422,78,4051,7551,0.4531850086081314,0.536485233743875,0.010329757647993643
2012,MISSISSIPPI,WARREN,10786,148,10457,21391,0.504230751250526,0.48885045112430464,0.006918797625169464
2012,MISSISSIPPI,WASHINGTON,13981,83,5651,19715,0.709155465381689,0.2866345422267309,0.004209992391580015
2012,MISSISSIPPI,WAYNE,4148,73,6111,10332,0.40147115756871854,0.5914634146341463,0.007065427797135114
2012,MISSISSIPPI,WEBSTER,1190,52,3992,5234,0.2273595720290409,0.7627053878486817,0.009935040122277417
2012,MISSISSIPPI,WILKINSON,3412,26,1415,4853,0.7030702658149598,0.2915722233669895,0.00535751081805069
2012,MISSISSIPPI,WINSTON,4607,54,5168,9829,0.4687150269610337,0.5257910265540747,0.005493946484891647
2012,MISSISSIPPI,YALOBUSHA,3030,48,3276,6354,0.4768649669499528,0.5155807365439093,0.007554296506137866
2012,MISSISSIPPI,YAZOO,6603,76,4941,11620,0.5682444061962134,0.42521514629948365,0.006540447504302926
2012,MISSOURI,ADAIR,4219,256,5651,10126,0.41665020738692476,0.5580683389294885,0.025281453683586808
2012,MISSOURI,ANDREW,2649,200,5457,8306,0.31892607753431257,0.6569949434143992,0.024078979051288224
2012,MISSOURI,ATCHISON,756,51,1902,2709,0.27906976744186046,0.7021040974529347,0.018826135105204873
2012,MISSOURI,AUDRAIN,3539,227,6186,9952,0.35560691318327975,0.6215836012861736,0.022809485530546625
2012,MISSOURI,BARRY,3667,307,9832,13806,0.2656091554396639,0.7121541358829494,0.022236708677386644
2012,MISSOURI,BARTON,1230,98,4418,5746,0.21406195614340412,0.7688827010093978,0.017055342847198052
2012,MISSOURI,BATES,2557,194,5020,7771,0.329043881096384,0.6459915068845709,0.02496461201904517
2012,MISSOURI,BENTON,2925,163,6069,9157,0.3194277601834662,0.6627716501037457,0.017800589712788032
2012,MISSOURI,BOLLINGER,1213,148,4095,5456,0.2223240469208211,0.7505498533724341,0.027126099706744868
2012,MISSOURI,BOONE,39847,2171,37404,79422,0.5017123718868828,0.47095263277177607,0.02733499534134119
2012,MISSOURI,BUCHANAN,15594,852,18660,35106,0.4441975730644334,0.5315330712698684,0.02426935566569817
2012,MISSOURI,BUTLER,4363,278,12248,16889,0.2583338267511398,0.7252057552252946,0.016460418023565633
2012,MISSOURI,CALDWELL,1312,134,2721,4167,0.3148548116150708,0.6529877609791217,0.032157427405807536
2012,MISSOURI,CALLAWAY,6071,416,11745,18232,0.3329859587538394,0.6441970162351909,0.022817025010969723
2012,MISSOURI,CAMDEN,6458,395,15092,21945,0.2942811574390522,0.6877192982456141,0.01799954431533379
2012,MISSOURI,CAPE GIRARDEAU,9728,618,25370,35716,0.2723709261955426,0.7103259043565909,0.0173031694478665
2012,MISSOURI,CARROLL,1154,78,3072,4304,0.26812267657992567,0.7137546468401487,0.01812267657992565
2012,MISSOURI,CARTER,754,67,1978,2799,0.2693819221150411,0.706680957484816,0.023937120400142908
2012,MISSOURI,CASS,17044,957,30912,48913,0.34845542084926295,0.6319792284259809,0.019565350724756198
2012,MISSOURI,CEDAR,1537,132,4376,6045,0.2542597187758478,0.723904052936311,0.02183622828784119
2012,MISSOURI,CHARITON,1339,80,2402,3821,0.35043182412980894,0.6286312483643025,0.02093692750588851
2012,MISSOURI,CHRISTIAN,9813,678,27473,37964,0.25848171952375937,0.7236592561373933,0.01785902433884733
2012,MISSOURI,CLARK,1398,97,1730,3225,0.43348837209302327,0.5364341085271318,0.03007751937984496
2012,MISSOURI,CLAY,47310,2088,56191,105589,0.4480580363484833,0.5321671765051283,0.019774787146388355
2012,MISSOURI,CLINTON,3688,242,5931,9861,0.37399858026569316,0.6014602981442044,0.024541121590102424
2012,MISSOURI,COLE,12005,567,24490,37062,0.3239166801575738,0.6607846311585991,0.0152986886838271
2012,MISSOURI,COOPER,2474,150,4887,7511,0.3293835707628811,0.6506457196112369,0.01997070962588204
2012,MISSOURI,CRAWFORD,2951,194,6434,9579,0.30806973588057207,0.6716776281449003,0.020252635974527613
2012,MISSOURI,DADE,939,62,2895,3896,0.2410164271047228,0.7430698151950719,0.01591375770020534
2012,MISSOURI,DALLAS,2122,165,4992,7279,0.291523560928699,0.6858084901772221,0.022667948894078856
2012,MISSOURI,DAVIESS,1125,106,2290,3521,0.31951150241408693,0.6503834138028969,0.030105083783016188
2012,MISSOURI,DEKALB,1194,100,3056,4350,0.27448275862068966,0.7025287356321839,0.022988505747126436
2012,MISSOURI,DENT,1585,175,4883,6643,0.23859701941893724,0.7350594610868584,0.026343519494204427
2012,MISSOURI,DOUGLAS,1710,198,4649,6557,0.2607899954247369,0.7090132682629251,0.03019673631233796
2012,MISSOURI,DUNKLIN,3636,165,6850,10651,0.34137639658248053,0.6431321002722749,0.015491503145244579
2012,MISSOURI,FRANKLIN,16347,1012,29396,46755,0.34963105550208534,0.6287242006202545,0.021644743877660143
2012,MISSOURI,GASCONADE,2099,140,4895,7134,0.29422483880011213,0.6861508270255117,0.019624334174376225
2012,MISSOURI,GENTRY,937,74,1988,2999,0.3124374791597199,0.6628876292097365,0.024674891630543514
2012,MISSOURI,GREENE,46219,2729,76900,125848,0.36726050473587185,0.6110546055559087,0.02168488970821944
2012,MISSOURI,GRUNDY,1212,132,3030,4374,0.27709190672153633,0.6927297668038409,0.03017832647462277
2012,MISSOURI,HARRISON,984,87,2624,3695,0.26630581867388364,0.710148849797023,0.02354533152909337
2012,MISSOURI,HENRY,3606,288,6229,10123,0.3562185122987257,0.61533142349106,0.028450064210214364
2012,MISSOURI,HICKORY,1733,112,2835,4680,0.3702991452991453,0.6057692307692307,0.023931623931623933
2012,MISSOURI,HOLT,551,34,1725,2310,0.23852813852813853,0.7467532467532467,0.01471861471861472
2012,MISSOURI,HOWARD,1723,127,3017,4867,0.35401684816108486,0.6198890486952948,0.0260941031436203
2012,MISSOURI,HOWELL,4395,407,11544,16346,0.26887311880582404,0.7062278233206901,0.02489905787348587
2012,MISSOURI,IRON,1669,110,2252,4031,0.41404118084842473,0.5586703051352022,0.027288514016373108
2012,MISSOURI,JACKSON,78283,3282,93199,174764,0.4479355015907166,0.5332848870476757,0.018779611361607655
2012,MISSOURI,JASPER,12809,1060,31349,45218,0.28327214825954267,0.6932858596134283,0.02344199212702906
2012,MISSOURI,JEFFERSON,41564,2069,53978,97611,0.4258126645562488,0.5529909538883937,0.02119638155535749
2012,MISSOURI,JOHNSON,7667,591,12763,21021,0.36473050758765047,0.6071547500118929,0.028114742400456687
2012,MISSOURI,KANSAS CITY,105670,1623,29509,136802,0.7724302276282511,0.21570591073229922,0.011863861639449715
2012,MISSOURI,KNOX,698,54,1205,1957,0.35666836995401124,0.6157383750638733,0.027593254982115484
2012,MISSOURI,LACLEDE,4093,335,10934,15362,0.2664366618929827,0.7117562817341492,0.021807056372868117
2012,MISSOURI,LAFAYETTE,5655,337,9803,15795,0.35802469135802467,0.6206394428616651,0.021335865780310225
2012,MISSOURI,LAWRENCE,4017,317,11421,15755,0.25496667724531896,0.7249127261186925,0.020120596635988575
2012,MISSOURI,LEWIS,1508,94,2677,4279,0.3524187894367843,0.6256134610890395,0.02196774947417621
2012,MISSOURI,LINCOLN,7734,586,14332,22652,0.3414268055800812,0.6327035140384955,0.025869680381423274
2012,MISSOURI,LINN,2041,165,3344,5550,0.36774774774774777,0.6025225225225225,0.02972972972972973
2012,MISSOURI,LIVINGSTON,1906,142,4006,6054,0.3148331681532871,0.6617112652791542,0.02345556656755864
2012,MISSOURI,MACON,2309,150,4701,7160,0.3224860335195531,0.6565642458100559,0.02094972067039106
2012,MISSOURI,MADISON,1588,115,3227,4930,0.32210953346855986,0.6545638945233265,0.02332657200811359
2012,MISSOURI,MARIES,1299,74,3165,4538,0.2862494490965183,0.6974438078448656,0.01630674305861613
2012,MISSOURI,MARION,4031,204,7923,12158,0.33155124198058894,0.6516696825135713,0.016779075505839777
2012,MISSOURI,MCDONALD,1920,203,5694,7817,0.24561852373033133,0.7284124344377638,0.025969041831904825
2012,MISSOURI,MERCER,353,47,1255,1655,0.21329305135951662,0.7583081570996979,0.0283987915407855
2012,MISSOURI,MILLER,2651,269,8099,11019,0.24058444504946003,0.7350031763317906,0.024412378618749432
2012,MISSOURI,MISSISSIPPI,1858,65,2997,4920,0.3776422764227642,0.6091463414634146,0.013211382113821139
2012,MISSOURI,MONITEAU,1608,131,4704,6443,0.24957318019556107,0.7300946763929846,0.02033214341145429
2012,MISSOURI,MONROE,1398,95,2564,4057,0.3445895982252896,0.6319940842987429,0.023416317475967462
2012,MISSOURI,MONTGOMERY,1740,97,3490,5327,0.32663788248545145,0.6551529941805895,0.018209123333959076
2012,MISSOURI,MORGAN,2773,182,5733,8688,0.3191758747697974,0.6598756906077348,0.02094843462246777
2012,MISSOURI,NEW MADRID,2814,152,4284,7250,0.38813793103448274,0.5908965517241379,0.020965517241379312
2012,MISSOURI,NEWTON,6425,477,18181,25083,0.2561495833831679,0.7248335526053502,0.01901686401148188
2012,MISSOURI,NODAWAY,3172,211,5593,8976,0.3533868092691622,0.6231060606060606,0.023507130124777183
2012,MISSOURI,OREGON,1419,116,2886,4421,0.3209681067631758,0.6527934856367338,0.026238407600090476
2012,MISSOURI,OSAGE,1473,117,5329,6919,0.2128920364214482,0.7701980054921231,0.016909958086428676
2012,MISSOURI,OZARK,1261,112,3080,4453,0.28317987873343814,0.6916685380642263,0.025151583202335504
2012,MISSOURI,PEMISCOT,2671,66,3598,6335,0.42162588792423045,0.5679558011049723,0.010418310970797158
2012,MISSOURI,PERRY,2184,134,5669,7987,0.27344434706397897,0.7097783898835608,0.01677726305246025
2012,MISSOURI,PETTIS,5904,429,10842,17175,0.34375545851528383,0.6312663755458515,0.02497816593886463
2012,MISSOURI,PHELPS,5798,497,11895,18190,0.31874656404617924,0.6539307311709731,0.027322704782847717
2012,MISSOURI,PIKE,2582,162,4577,7321,0.35268405955470566,0.6251878158721487,0.022128124573145745
2012,MISSOURI,PLATTE,19175,759,25618,45552,0.4209474885844749,0.5623902353354409,0.0166622760800843
2012,MISSOURI,POLK,3580,287,9252,13119,0.2728866529461087,0.7052366796249714,0.021876667428919888
2012,MISSOURI,PULASKI,4199,280,9092,13571,0.3094097708348685,0.6699579986736424,0.020632230491489205
2012,MISSOURI,PUTNAM,587,49,1673,2309,0.25422260718925943,0.7245560848852317,0.02122130792550888
2012,MISSOURI,RALLS,1736,69,3231,5036,0.34471803018268465,0.6415806195393169,0.013701350277998412
2012,MISSOURI,RANDOLPH,3031,246,6667,9944,0.30480691874497184,0.6704545454545454,0.024738535800482703
2012,MISSOURI,RAY,4275,277,5815,10367,0.4123661618597473,0.5609144400501591,0.026719398090093566
2012,MISSOURI,REYNOLDS,1157,114,1931,3202,0.3613366645846346,0.6030605871330419,0.03560274828232355
2012,MISSOURI,RIPLEY,1396,124,3743,5263,0.26524795743872315,0.7111913357400722,0.023560706821204636
2012,MISSOURI,SALINE,3790,214,5104,9108,0.41611769872639437,0.5603864734299517,0.023495827843653932
2012,MISSOURI,SCHUYLER,697,68,1174,1939,0.3594636410520887,0.6054667354306343,0.035069623517276945
2012,MISSOURI,SCOTLAND,643,47,1246,1936,0.33212809917355374,0.643595041322314,0.02427685950413223
2012,MISSOURI,SCOTT,5122,254,11623,16999,0.3013118418730514,0.6837461027119243,0.014942055415024413
2012,MISSOURI,SHANNON,1302,128,2262,3692,0.35265438786565545,0.6126760563380281,0.03466955579631636
2012,MISSOURI,SHELBY,966,78,2188,3232,0.2988861386138614,0.676980198019802,0.024133663366336634
2012,MISSOURI,ST. CHARLES,71838,3068,110784,185690,0.38687059076956215,0.5966072486402068,0.01652216059023103
2012,MISSOURI,ST. CLAIR,1460,147,3019,4626,0.3156074362300043,0.6526156506701254,0.031776913099870296
2012,MISSOURI,ST. FRANCOIS,8829,505,13248,22582,0.3909751129217961,0.5866619431405544,0.022362943937649454
2012,MISSOURI,ST. LOUIS CITY,118780,1884,22943,143607,0.8271184552285056,0.15976240712500087,0.013119137646493556
2012,MISSOURI,ST. LOUIS COUNTY,297097,6837,224742,528676,0.5619642276176713,0.4251034660169934,0.01293230636533529
2012,MISSOURI,STE. GENEVIEVE,3813,202,4055,8070,0.4724907063197026,0.5024783147459727,0.025030978934324658
2012,MISSOURI,STODDARD,3153,217,9496,12866,0.2450645111145655,0.7380693300170993,0.016866158868335146
2012,MISSOURI,STONE,3923,274,11787,15984,0.24543293293293295,0.737424924924925,0.01714214214214214
2012,MISSOURI,SULLIVAN,908,77,1610,2595,0.34990366088631986,0.6204238921001927,0.029672447013487476
2012,MISSOURI,TANEY,5479,434,15746,21659,0.2529664342767441,0.7269957061729535,0.020037859550302416
2012,MISSOURI,TEXAS,2871,275,7618,10764,0.26672240802675584,0.7077294685990339,0.025548123374210332
2012,MISSOURI,VERNON,2580,183,5758,8521,0.30278136368970776,0.6757422837695106,0.021476352540781597
2012,MISSOURI,WARREN,5219,307,9150,14676,0.3556146088852548,0.6234668847097302,0.02091850640501499
2012,MISSOURI,WASHINGTON,3417,207,5071,8695,0.39298447383553764,0.5832087406555492,0.02380678550891317
2012,MISSOURI,WAYNE,1813,117,3790,5720,0.31695804195804195,0.6625874125874126,0.020454545454545454
2012,MISSOURI,WEBSTER,4409,312,10708,15429,0.2857605807246095,0.6940177587659602,0.020221660509430292
2012,MISSOURI,WORTH,341,43,664,1048,0.32538167938931295,0.6335877862595419,0.04103053435114504
2012,MISSOURI,WRIGHT,1953,172,5830,7955,0.24550597108736644,0.732872407291012,0.021621621621621623
2012,MONTANA,BEAVERHEAD,1371,152,3289,4812,0.28491271820448877,0.6834995843724023,0.03158769742310889
2012,MONTANA,BIG HORN,2882,77,1667,4626,0.6230004323389537,0.3603545179420666,0.01664504971897968
2012,MONTANA,BLAINE,1616,65,1178,2859,0.565232598810773,0.4120321790835957,0.02273522210563134
2012,MONTANA,BROADWATER,764,95,2152,3011,0.2537363002324809,0.7147127200265693,0.03155097974094985
2012,MONTANA,CARBON,2146,167,3533,5846,0.3670886075949367,0.6043448511802942,0.028566541224769072
2012,MONTANA,CARTER,96,20,678,794,0.12090680100755667,0.853904282115869,0.02518891687657431
2012,MONTANA,CASCADE,15232,987,18345,34564,0.4406897349843768,0.5307545422983451,0.028555722717278093
2012,MONTANA,CHOUTEAU,978,85,1758,2821,0.3466855724920241,0.6231832683445586,0.03013115916341723
2012,MONTANA,CUSTER,1833,159,3373,5365,0.34165890027958995,0.6287045666356011,0.029636533084808948
2012,MONTANA,DANIELS,237,30,740,1007,0.23535253227408143,0.7348560079443893,0.029791459781529295
2012,MONTANA,DAWSON,1219,175,3029,4423,0.275604793126837,0.6848293013791544,0.03956590549400859
2012,MONTANA,DEER LODGE,2860,152,1448,4460,0.6412556053811659,0.32466367713004485,0.034080717488789235
2012,MONTANA,FALLON,237,40,1128,1405,0.1686832740213523,0.802846975088968,0.028469750889679714
2012,MONTANA,FERGUS,1640,174,4257,6071,0.2701367155328611,0.7012024378191402,0.028660846647998683
2012,MONTANA,FLATHEAD,13892,1275,28309,43476,0.3195326156960162,0.6511408593246849,0.029326524979298923
2012,MONTANA,GALLATIN,21961,1563,24358,47882,0.45864834384528635,0.5087089094022806,0.03264274675243307
2012,MONTANA,GARFIELD,66,12,622,700,0.09428571428571429,0.8885714285714286,0.017142857142857144
2012,MONTANA,GLACIER,2924,113,1415,4452,0.6567834681042228,0.31783468104222823,0.025381850853548965
2012,MONTANA,GOLDEN VALLEY,110,18,351,479,0.22964509394572025,0.732776617954071,0.037578288100208766
2012,MONTANA,GRANITE,533,65,1107,1705,0.3126099706744868,0.649266862170088,0.03812316715542522
2012,MONTANA,HILL,3403,253,3164,6820,0.49897360703812316,0.46392961876832844,0.037096774193548385
2012,MONTANA,JEFFERSON,2272,193,4055,6520,0.34846625766871164,0.6219325153374233,0.02960122699386503
2012,MONTANA,JUDITH BASIN,337,24,854,1215,0.2773662551440329,0.702880658436214,0.019753086419753086
2012,MONTANA,LAKE,5805,364,7135,13304,0.4363349368610944,0.5363048707155743,0.02736019242333133
2012,MONTANA,LEWIS AND CLARK,15620,895,16803,33318,0.4688156552013926,0.5043219881145327,0.026862356684074676
2012,MONTANA,LIBERTY,257,29,702,988,0.2601214574898785,0.7105263157894737,0.029352226720647773
2012,MONTANA,LINCOLN,2552,280,6057,8889,0.2870964112948588,0.6814039824502194,0.03149960625492181
2012,MONTANA,MADISON,1289,111,3130,4530,0.28454746136865344,0.6909492273730684,0.024503311258278145
2012,MONTANA,MCCONE,223,25,745,993,0.22457200402819738,0.7502517623363545,0.025176233635448138
2012,MONTANA,MEAGHER,269,33,670,972,0.2767489711934156,0.6893004115226338,0.033950617283950615
2012,MONTANA,MINERAL,700,101,1216,2017,0.34705007436787305,0.6028755577590481,0.05007436787307883
2012,MONTANA,MISSOULA,32824,1716,22652,57192,0.5739264232759826,0.39606938033291367,0.03000419639110365
2012,MONTANA,MUSSELSHELL,492,82,1833,2407,0.2044038221852929,0.7615288741171583,0.03406730369754882
2012,MONTANA,PARK,3783,276,4709,8768,0.4314552919708029,0.537066605839416,0.031478102189781025
2012,MONTANA,PETROLEUM,49,9,240,298,0.1644295302013423,0.8053691275167785,0.030201342281879196
2012,MONTANA,PHILLIPS,471,69,1688,2228,0.2114003590664273,0.7576301615798923,0.03096947935368043
2012,MONTANA,PONDERA,975,71,1673,2719,0.35858771607208534,0.6152997425524089,0.0261125413755057
2012,MONTANA,POWDER RIVER,170,24,833,1027,0.1655306718597858,0.8111002921129503,0.023369036027263874
2012,MONTANA,POWELL,888,82,1806,2776,0.31988472622478387,0.6505763688760807,0.029538904899135448
2012,MONTANA,PRAIRIE,167,16,520,703,0.2375533428165007,0.7396870554765291,0.02275960170697013
2012,MONTANA,RAVALLI,7285,614,14307,22206,0.3280644870755652,0.6442853282896515,0.02765018463478339
2012,MONTANA,RICHLAND,1002,133,3510,4645,0.21571582346609258,0.7556512378902045,0.028632938643702907
2012,MONTANA,ROOSEVELT,2086,72,1514,3672,0.568082788671024,0.41230936819172115,0.0196078431372549
2012,MONTANA,ROSEBUD,1422,97,2004,3523,0.4036332671019018,0.5688333806414987,0.02753335225659949
2012,MONTANA,SANDERS,1720,201,3980,5901,0.29147602101338754,0.6744619556007456,0.0340620233858668
2012,MONTANA,SHERIDAN,665,56,1207,1928,0.3449170124481328,0.6260373443983402,0.029045643153526972
2012,MONTANA,SILVER BOW,10857,469,5430,16756,0.6479470040582478,0.32406302220100264,0.02798997374074958
2012,MONTANA,STILLWATER,1248,117,3337,4702,0.2654189706507869,0.7096980008507018,0.024883028498511272
2012,MONTANA,SWEET GRASS,475,48,1594,2117,0.22437411431270665,0.7529522909777988,0.02267359470949457
2012,MONTANA,TETON,1082,86,2113,3281,0.3297775068576653,0.6440109722645535,0.026211520877781166
2012,MONTANA,TOOLE,582,80,1440,2102,0.2768791627021884,0.6850618458610847,0.038058991436726926
2012,MONTANA,TREASURE,114,22,319,455,0.25054945054945055,0.701098901098901,0.04835164835164835
2012,MONTANA,VALLEY,1385,137,2337,3859,0.35890126975900494,0.6055973050012957,0.0355014252396994
2012,MONTANA,WHEATLAND,272,27,693,992,0.27419354838709675,0.6985887096774194,0.02721774193548387
2012,MONTANA,WIBAUX,98,25,421,544,0.1801470588235294,0.7738970588235294,0.04595588235294118
2012,MONTANA,YELLOWSTONE,26403,1904,40500,68807,0.3837254930457657,0.5886029037743253,0.02767160317990902
2012,NEBRASKA,ADAMS,4062,292,8316,12670,0.3205998421468035,0.656353591160221,0.023046566692975532
2012,NEBRASKA,ANTELOPE,571,65,2596,3232,0.1766707920792079,0.8032178217821783,0.020111386138613862
2012,NEBRASKA,ARTHUR,30,5,227,262,0.11450381679389313,0.8664122137404581,0.019083969465648856
2012,NEBRASKA,BANNER,55,10,346,411,0.13381995133819952,0.8418491484184915,0.024330900243309004
2012,NEBRASKA,BLAINE,29,6,268,303,0.09570957095709572,0.8844884488448845,0.019801980198019802
2012,NEBRASKA,BOONE,615,53,2138,2806,0.21917320028510334,0.7619387027797576,0.018888096935138987
2012,NEBRASKA,BOX BUTTE,1692,144,2869,4705,0.3596174282678002,0.6097768331562168,0.030605738575982998
2012,NEBRASKA,BOYD,188,10,873,1071,0.17553688141923435,0.8151260504201681,0.009337068160597572
2012,NEBRASKA,BROWN,224,29,1302,1555,0.1440514469453376,0.8372990353697749,0.01864951768488746
2012,NEBRASKA,BUFFALO,5365,518,13570,19453,0.275792936822084,0.6975787796226803,0.026628283555235697
2012,NEBRASKA,BURT,1291,55,2029,3375,0.38251851851851854,0.6011851851851852,0.016296296296296295
2012,NEBRASKA,BUTLER,1045,76,2738,3859,0.2707955428867582,0.7095102358123866,0.019694221300855144
2012,NEBRASKA,CASS,4367,257,7556,12180,0.35853858784893267,0.6203612479474548,0.02110016420361248
2012,NEBRASKA,CEDAR,958,98,3278,4334,0.22104291647438856,0.7563451776649747,0.022611905860636824
2012,NEBRASKA,CHASE,254,29,1584,1867,0.13604713444027852,0.8484199250133905,0.015532940546331012
2012,NEBRASKA,CHERRY,436,71,2557,3064,0.1422976501305483,0.8345300261096605,0.023172323759791124
2012,NEBRASKA,CHEYENNE,1084,116,3449,4649,0.23316842331684234,0.7418799741879974,0.02495160249516025
2012,NEBRASKA,CLAY,667,48,2232,2947,0.22633186291143537,0.7573803868340685,0.016287750254496098
2012,NEBRASKA,COLFAX,969,49,2051,3069,0.31573802541544477,0.6682958618442489,0.01596611274030629
2012,NEBRASKA,CUMING,1031,69,2876,3976,0.2593058350100604,0.7233400402414487,0.017354124748490945
2012,NEBRASKA,CUSTER,1083,119,4296,5498,0.19698072026191343,0.7813750454710804,0.021644234267006183
2012,NEBRASKA,DAKOTA,2922,120,3094,6136,0.4762059973924381,0.5042372881355932,0.01955671447196871
2012,NEBRASKA,DAWES,1132,118,2478,3728,0.30364806866952787,0.6646995708154506,0.03165236051502146
2012,NEBRASKA,DAWSON,2199,200,5460,7859,0.27980659116935996,0.6947448784832676,0.02544853034737244
2012,NEBRASKA,DEUEL,215,39,763,1017,0.21140609636184857,0.7502458210422812,0.038348082595870206
2012,NEBRASKA,DIXON,870,71,1745,2686,0.3239017125837677,0.6496649292628444,0.02643335815338794
2012,NEBRASKA,DODGE,5673,282,8995,14950,0.3794648829431438,0.6016722408026756,0.0188628762541806
2012,NEBRASKA,DOUGLAS,106456,4251,113220,223927,0.4754049310712866,0.5056112036511899,0.01898386527752348
2012,NEBRASKA,DUNDY,176,17,792,985,0.17868020304568527,0.8040609137055837,0.017258883248730966
2012,NEBRASKA,FILLMORE,807,65,2007,2879,0.2803056616880861,0.6971170545328239,0.022577283779089963
2012,NEBRASKA,FRANKLIN,384,40,1112,1536,0.25,0.7239583333333334,0.026041666666666668
2012,NEBRASKA,FRONTIER,271,27,1007,1305,0.20766283524904214,0.7716475095785441,0.020689655172413793
2012,NEBRASKA,FURNAS,423,35,1782,2240,0.1888392857142857,0.7955357142857142,0.015625
2012,NEBRASKA,GAGE,3903,245,5513,9661,0.40399544560604495,0.5706448607804575,0.025359693613497568
2012,NEBRASKA,GARDEN,242,20,829,1091,0.22181484876260313,0.7598533455545371,0.01833180568285976
2012,NEBRASKA,GARFIELD,149,22,769,940,0.15851063829787235,0.8180851063829787,0.023404255319148935
2012,NEBRASKA,GOSPER,230,14,734,978,0.23517382413087934,0.7505112474437627,0.014314928425357873
2012,NEBRASKA,GRANT,30,11,322,363,0.08264462809917356,0.8870523415977961,0.030303030303030304
2012,NEBRASKA,GREELEY,340,25,820,1185,0.2869198312236287,0.6919831223628692,0.02109704641350211
2012,NEBRASKA,HALL,7161,422,12646,20229,0.3539967373572594,0.6251421226951407,0.020861139947599982
2012,NEBRASKA,HAMILTON,1146,125,3600,4871,0.23526996509956888,0.739067953192363,0.02566208170806816
2012,NEBRASKA,HARLAN,354,29,1395,1778,0.19910011248593926,0.7845894263217098,0.016310461192350956
2012,NEBRASKA,HAYES,51,12,476,539,0.09461966604823747,0.8831168831168831,0.022263450834879406
2012,NEBRASKA,HITCHCOCK,274,43,1178,1495,0.18327759197324414,0.7879598662207358,0.028762541806020066
2012,NEBRASKA,HOLT,882,135,3922,4939,0.17857865964770198,0.7940878720388743,0.02733346831342377
2012,NEBRASKA,HOOKER,59,6,330,395,0.14936708860759493,0.8354430379746836,0.015189873417721518
2012,NEBRASKA,HOWARD,914,66,1890,2870,0.3184668989547038,0.6585365853658537,0.022996515679442508
2012,NEBRASKA,JEFFERSON,1195,85,2166,3446,0.3467788740568775,0.628554846198491,0.024666279744631456
2012,NEBRASKA,JOHNSON,790,48,1225,2063,0.3829374697043141,0.5937954435288415,0.0232670867668444
2012,NEBRASKA,KEARNEY,773,58,2349,3180,0.2430817610062893,0.7386792452830189,0.018238993710691823
2012,NEBRASKA,KEITH,928,86,3044,4058,0.22868408082799407,0.7501232134056185,0.021192705766387383
2012,NEBRASKA,KEYA PAHA,80,11,393,484,0.1652892561983471,0.8119834710743802,0.022727272727272728
2012,NEBRASKA,KIMBALL,395,57,1235,1687,0.23414344991108477,0.7320687611144042,0.033787788974510964
2012,NEBRASKA,KNOX,1059,92,2885,4036,0.26238850346878095,0.714816650148662,0.022794846382556987
2012,NEBRASKA,LANCASTER,62015,2906,62434,127355,0.48694593851831497,0.4902359546150524,0.022818106866632642
2012,NEBRASKA,LINCOLN,4450,477,10728,15655,0.28425423187480037,0.6852762695624401,0.030469498562759503
2012,NEBRASKA,LOGAN,68,7,356,431,0.15777262180974477,0.8259860788863109,0.016241299303944315
2012,NEBRASKA,LOUP,62,6,290,358,0.17318435754189945,0.8100558659217877,0.01675977653631285
2012,NEBRASKA,MADISON,3485,338,10062,13885,0.25099027727763773,0.7246669067338855,0.024342815988476773
2012,NEBRASKA,MCPHERSON,41,13,237,291,0.140893470790378,0.8144329896907216,0.044673539518900345
2012,NEBRASKA,MERRICK,925,74,2490,3489,0.26511894525652047,0.7136715391229579,0.02120951562052164
2012,NEBRASKA,MORRILL,455,54,1681,2190,0.20776255707762556,0.7675799086757991,0.024657534246575342
2012,NEBRASKA,NANCE,481,34,1106,1621,0.29673041332510797,0.6822948797038865,0.020974706971005553
2012,NEBRASKA,NEMAHA,1128,74,2012,3214,0.3509645301804605,0.6260112009956441,0.023024268823895456
2012,NEBRASKA,NUCKOLLS,568,49,1574,2191,0.25924235508900045,0.7183934276586034,0.022364217252396165
2012,NEBRASKA,OTOE,2561,163,4258,6982,0.3668003437410484,0.6098539100544257,0.023345746204525925
2012,NEBRASKA,PAWNEE,400,42,899,1341,0.29828486204325133,0.6703952274422073,0.03131991051454139
2012,NEBRASKA,PERKINS,238,21,1135,1394,0.17073170731707318,0.8142037302725968,0.015064562410329985
2012,NEBRASKA,PHELPS,880,100,3400,4380,0.2009132420091324,0.776255707762557,0.0228310502283105
2012,NEBRASKA,PIERCE,637,87,2707,3431,0.18566015738851646,0.7889828038472748,0.025357038764208684
2012,NEBRASKA,PLATTE,3148,264,10061,13473,0.23365249016551623,0.7467527647888369,0.019594745045646848
2012,NEBRASKA,POLK,528,39,1890,2457,0.2148962148962149,0.7692307692307693,0.015873015873015872
2012,NEBRASKA,RED WILLOW,952,93,3891,4936,0.19286871961102106,0.788290113452188,0.018841166936790926
2012,NEBRASKA,RICHARDSON,1191,105,2443,3739,0.3185343674779353,0.6533832575554961,0.0280823749665686
2012,NEBRASKA,ROCK,103,14,672,789,0.13054499366286437,0.8517110266159695,0.017743979721166033
2012,NEBRASKA,SALINE,2289,112,2557,4958,0.4616780960064542,0.5157321500605083,0.022589753933037516
2012,NEBRASKA,SARPY,26671,1606,43213,71490,0.37307315708490696,0.6044621625402155,0.022464680374877605
2012,NEBRASKA,SAUNDERS,3307,235,6770,10312,0.3206943366951125,0.6565166795965865,0.022788983708301007
2012,NEBRASKA,SCOTTS BLUFF,4327,312,9648,14287,0.3028627423531882,0.6752992230699237,0.02183803457688808
2012,NEBRASKA,SEWARD,2386,184,5003,7573,0.3150666842730754,0.66063647167569,0.02429684405123465
2012,NEBRASKA,SHERIDAN,390,61,2021,2472,0.15776699029126215,0.8175566343042071,0.024676375404530743
2012,NEBRASKA,SHERMAN,552,51,927,1530,0.3607843137254902,0.6058823529411764,0.03333333333333333
2012,NEBRASKA,SIOUX,101,14,624,739,0.13667117726657646,0.8443843031123139,0.018944519621109608
2012,NEBRASKA,STANTON,614,81,1949,2644,0.23222390317700453,0.7371406959152799,0.030635400907715583
2012,NEBRASKA,THAYER,728,57,1874,2659,0.2737871380218127,0.7047762316660399,0.021436630312147424
2012,NEBRASKA,THOMAS,42,6,360,408,0.10294117647058823,0.8823529411764706,0.014705882352941176
2012,NEBRASKA,THURSTON,1247,29,939,2215,0.562979683972912,0.4239277652370203,0.01309255079006772
2012,NEBRASKA,VALLEY,498,40,1657,2195,0.22687927107061504,0.7548974943052392,0.018223234624145785
2012,NEBRASKA,WASHINGTON,3132,215,6899,10246,0.3056802654694515,0.6733359359750146,0.020983798555533867
2012,NEBRASKA,WAYNE,1074,115,2493,3682,0.29168929929386206,0.6770776751765345,0.031233025529603477
2012,NEBRASKA,WEBSTER,442,42,1258,1742,0.2537313432835821,0.722158438576349,0.024110218140068886
2012,NEBRASKA,WHEELER,93,10,345,448,0.20758928571428573,0.7700892857142857,0.022321428571428572
2012,NEBRASKA,YORK,1373,108,4874,6355,0.21605035405192763,0.766955153422502,0.016994492525570417
2012,NEVADA,CARSON CITY,10291,634,12394,23319,0.44131394999785584,0.5314979201509499,0.027188129851194304
2012,NEVADA,CHURCHILL,2961,243,7061,10265,0.28845591816853383,0.6878714076960546,0.023672674135411593
2012,NEVADA,CLARK,389936,12201,289053,691190,0.5641516804351915,0.41819615445825314,0.017652165106555363
2012,NEVADA,DOUGLAS,9297,502,16276,26075,0.3565484180249281,0.6241994247363375,0.01925215723873442
2012,NEVADA,ELKO,3511,461,12014,15986,0.21962967596647065,0.75153259101714,0.028837733016389342
2012,NEVADA,ESMERALDA,92,26,317,435,0.21149425287356322,0.728735632183908,0.059770114942528735
2012,NEVADA,EUREKA,107,38,663,808,0.13242574257425743,0.8205445544554455,0.04702970297029703
2012,NEVADA,HUMBOLDT,1737,197,3810,5744,0.3024025069637883,0.6633008356545961,0.0342966573816156
2012,NEVADA,LANDER,534,51,1580,2165,0.24665127020785219,0.7297921478060047,0.023556581986143188
2012,NEVADA,LINCOLN,400,61,1691,2152,0.18587360594795538,0.7857806691449815,0.028345724907063198
2012,NEVADA,LYON,7380,565,13520,21465,0.3438155136268344,0.6298625669694852,0.02632191940368041
2012,NEVADA,MINERAL,863,92,1080,2035,0.42407862407862407,0.5307125307125307,0.04520884520884521
2012,NEVADA,NYE,6320,636,10566,17522,0.360689419016094,0.6030133546398813,0.03629722634402466
2012,NEVADA,PERSHING,632,85,1167,1884,0.3354564755838641,0.6194267515923567,0.04511677282377919
2012,NEVADA,STOREY,920,73,1321,2314,0.3975799481417459,0.5708729472774416,0.031547104580812446
2012,NEVADA,WASHOE,95409,3993,88453,187855,0.5078864017460275,0.47085784248489526,0.021255755769077213
2012,NEVADA,WHITE PINE,983,120,2601,3704,0.2653887688984881,0.7022138228941684,0.032397408207343416
2012,NEW HAMPSHIRE,BELKNAP,15890,425,17571,33886,0.4689252198548073,0.518532727380039,0.01254205276515375
2012,NEW HAMPSHIRE,CARROLL,13977,408,14207,28592,0.48884303301622833,0.4968872411863458,0.014269725797425853
2012,NEW HAMPSHIRE,CHESHIRE,25380,827,15156,41363,0.6135918574571477,0.3664144283538428,0.0199937141890095
2012,NEW HAMPSHIRE,COOS,9095,265,6342,15702,0.5792255763596994,0.403897592663355,0.016876830976945614
2012,NEW HAMPSHIRE,GRAFTON,29826,971,18208,49005,0.6086317722681359,0.3715539230690746,0.019814304662789512
2012,NEW HAMPSHIRE,HILLSBOROUGH,102303,3378,99991,205672,0.49740849507954416,0.4861672954996305,0.01642420942082539
2012,NEW HAMPSHIRE,MERRIMACK,44756,1218,34524,80498,0.5559889686700291,0.4288802206265994,0.015130810703371512
2012,NEW HAMPSHIRE,ROCKINGHAM,80142,2356,87921,170419,0.47026446581660497,0.5159107845956143,0.013824749587780705
2012,NEW HAMPSHIRE,STRAFFORD,36026,1205,26729,63960,0.5632582864290181,0.41790181363352097,0.018839899937460915
2012,NEW HAMPSHIRE,SULLIVAN,12166,399,9269,21834,0.5572043601722085,0.42452138865988825,0.01827425116790327
2012,NEW JERSEY,ATLANTIC,65600,1057,46522,113179,0.5796128257008809,0.41104798593378633,0.009339188365332792
2012,NEW JERSEY,BERGEN,212754,3583,169070,385407,0.5520242237426928,0.43867911065445103,0.009296665602856202
2012,NEW JERSEY,BURLINGTON,126377,2158,87401,215936,0.5852521117368109,0.40475418642560756,0.009993701837581505
2012,NEW JERSEY,CAMDEN,153682,2270,69476,225428,0.681734300974147,0.30819596500878327,0.010069734017069752
2012,NEW JERSEY,CAPE MAY,21657,493,25781,47931,0.4518370157100832,0.5378773653793996,0.010285618910517201
2012,NEW JERSEY,CUMBERLAND,34055,579,20658,55292,0.6159118859871229,0.37361643637415903,0.010471677638718079
2012,NEW JERSEY,ESSEX,236618,1995,64406,303019,0.7808685263960345,0.21254772803025554,0.006583745573709899
2012,NEW JERSEY,GLOUCESTER,74013,1717,59456,135186,0.5474901247170565,0.43980885594662167,0.012701019336321808
2012,NEW JERSEY,HUDSON,153108,2027,42369,197504,0.7752146791963707,0.2145222375243033,0.010263083279325989
2012,NEW JERSEY,HUNTERDON,26876,931,38687,66494,0.40418684392576776,0.5818118928023581,0.014001263271874153
2012,NEW JERSEY,MERCER,104377,1779,47355,153511,0.679931731276586,0.3084795226400714,0.011588746083342562
2012,NEW JERSEY,MIDDLESEX,190555,3450,107310,301315,0.6324112639596435,0.3561389243814613,0.011449811658895177
2012,NEW JERSEY,MONMOUTH,133145,3320,147513,283978,0.4688567424237089,0.5194522110867743,0.011691046489516793
2012,NEW JERSEY,MORRIS,100146,2299,124947,227392,0.44041127216436815,0.5494784337179848,0.01011029411764706
2012,NEW JERSEY,OCEAN,102300,2501,146474,251275,0.4071236692866381,0.5829230922296289,0.009953238483732961
2012,NEW JERSEY,PASSAIC,115926,1539,64523,181988,0.6369980438270655,0.3545453546387674,0.008456601534167088
2012,NEW JERSEY,SALEM,14719,448,14334,29501,0.4989322395850988,0.4858818345140843,0.015185925900816922
2012,NEW JERSEY,SOMERSET,74592,1727,66603,142922,0.5219070541973944,0.466009431718,0.012083514084605588
2012,NEW JERSEY,SUSSEX,26104,1204,40625,67933,0.3842609630076693,0.5980156919317563,0.01772334506057439
2012,NEW JERSEY,UNION,139752,1765,68314,209831,0.6660217031801783,0.32556676563520165,0.008411531184620003
2012,NEW JERSEY,WARREN,18745,781,25744,45270,0.4140711287828584,0.5686768279213608,0.01725204329578087
2012,NEW MEXICO,BERNALILLO,150739,13822,106408,270969,0.5562961076728334,0.3926943672523425,0.05100952507482406
2012,NEW MEXICO,CATRON,560,69,1494,2123,0.263777673104098,0.7037211493170042,0.03250117757889778
2012,NEW MEXICO,CHAVES,6604,600,13088,20292,0.32544845259215455,0.644983244628425,0.02956830277942046
2012,NEW MEXICO,CIBOLA,4961,284,2998,8243,0.6018439888390149,0.36370253548465364,0.03445347567633143
2012,NEW MEXICO,COLFAX,2828,237,2699,5764,0.4906315058986815,0.4682512144344205,0.04111727966689799
2012,NEW MEXICO,CURRY,4022,352,9251,13625,0.29519266055045873,0.6789724770642201,0.0258348623853211
2012,NEW MEXICO,DE BACA,287,29,586,902,0.3181818181818182,0.6496674057649667,0.03215077605321508
2012,NEW MEXICO,DONA ANA,37139,1962,27322,66423,0.5591286150881472,0.41133342366349007,0.029537961248362766
2012,NEW MEXICO,EDDY,6142,544,12583,19269,0.3187503243551819,0.6530178006123826,0.02823187503243552
2012,NEW MEXICO,GRANT,7090,454,5358,12902,0.549527205084483,0.4152844520229422,0.035188342892574796
2012,NEW MEXICO,GUADALUPE,1488,90,557,2135,0.6969555035128806,0.2608899297423888,0.04215456674473068
2012,NEW MEXICO,HARDING,260,14,327,601,0.43261231281198004,0.5440931780366056,0.02329450915141431
2012,NEW MEXICO,HIDALGO,995,41,899,1935,0.5142118863049095,0.46459948320413436,0.02118863049095607
2012,NEW MEXICO,LEA,4080,387,12548,17015,0.23978842198060535,0.7374669409344696,0.022744637084925065
2012,NEW MEXICO,LINCOLN,2942,339,5961,9242,0.3183293659381086,0.6449902618480848,0.03668037221380654
2012,NEW MEXICO,LOS ALAMOS,5191,667,4796,10654,0.48723484137413176,0.45015956448282335,0.06260559414304487
2012,NEW MEXICO,LUNA,3583,247,3670,7500,0.47773333333333334,0.48933333333333334,0.032933333333333335
2012,NEW MEXICO,MCKINLEY,15841,542,5546,21929,0.7223767613662274,0.25290710930731,0.024716129326462676
2012,NEW MEXICO,MORA,1955,61,595,2611,0.7487552661815396,0.22788203753351208,0.023362696284948296
2012,NEW MEXICO,OTERO,6829,732,12451,20012,0.34124525284829105,0.6221766939836099,0.03657805316809914
2012,NEW MEXICO,QUAY,1383,122,2202,3707,0.3730779606150526,0.5940113299163744,0.03291070946857297
2012,NEW MEXICO,RIO ARRIBA,11465,481,3397,15343,0.7472463012448674,0.22140389754285342,0.03134980121227922
2012,NEW MEXICO,ROOSEVELT,1727,199,4043,5969,0.28932819567766793,0.6773328865806668,0.033338917741665273
2012,NEW MEXICO,SAN JUAN,15855,1533,28849,46237,0.34290719553604254,0.6239375392002077,0.03315526526374981
2012,NEW MEXICO,SAN MIGUEL,8850,356,2303,11509,0.7689634199322269,0.2001042662264315,0.03093231384134156
2012,NEW MEXICO,SANDOVAL,27236,2456,24387,54079,0.5036335731060115,0.4509513859353908,0.04541504095859761
2012,NEW MEXICO,SANTA FE,50872,2873,15500,69245,0.7346667629431728,0.22384287674200304,0.04149036031482418
2012,NEW MEXICO,SIERRA,1964,210,2928,5102,0.3849470795766366,0.5738925911407291,0.04116032928263426
2012,NEW MEXICO,SOCORRO,4058,413,2722,7193,0.5641595996107327,0.37842346725983594,0.05741693312943139
2012,NEW MEXICO,TAOS,11978,631,2730,15339,0.7808853249885912,0.1779777038920399,0.041136971119368926
2012,NEW MEXICO,TORRANCE,2428,445,3529,6402,0.37925648234926584,0.5512339893783192,0.06950952827241487
2012,NEW MEXICO,UNION,472,51,1236,1759,0.26833428084138716,0.7026719727117681,0.028993746446844798
2012,NEW MEXICO,VALENCIA,13511,1392,12825,27728,0.4872691863819965,0.46252885170225044,0.05020196191575303
2012,NEW YORK,ALBANY,83978,11578,40210,135766,0.6185495632190681,0.29617135365260816,0.08527908312832373
2012,NEW YORK,ALLEGANY,5866,1710,9377,16953,0.34601545449183035,0.5531174423405887,0.10086710316758096
2012,NEW YORK,BRONX,334600,9614,26680,370894,0.9021445480379839,0.07193429928766709,0.025921152674349007
2012,NEW YORK,BROOME,39971,6886,34708,81565,0.4900508796665236,0.4255256543860725,0.08442346594740391
2012,NEW YORK,CATTARAUGUS,12040,3072,14655,29767,0.4044747539221285,0.4923237141801324,0.1032015318977391
2012,NEW YORK,CAYUGA,16105,3418,11646,31169,0.516699284545542,0.37364047611408774,0.10966023934037024
2012,NEW YORK,CHAUTAUQUA,22463,6123,24266,52852,0.4250170286838719,0.4591311587073337,0.11585181260879437
2012,NEW YORK,CHEMUNG,16205,2667,16138,35010,0.4628677520708369,0.4609540131391031,0.07617823479005999
2012,NEW YORK,CHENANGO,8642,1750,8922,19314,0.44744744744744747,0.46194470332401366,0.09060784922853889
2012,NEW YORK,CLINTON,18072,2692,9892,30656,0.589509394572025,0.32267745302713985,0.08781315240083508
2012,NEW YORK,COLUMBIA,15241,3288,10600,29129,0.5232242782107178,0.3638985203748841,0.11287720141439803
2012,NEW YORK,CORTLAND,9965,1800,7859,19624,0.5077965756216878,0.4004790052996331,0.09172441907867916
2012,NEW YORK,DELAWARE,7881,1671,9086,18638,0.422845798905462,0.48749865865436204,0.08965554244017598
2012,NEW YORK,DUTCHESS,62063,13378,48264,123705,0.5017016288751465,0.39015399539226386,0.10814437573258963
2012,NEW YORK,ERIE,227325,37187,149683,414195,0.5488356933328504,0.3613829235022151,0.08978138316493439
2012,NEW YORK,ESSEX,9368,1273,6076,16717,0.5603876293593348,0.3634623437219597,0.07615002691870551
2012,NEW YORK,FRANKLIN,9532,1171,5231,15934,0.5982176477971632,0.32829170327601354,0.07349064892682315
2012,NEW YORK,FULTON,8331,1638,9830,19799,0.42077882721349563,0.49648972170311634,0.08273145108338804
2012,NEW YORK,GENESEE,9092,2840,12814,24746,0.3674129152186212,0.5178210619898166,0.11476602279156227
2012,NEW YORK,GREENE,8384,2351,9737,20472,0.40953497459945293,0.4756252442360297,0.11483978116451739
2012,NEW YORK,HAMILTON,1092,259,1771,3122,0.34977578475336324,0.5672645739910314,0.08295964125560538
2012,NEW YORK,HERKIMER,10826,2048,12166,25040,0.4323482428115016,0.4858626198083067,0.0817891373801917
2012,NEW YORK,JEFFERSON,16231,3042,16435,35708,0.45454800044807886,0.46026100593704494,0.08519099361487621
2012,NEW YORK,KINGS,580225,37352,112957,730534,0.7942477694398892,0.15462250901395416,0.051129721546156644
2012,NEW YORK,LEWIS,4530,863,5129,10522,0.4305265158715073,0.4874548564911614,0.08201862763733131
2012,NEW YORK,LIVINGSTON,11100,3029,12641,26770,0.41464325737766156,0.47220769518117295,0.11314904744116548
2012,NEW YORK,MADISON,13231,2852,12011,28094,0.4709546522389122,0.42752900975297214,0.10151633800811562
2012,NEW YORK,MONROE,185916,33463,114434,333813,0.556946553908925,0.3428086982831705,0.10024474780790442
2012,NEW YORK,MONTGOMERY,8106,2034,8046,18186,0.4457274826789838,0.442428241504454,0.11184427581656219
2012,NEW YORK,NASSAU,294661,35628,237862,568151,0.5186314905720486,0.41865982810907665,0.06270868131887473
2012,NEW YORK,NEW YORK,486172,26245,84810,597227,0.8140489294690294,0.14200630581001863,0.043944764720952
2012,NEW YORK,NIAGARA,41837,9018,38158,89013,0.4700099985395392,0.42867895700628,0.10131104445418085
2012,NEW YORK,ONEIDA,39031,7137,40532,86700,0.4501845444059977,0.4674971164936563,0.08231833910034603
2012,NEW YORK,ONONDAGA,117470,17890,69357,204717,0.5738165369754343,0.33879453098667917,0.08738893203788645
2012,NEW YORK,ONTARIO,22065,4869,20919,47853,0.46109961757883516,0.4371512757820826,0.1017491066390822
2012,NEW YORK,ORANGE,70742,11883,58003,140628,0.5030434906277556,0.4124569786955656,0.0844995306766789
2012,NEW YORK,ORLEANS,5505,1616,7585,14706,0.3743370053039576,0.5157758737930097,0.10988712090303278
2012,NEW YORK,OSWEGO,22178,4803,17610,44591,0.49736493911327395,0.3949227422574062,0.10771231862931982
2012,NEW YORK,OTSEGO,11530,2158,10451,24139,0.4776502754877998,0.4329508264633995,0.08939889804880069
2012,NEW YORK,PUTNAM,18539,4881,20925,44345,0.4180629157740444,0.471868305333183,0.11006877889277258
2012,NEW YORK,QUEENS,461391,24818,108864,595073,0.7753519316117519,0.18294226086547366,0.041705807522774516
2012,NEW YORK,RENSSELAER,35373,7714,24903,67990,0.5202676864244742,0.36627445212531257,0.11345786145021326
2012,NEW YORK,RICHMOND,75557,11696,66916,154169,0.4900920418501774,0.4340431604278422,0.07586479772198042
2012,NEW YORK,ROCKLAND,63908,8558,51976,124442,0.5135565162887128,0.4176724899953392,0.068770993715948
2012,NEW YORK,SARATOGA,50998,9597,44915,105510,0.48334754999526114,0.42569424699080655,0.09095820301393233
2012,NEW YORK,SCHENECTADY,35330,6651,22952,64933,0.544099302357815,0.3534720404108851,0.10242865723129996
2012,NEW YORK,SCHOHARIE,5119,1591,6497,13207,0.38759748618157036,0.49193609449534337,0.12046641932308624
2012,NEW YORK,SCHUYLER,3444,904,3798,8146,0.42278418855880184,0.4662410999263442,0.11097471151485391
2012,NEW YORK,SENECA,6715,1307,5244,13266,0.506181215136439,0.3952962460425147,0.09852253882104628
2012,NEW YORK,ST. LAWRENCE,20488,3160,13543,37191,0.5508859670350353,0.36414723992363746,0.0849667930413272
2012,NEW YORK,STEUBEN,15015,3353,20163,38531,0.3896862266746256,0.5232929329630687,0.08702084036230567
2012,NEW YORK,SUFFOLK,287519,55481,243258,586258,0.4904308342061004,0.41493335698617334,0.09463580880772629
2012,NEW YORK,SULLIVAN,14612,2456,11347,28415,0.5142354390286821,0.39933133908147106,0.08643322188984691
2012,NEW YORK,TIOGA,8544,1897,11160,21601,0.39553724364612747,0.5166427480209249,0.08782000833294755
2012,NEW YORK,TOMPKINS,24872,4607,10191,39670,0.6269725233173683,0.25689437862364506,0.11613309805898664
2012,NEW YORK,ULSTER,43837,8906,25572,78315,0.5597522824490838,0.32652748515610036,0.11372023239481581
2012,NEW YORK,WARREN,14276,2377,12925,29578,0.4826560281290148,0.4369801879775509,0.0803637838934343
2012,NEW YORK,WASHINGTON,10993,2309,9793,23095,0.47599047412859924,0.42403117557912967,0.09997835029227105
2012,NEW YORK,WAYNE,15732,4567,17248,37547,0.41899485977574774,0.4593709217780382,0.12163421844621408
2012,NEW YORK,WESTCHESTER,234778,22530,131139,388447,0.6044016300808089,0.33759817941701187,0.05800019050217919
2012,NEW YORK,WYOMING,5357,1730,9248,16335,0.32794612794612793,0.566146311600857,0.105907560453015
2012,NEW YORK,YATES,4259,914,4269,9442,0.45106968862529123,0.4521287862740945,0.09680152510061428
2012,NORTH CAROLINA,ALAMANCE,28875,731,38170,67776,0.42603576487252126,0.5631787063267233,0.01078552880075543
2012,NORTH CAROLINA,ALEXANDER,4611,332,12253,17196,0.2681437543614794,0.7125494301000233,0.019306815538497325
2012,NORTH CAROLINA,ALLEGHANY,1583,94,3390,5067,0.31241365699625023,0.6690349319123742,0.018551411091375567
2012,NORTH CAROLINA,ANSON,7019,71,4166,11256,0.6235785358919688,0.3701137171286425,0.00630774697938877
2012,NORTH CAROLINA,ASHE,4116,252,8242,12610,0.32640761300555116,0.6536082474226804,0.019984139571768436
2012,NORTH CAROLINA,AVERY,1882,111,5766,7759,0.24255703054517336,0.743137002191004,0.014305967263822657
2012,NORTH CAROLINA,BEAUFORT,9435,208,13977,23620,0.3994496189669771,0.5917442845046571,0.008806096528365791
2012,NORTH CAROLINA,BERTIE,6695,41,3387,10123,0.6613652079423096,0.33458460930554185,0.004050182752148573
2012,NORTH CAROLINA,BLADEN,8062,147,7748,15957,0.5052328131854359,0.4855549288713417,0.00921225794322241
2012,NORTH CAROLINA,BRUNSWICK,22038,581,34743,57362,0.38419162511767374,0.6056797182803947,0.010128656601931593
2012,NORTH CAROLINA,BUNCOMBE,70625,2370,54701,127696,0.5530713569728104,0.4283689387294825,0.018559704297707053
2012,NORTH CAROLINA,BURKE,13701,576,22267,36544,0.3749179071803853,0.6093202714535902,0.01576182136602452
2012,NORTH CAROLINA,CABARRUS,32849,1160,49557,83566,0.39309049134815593,0.5930282650838858,0.01388124356795826
2012,NORTH CAROLINA,CALDWELL,10898,605,23229,34732,0.31377404122998964,0.6688068639871012,0.017419094782909133
2012,NORTH CAROLINA,CAMDEN,1508,87,3109,4704,0.320578231292517,0.6609268707482994,0.018494897959183673
2012,NORTH CAROLINA,CARTERET,10301,441,24775,35517,0.29003012641833487,0.6975532843427091,0.012416589238955993
2012,NORTH CAROLINA,CASWELL,5348,97,5594,11039,0.4844641724793913,0.5067487997101187,0.00878702781049008
2012,NORTH CAROLINA,CATAWBA,24069,994,44538,69601,0.34581399692533155,0.6399045990718524,0.014281404002816052
2012,NORTH CAROLINA,CHATHAM,18361,408,16665,35434,0.5181746345318056,0.47031100073375853,0.011514364734435853
2012,NORTH CAROLINA,CHEROKEE,3378,211,9278,12867,0.26253205875495456,0.7210694023470895,0.016398538897956012
2012,NORTH CAROLINA,CHOWAN,3556,58,3891,7505,0.47381745502998,0.518454363757495,0.0077281812125249835
2012,NORTH CAROLINA,CLAY,1579,90,3973,5642,0.27986529599432824,0.7041829138603333,0.015951790145338533
2012,NORTH CAROLINA,CLEVELAND,17062,485,25793,43340,0.39367789570835254,0.595131518227965,0.01119058606368251
2012,NORTH CAROLINA,COLUMBUS,11050,252,12941,24243,0.45580167471022565,0.533803572165161,0.01039475312461329
2012,NORTH CAROLINA,CRAVEN,18763,479,26928,46170,0.40638943036603853,0.5832358674463938,0.010374702187567685
2012,NORTH CAROLINA,CUMBERLAND,75792,1183,50666,127641,0.5937903965026912,0.3969414216435158,0.009268181853793061
2012,NORTH CAROLINA,CURRITUCK,3562,246,7496,11304,0.3151096956829441,0.6631280962491154,0.02176220806794055
2012,NORTH CAROLINA,DARE,7393,333,10248,17974,0.4113163458328697,0.5701568932903083,0.018526760876822077
2012,NORTH CAROLINA,DAVIDSON,20624,928,49383,70935,0.29074504828363995,0.6961725523366462,0.013082399379713823
2012,NORTH CAROLINA,DAVIE,5735,248,14687,20670,0.27745524915336234,0.7105466860183841,0.011998064828253507
2012,NORTH CAROLINA,DUPLIN,9033,143,11416,20592,0.4386655011655012,0.5543900543900544,0.006944444444444444
2012,NORTH CAROLINA,DURHAM,111224,1742,33769,146735,0.7579922990424915,0.2301359593825604,0.011871741574948035
2012,NORTH CAROLINA,EDGECOMBE,18310,116,8546,26972,0.6788521429630728,0.31684710069701916,0.004300756339908052
2012,NORTH CAROLINA,FORSYTH,92323,1978,79768,174069,0.5303816302730526,0.45825505977514663,0.011363309951800724
2012,NORTH CAROLINA,FRANKLIN,13436,350,14603,28389,0.47328190496318995,0.5143893761668252,0.012328718869984854
2012,NORTH CAROLINA,GASTON,33171,1174,56138,90483,0.36659925068797455,0.6204259363637369,0.012974812948288629
2012,NORTH CAROLINA,GATES,2786,46,2564,5396,0.5163083765752409,0.47516679021497404,0.008524833209785025
2012,NORTH CAROLINA,GRAHAM,1119,78,2750,3947,0.2835064606029896,0.6967316949581961,0.019761844438814288
2012,NORTH CAROLINA,GRANVILLE,13598,272,12405,26275,0.5175261655566128,0.47212178877259753,0.010352045670789725
2012,NORTH CAROLINA,GREENE,3778,47,4411,8236,0.4587178241864983,0.5355755220981059,0.005706653715395823
2012,NORTH CAROLINA,GUILFORD,146365,2698,104789,253852,0.5765761152167405,0.4127956447063643,0.0106282400768952
2012,NORTH CAROLINA,HALIFAX,17176,140,8763,26079,0.658614210667587,0.33601748533302656,0.0053683039993864794
2012,NORTH CAROLINA,HARNETT,17331,519,25565,43415,0.39919382701831163,0.5888517793389382,0.011954393642750201
2012,NORTH CAROLINA,HAYWOOD,11833,508,15633,27974,0.42299992850504037,0.5588403517552013,0.018159719739758346
2012,NORTH CAROLINA,HENDERSON,18642,756,32994,52392,0.35581768208886855,0.6297526339899221,0.014429683921209345
2012,NORTH CAROLINA,HERTFORD,7843,68,3007,10918,0.7183550100751054,0.2754167429932222,0.006228246931672467
2012,NORTH CAROLINA,HOKE,10076,194,6819,17089,0.5896190531921118,0.3990286148984727,0.011352331909415413
2012,NORTH CAROLINA,HYDE,1163,27,1193,2383,0.48804028535459504,0.5006294586655476,0.011330255979857323
2012,NORTH CAROLINA,IREDELL,26076,990,49299,76365,0.34146533097623255,0.6455706148104499,0.01296405421331762
2012,NORTH CAROLINA,JACKSON,8095,352,8254,16701,0.48470151487934854,0.49422190288006707,0.021076582240584396
2012,NORTH CAROLINA,JOHNSTON,27290,974,48427,76691,0.35584358008110467,0.6314561030629409,0.012700316855954415
2012,NORTH CAROLINA,JONES,2352,41,2837,5230,0.4497131931166348,0.5424474187380497,0.007839388145315488
2012,NORTH CAROLINA,LEE,10801,280,13158,24239,0.4456041915920624,0.5428441767399645,0.011551631667973102
2012,NORTH CAROLINA,LENOIR,13948,158,13980,28086,0.49661753186641033,0.4977568895535142,0.0056255785800754824
2012,NORTH CAROLINA,LINCOLN,11024,484,25267,36775,0.299768864717879,0.6870700203942895,0.013161114887831407
2012,NORTH CAROLINA,MACON,5712,314,10835,16861,0.33876994247079056,0.6426072000474468,0.018622857481762647
2012,NORTH CAROLINA,MADISON,4484,225,5404,10113,0.4433896964303372,0.5343617126470879,0.022248590922574904
2012,NORTH CAROLINA,MARTIN,6583,74,5995,12652,0.5203129939930445,0.4738381283591527,0.005848877647802719
2012,NORTH CAROLINA,MCDOWELL,6031,293,11775,18099,0.3332228299906072,0.6505884303000166,0.016188739709376208
2012,NORTH CAROLINA,MECKLENBURG,272262,4970,171668,448900,0.6065092448206728,0.3824192470483404,0.011071508130986858
2012,NORTH CAROLINA,MITCHELL,1838,121,5806,7765,0.23670315518351578,0.7477141017385706,0.015582743077913715
2012,NORTH CAROLINA,MONTGOMERY,4706,121,6404,11231,0.41901878728519276,0.5702074614905173,0.010773751224289911
2012,NORTH CAROLINA,MOORE,16505,415,29495,46415,0.3555962512118927,0.6354626737046214,0.008941075083485942
2012,NORTH CAROLINA,NASH,24313,337,23842,48492,0.5013816712034975,0.4916687288624928,0.006949599934009733
2012,NORTH CAROLINA,NEW HANOVER,48668,1575,53385,103628,0.46964140965762147,0.5151599953680472,0.015198594974331263
2012,NORTH CAROLINA,NORTHAMPTON,7232,41,3483,10756,0.6723689103756043,0.32381926366679065,0.0038118259576050578
2012,NORTH CAROLINA,ONSLOW,18490,702,32243,51435,0.35948284242247497,0.6268688636142704,0.013648293963254593
2012,NORTH CAROLINA,ORANGE,53901,1317,21539,76757,0.7022291126542205,0.280612843128314,0.017158044217465508
2012,NORTH CAROLINA,PAMLICO,2647,64,4051,6762,0.3914522330671399,0.5990831115054718,0.009464655427388346
2012,NORTH CAROLINA,PASQUOTANK,10282,192,7633,18107,0.5678466891257524,0.42154967692052797,0.010603633953719556
2012,NORTH CAROLINA,PENDER,9632,278,14617,24527,0.39271007461165247,0.5959554776368899,0.011334447751457578
2012,NORTH CAROLINA,PERQUIMANS,2759,71,3822,6652,0.41476247745039085,0.5745640408899579,0.010673481659651233
2012,NORTH CAROLINA,PERSON,8418,192,10496,19106,0.4405945776195959,0.5493562231759657,0.010049199204438397
2012,NORTH CAROLINA,PITT,41843,799,36214,78856,0.5306254438470123,0.45924216292989756,0.01013239322309019
2012,NORTH CAROLINA,POLK,4013,140,6236,10389,0.38627394359418615,0.6002502647030513,0.013475791702762537
2012,NORTH CAROLINA,RANDOLPH,14773,782,45160,60715,0.2433171374454418,0.7438030140821873,0.012879848472370913
2012,NORTH CAROLINA,RICHMOND,9904,181,9332,19417,0.5100684966781687,0.48060977493948603,0.009321728382345367
2012,NORTH CAROLINA,ROBESON,24988,448,17510,42946,0.5818469706142597,0.4077213244539655,0.010431704931774788
2012,NORTH CAROLINA,ROCKINGHAM,16351,442,25227,42020,0.38912422655878154,0.6003569728700618,0.010518800571156593
2012,NORTH CAROLINA,ROWAN,22650,887,38775,62312,0.3634933881114392,0.6222717935550135,0.014234818333547311
2012,NORTH CAROLINA,RUTHERFORD,9374,374,18954,28702,0.3265974496550763,0.660372099505261,0.013030450839662741
2012,NORTH CAROLINA,SAMPSON,11566,186,14422,26174,0.4418888973790785,0.5510048139374952,0.007106288683426301
2012,NORTH CAROLINA,SCOTLAND,8215,110,5831,14156,0.5803192992370726,0.41191014410850524,0.007770556654422153
2012,NORTH CAROLINA,STANLY,8431,382,19904,28717,0.2935891632134276,0.6931086116237769,0.013302225162795557
2012,NORTH CAROLINA,STOKES,6018,364,15237,21619,0.27836625190804387,0.7047967066006753,0.01683704149128082
2012,NORTH CAROLINA,SURRY,9112,435,19923,29470,0.30919579233118427,0.6760434340006787,0.014760773668137089
2012,NORTH CAROLINA,SWAIN,2618,134,2976,5728,0.45705307262569833,0.5195530726256983,0.02339385474860335
2012,NORTH CAROLINA,TRANSYLVANIA,6826,303,9634,16763,0.4072063473125336,0.574718129213148,0.01807552347431844
2012,NORTH CAROLINA,TYRRELL,837,16,930,1783,0.46943353897924844,0.5215928210880538,0.0089736399326977
2012,NORTH CAROLINA,UNION,32473,1148,61107,94728,0.3428025504602652,0.6450785406637953,0.012118908875939532
2012,NORTH CAROLINA,VANCE,13323,102,7429,20854,0.6388702407212046,0.35623861129759277,0.004891147981202647
2012,NORTH CAROLINA,WAKE,267262,7569,211596,486427,0.5494390730777691,0.43500052423076846,0.015560402691462439
2012,NORTH CAROLINA,WARREN,6978,44,3140,10162,0.6866758512103917,0.30899429246211374,0.004329856327494588
2012,NORTH CAROLINA,WASHINGTON,3833,44,2622,6499,0.5897830435451608,0.403446684105247,0.006770272349592245
2012,NORTH CAROLINA,WATAUGA,13002,811,13861,27674,0.46982727469827273,0.5008672400086724,0.029305485293054854
2012,NORTH CAROLINA,WAYNE,23314,397,27641,51352,0.45400373890014023,0.5382653061224489,0.007730954977410812
2012,NORTH CAROLINA,WILKES,8148,482,20515,29145,0.2795676788471436,0.7038943214959684,0.016537999656887972
2012,NORTH CAROLINA,WILSON,20875,280,17954,39109,0.5337646066122888,0.45907591602955844,0.007159477358152855
2012,NORTH CAROLINA,YADKIN,3957,278,12578,16813,0.2353535954321061,0.7481115803247487,0.016534824243145185
2012,NORTH CAROLINA,YANCEY,3981,192,5278,9451,0.4212252671674955,0.5584594222833562,0.020315310549148237
2012,NORTH DAKOTA,ADAMS,328,40,918,1286,0.25505443234836706,0.713841368584759,0.03110419906687403
2012,NORTH DAKOTA,BARNES,2394,164,2964,5522,0.43353857298080406,0.5367620427381383,0.02969938428105759
2012,NORTH DAKOTA,BENSON,1235,54,868,2157,0.5725544738062124,0.40241075567918405,0.025034770514603615
2012,NORTH DAKOTA,BILLINGS,89,17,472,578,0.15397923875432526,0.8166089965397924,0.029411764705882353
2012,NORTH DAKOTA,BOTTINEAU,1183,92,2280,3555,0.3327707454289733,0.6413502109704642,0.025879043600562587
2012,NORTH DAKOTA,BOWMAN,414,43,1280,1737,0.23834196891191708,0.7369027058146229,0.02475532527345999
2012,NORTH DAKOTA,BURKE,230,24,769,1023,0.22482893450635386,0.7517106549364614,0.02346041055718475
2012,NORTH DAKOTA,BURLEIGH,14122,1314,27951,43387,0.3254892018346509,0.6442252287551571,0.030285569410191993
2012,NORTH DAKOTA,CASS,34712,2288,36855,73855,0.47000203100670235,0.4990183467605443,0.030979622232753367
2012,NORTH DAKOTA,CAVALIER,818,56,1195,2069,0.3953600773320445,0.5775737071048815,0.02706621556307395
2012,NORTH DAKOTA,DICKEY,853,72,1610,2535,0.33648915187376727,0.6351084812623274,0.028402366863905324
2012,NORTH DAKOTA,DIVIDE,385,44,733,1162,0.3313253012048193,0.6308089500860585,0.0378657487091222
2012,NORTH DAKOTA,DUNN,508,20,1506,2034,0.2497541789577188,0.7404129793510325,0.00983284169124877
2012,NORTH DAKOTA,EDDY,486,37,634,1157,0.42005185825410546,0.5479688850475367,0.03197925669835782
2012,NORTH DAKOTA,EMMONS,383,66,1435,1884,0.20329087048832273,0.7616772823779193,0.03503184713375796
2012,NORTH DAKOTA,FOSTER,607,45,1030,1682,0.36087990487514865,0.6123662306777645,0.0267538644470868
2012,NORTH DAKOTA,GOLDEN VALLEY,162,24,742,928,0.17456896551724138,0.7995689655172413,0.02586206896551724
2012,NORTH DAKOTA,GRAND FORKS,14032,937,15060,30029,0.4672816277598322,0.5015152019714276,0.031203170268740216
2012,NORTH DAKOTA,GRANT,334,54,1025,1413,0.23637650389242745,0.7254069355980184,0.03821656050955414
2012,NORTH DAKOTA,GRIGGS,536,36,771,1343,0.3991064780342517,0.5740878629932986,0.02680565897244974
2012,NORTH DAKOTA,HETTINGER,313,49,1000,1362,0.22980910425844348,0.7342143906020558,0.035976505139500736
2012,NORTH DAKOTA,KIDDER,393,65,870,1328,0.29593373493975905,0.6551204819277109,0.04894578313253012
2012,NORTH DAKOTA,LAMOURE,740,77,1377,2194,0.33728350045578853,0.6276207839562443,0.03509571558796718
2012,NORTH DAKOTA,LOGAN,232,31,810,1073,0.21621621621621623,0.7548928238583411,0.028890959925442685
2012,NORTH DAKOTA,MCHENRY,943,91,1678,2712,0.34771386430678464,0.6187315634218289,0.03355457227138643
2012,NORTH DAKOTA,MCINTOSH,459,36,1035,1530,0.3,0.6764705882352942,0.023529411764705882
2012,NORTH DAKOTA,MCKENZIE,927,66,2458,3451,0.26861779194436397,0.7122573167197913,0.019124891335844683
2012,NORTH DAKOTA,MCLEAN,1670,127,3141,4938,0.33819360064803566,0.6360874848116647,0.025718914540299717
2012,NORTH DAKOTA,MERCER,1166,137,3152,4455,0.2617283950617284,0.7075196408529741,0.030751964085297418
2012,NORTH DAKOTA,MORTON,4469,464,8680,13613,0.3282891353852935,0.6376257988687284,0.03408506574597811
2012,NORTH DAKOTA,MOUNTRAIL,1403,92,1962,3457,0.40584321666184553,0.5675441133931154,0.026612669945039052
2012,NORTH DAKOTA,NELSON,767,46,865,1678,0.4570917759237187,0.5154946364719905,0.027413587604290822
2012,NORTH DAKOTA,OLIVER,281,39,693,1013,0.2773938795656466,0.684106614017769,0.0384995064165844
2012,NORTH DAKOTA,PEMBINA,1253,103,1899,3255,0.3849462365591398,0.5834101382488479,0.03164362519201229
2012,NORTH DAKOTA,PIERCE,660,53,1465,2178,0.30303030303030304,0.6726354453627181,0.024334251606978878
2012,NORTH DAKOTA,RAMSEY,2164,170,2665,4999,0.4328865773154631,0.5331066213242649,0.03400680136027205
2012,NORTH DAKOTA,RANSOM,1343,73,1009,2425,0.5538144329896907,0.4160824742268041,0.030103092783505155
2012,NORTH DAKOTA,RENVILLE,398,29,851,1278,0.3114241001564945,0.6658841940532081,0.02269170579029734
2012,NORTH DAKOTA,RICHLAND,3198,186,4229,7613,0.42007093130172074,0.5554971758833575,0.024431892814921845
2012,NORTH DAKOTA,ROLETTE,3353,107,1092,4552,0.7365992970123023,0.2398945518453427,0.02350615114235501
2012,NORTH DAKOTA,SARGENT,1075,53,879,2007,0.5356253114100648,0.43796711509715996,0.026407573492775286
2012,NORTH DAKOTA,SHERIDAN,163,17,642,822,0.19829683698296838,0.781021897810219,0.02068126520681265
2012,NORTH DAKOTA,SIOUX,900,19,225,1144,0.7867132867132867,0.19667832167832167,0.016608391608391608
2012,NORTH DAKOTA,SLOPE,83,13,341,437,0.18993135011441648,0.7803203661327232,0.029748283752860413
2012,NORTH DAKOTA,STARK,2812,300,8521,11633,0.2417261239577065,0.7324851714948852,0.025788704547408236
2012,NORTH DAKOTA,STEELE,518,26,498,1042,0.4971209213051823,0.4779270633397313,0.02495201535508637
2012,NORTH DAKOTA,STUTSMAN,3585,288,5685,9558,0.37507846829880725,0.5947897049591965,0.030131826741996232
2012,NORTH DAKOTA,TOWNER,516,43,623,1182,0.4365482233502538,0.5270727580372251,0.03637901861252115
2012,NORTH DAKOTA,TRAILL,1811,114,1996,3921,0.4618719714358582,0.5090538128028564,0.029074215761285386
2012,NORTH DAKOTA,WALSH,2124,159,2813,5096,0.41679748822605966,0.5520015698587127,0.03120094191522763
2012,NORTH DAKOTA,WARD,8441,792,16230,25463,0.3315006087263873,0.6373954365157287,0.031103954757883988
2012,NORTH DAKOTA,WELLS,673,52,1654,2379,0.2828919714165616,0.6952501050861707,0.02185792349726776
2012,NORTH DAKOTA,WILLIAMS,2322,302,7184,9808,0.23674551386623166,0.732463295269168,0.030791190864600325
2012,OHIO,ADAMS,3976,248,6865,11089,0.3585535215078005,0.6190819731265218,0.0223645053656777
2012,OHIO,ALLEN,17913,820,29502,48235,0.3713693376179123,0.611630558722919,0.017000103659168653
2012,OHIO,ASHLAND,8281,530,15519,24330,0.34036169338265515,0.6378545006165228,0.02178380600082203
2012,OHIO,ASHTABULA,23803,963,18298,43064,0.5527354634961917,0.4249024707412224,0.02236206576258592
2012,OHIO,ATHENS,18307,788,8543,27638,0.6623851219335697,0.30910340835082134,0.028511469715608945
2012,OHIO,AUGLAIZE,5831,405,17169,23405,0.24913480025635548,0.7335612048707542,0.01730399487289041
2012,OHIO,BELMONT,14156,650,16758,31564,0.44848561652515523,0.5309213027499683,0.02059308072487644
2012,OHIO,BROWN,7107,369,11916,19392,0.36649133663366334,0.614480198019802,0.019028465346534653
2012,OHIO,BUTLER,62388,2627,105176,170191,0.3665763759540751,0.6179880252187249,0.015435598827200029
2012,OHIO,CARROLL,5543,404,7315,13262,0.4179610918413512,0.5515759312320917,0.03046297692655708
2012,OHIO,CHAMPAIGN,7044,332,11045,18421,0.3823896639704685,0.5995874273926497,0.01802290863688182
2012,OHIO,CLARK,31298,1030,31816,64144,0.48793339985033674,0.4960089797954602,0.016057620354203044
2012,OHIO,CLERMONT,30458,1607,64208,96273,0.3163711528673668,0.6669367320017034,0.016692115130929754
2012,OHIO,CLINTON,5791,344,12009,18144,0.3191688712522046,0.6618716931216931,0.01895943562610229
2012,OHIO,COLUMBIANA,19821,979,25251,46051,0.43041410609975894,0.5483268550085775,0.02125903889166359
2012,OHIO,COSHOCTON,6940,409,8390,15739,0.4409428807421056,0.5330707160556579,0.025986403202236483
2012,OHIO,CRAWFORD,7507,444,11852,19803,0.3790839771751755,0.5984951774983588,0.022420845326465686
2012,OHIO,CUYAHOGA,447232,6398,190651,644281,0.6941567421668495,0.29591280823119104,0.009930449601959393
2012,OHIO,DARKE,6826,467,18108,25401,0.268729577575686,0.7128853194756112,0.018385102948702808
2012,OHIO,DEFIANCE,7732,380,10176,18288,0.42279090113735784,0.5564304461942258,0.02077865266841645
2012,OHIO,DELAWARE,37292,1275,60194,98761,0.37759844473020726,0.609491600935592,0.012909954334200746
2012,OHIO,ERIE,21793,660,16952,39405,0.5530516431924882,0.43019921329780486,0.01674914350970689
2012,OHIO,FAIRFIELD,29890,1144,41034,72068,0.4147471832158517,0.5693789199089748,0.015873896875173446
2012,OHIO,FAYETTE,4249,151,6620,11020,0.3855716878402904,0.6007259528130672,0.013702359346642469
2012,OHIO,FRANKLIN,346336,8660,215987,570983,0.6065609659131708,0.37827220775399617,0.015166826332833026
2012,OHIO,FULTON,9073,457,11738,21268,0.426603347752492,0.5519089712243747,0.021487681023133347
2012,OHIO,GALLIA,4557,288,7750,12595,0.3618102421595871,0.6153235410877332,0.022866216752679636
2012,OHIO,GEAUGA,19659,749,30589,50997,0.3854932643096653,0.5998195972312097,0.014687138459125046
2012,OHIO,GREENE,32256,1415,49819,83490,0.38634567014013654,0.5967061923583663,0.016948137501497186
2012,OHIO,GUERNSEY,7450,371,8993,16814,0.44308314499821577,0.5348519091233496,0.022064945878434637
2012,OHIO,HAMILTON,219927,5641,193326,418894,0.5250182623766394,0.4615153236857057,0.013466413937654872
2012,OHIO,HANCOCK,12564,687,22443,35694,0.3519919314170449,0.6287611363254328,0.019246932257522272
2012,OHIO,HARDIN,4619,341,7489,12449,0.3710338179773476,0.6015744236484858,0.0273917583741666
2012,OHIO,HARRISON,2950,172,4019,7141,0.41310740792606077,0.5628063296457079,0.02408626242823134
2012,OHIO,HENRY,5658,321,8257,14236,0.3974431019949424,0.5800084293340826,0.022548468670974993
2012,OHIO,HIGHLAND,6049,380,11410,17839,0.33908851393015305,0.6396098436010987,0.021301642468748248
2012,OHIO,HOCKING,6157,286,6285,12728,0.48373664362036456,0.4937932118164676,0.02247014456316782
2012,OHIO,HOLMES,2608,226,8702,11536,0.2260748959778086,0.7543342579750347,0.01959084604715673
2012,OHIO,HURON,11006,597,13060,24663,0.4462555244698536,0.5295381745935207,0.024206300936625715
2012,OHIO,JACKSON,5166,311,7904,13381,0.38606980046334355,0.5906882893655183,0.02324191017113818
2012,OHIO,JEFFERSON,15385,650,17034,33069,0.46523934802987693,0.5151047809126372,0.01965587105748586
2012,OHIO,KNOX,10470,652,17266,28388,0.3688178103423982,0.608214738621953,0.022967451035648866
2012,OHIO,LAKE,57680,1980,58744,118404,0.4871457045370089,0.49613188743623526,0.016722408026755852
2012,OHIO,LAWRENCE,10744,438,14651,25833,0.41590214067278286,0.5671428018426045,0.016955057484612703
2012,OHIO,LICKING,34201,1686,45503,81390,0.4202113281729942,0.5590735962648974,0.020715075562108366
2012,OHIO,LOGAN,7062,442,13633,21137,0.3341060699247765,0.6449827317027014,0.020911198372522116
2012,OHIO,LORAIN,81464,2384,59405,143253,0.5686722093080075,0.4146859053562578,0.016641885335734678
2012,OHIO,LUCAS,136616,3662,69940,210218,0.6498777459589569,0.33270224243404467,0.01742001160699845
2012,OHIO,MADISON,6845,330,10342,17517,0.39076325854883825,0.5903978991836502,0.01883884226751156
2012,OHIO,MAHONING,77059,1610,42641,121310,0.6352238067760284,0.35150441018877254,0.013271783035199077
2012,OHIO,MARION,12504,583,14265,27352,0.4571512138052062,0.5215340742907283,0.021314711904065517
2012,OHIO,MEDINA,38785,1580,50418,90783,0.4272275646321448,0.5553682958263111,0.01740413954154412
2012,OHIO,MEIGS,4027,296,5895,10218,0.3941084360931689,0.5769230769230769,0.02896848698375416
2012,OHIO,MERCER,4745,355,16561,21661,0.21905729190711418,0.7645538063801302,0.016388901712755644
2012,OHIO,MIAMI,16383,947,34606,51936,0.3154459334565619,0.6663200862600123,0.018233980283425755
2012,OHIO,MONROE,3035,199,3548,6782,0.44750810970215277,0.5231495134178709,0.029342376879976408
2012,OHIO,MONTGOMERY,137139,4298,124841,266278,0.5150218944111041,0.46883708004416436,0.016141025544731447
2012,OHIO,MORGAN,2814,136,3179,6129,0.45912873225648554,0.5186816772719857,0.022189590471528797
2012,OHIO,MORROW,5933,386,9865,16184,0.36659663865546216,0.6095526445872467,0.02385071675729115
2012,OHIO,MUSKINGUM,17001,820,19264,37085,0.4584333288391533,0.5194553053795335,0.0221113657813132
2012,OHIO,NOBLE,2131,178,3563,5872,0.36290871934604907,0.6067779291553134,0.030313351498637602
2012,OHIO,OTTAWA,11503,415,10538,22456,0.5122461702885643,0.4692732454577841,0.018480584253651584
2012,OHIO,PAULDING,3538,236,5354,9128,0.3875985977212971,0.586546888694128,0.025854513584574933
2012,OHIO,PERRY,7033,324,7627,14984,0.4693673251468233,0.5090096102509343,0.021623064602242392
2012,OHIO,PICKAWAY,9684,402,14037,24123,0.40144260664096504,0.5818927994030593,0.016664593955975623
2012,OHIO,PIKE,5684,212,5685,11581,0.490803902944478,0.49089025127363783,0.01830584578188412
2012,OHIO,PORTAGE,39453,1544,35242,76239,0.5174910478888758,0.4622568501685489,0.02025210194257532
2012,OHIO,PREBLE,6211,423,13535,20169,0.30794784074569886,0.6710793792453765,0.020972780008924587
2012,OHIO,PUTNAM,4318,333,13721,18372,0.23503156978010015,0.7468430219899848,0.01812540822991509
2012,OHIO,RICHLAND,22687,1161,33867,57715,0.393086719223772,0.5867971931040458,0.020116087672182276
2012,OHIO,ROSS,14569,506,15008,30083,0.48429345477512215,0.49888641425389757,0.01682013097098029
2012,OHIO,SANDUSKY,14541,698,13755,28994,0.5015175553562806,0.47440849830999515,0.024073946333724217
2012,OHIO,SCIOTO,15077,592,15492,31161,0.4838419819646353,0.49715991142774624,0.018998106607618498
2012,OHIO,SENECA,11353,666,13243,25262,0.44941018129997623,0.5242261103633916,0.026363708336632097
2012,OHIO,SHELBY,6343,381,17142,23866,0.2657755803234727,0.7182602866001844,0.015964133076342913
2012,OHIO,STARK,89432,3464,88581,181477,0.4928007405897166,0.4881114411192603,0.019087818291023104
2012,OHIO,SUMMIT,153037,3674,111000,267711,0.5716500255872937,0.41462622006566785,0.013723754347038411
2012,OHIO,TRUMBULL,61672,1768,38279,101719,0.6062977418181461,0.3763210413000521,0.017381216881801827
2012,OHIO,TUSCARAWAS,18407,964,22242,41613,0.4423377309975248,0.5344964314036479,0.023165837598827288
2012,OHIO,UNION,8805,473,16289,25567,0.3443892517698596,0.637110337544491,0.01850041068564947
2012,OHIO,VAN WERT,4029,252,9585,13866,0.2905668541756815,0.6912591951536131,0.018173950670705322
2012,OHIO,VINTON,2436,175,2856,5467,0.44558258642765686,0.5224071702944942,0.03201024327784891
2012,OHIO,WARREN,32909,1534,76561,111004,0.2964667939894058,0.6897138841843538,0.013819321826240495
2012,OHIO,WASHINGTON,11651,564,17284,29499,0.39496254110308826,0.5859181667175158,0.01911929217939591
2012,OHIO,WAYNE,19808,1005,30251,51064,0.3879053736487545,0.5924134419551935,0.01968118439605201
2012,OHIO,WILLIAMS,7266,393,10047,17706,0.4103693663165029,0.5674347678752966,0.02219586580820061
2012,OHIO,WOOD,32802,1442,29704,63948,0.5129480202664665,0.46450240820666794,0.02254957152686558
2012,OHIO,WYANDOT,4137,255,6180,10572,0.391316685584563,0.5845629965947786,0.024120317820658342
2012,OKLAHOMA,ADAIR,2127,0,4381,6508,0.3268285187461586,0.6731714812538414,0.0
2012,OKLAHOMA,ALFALFA,322,0,1761,2083,0.15458473355736918,0.8454152664426309,0.0
2012,OKLAHOMA,ATOKA,1243,0,3538,4781,0.25998745032419995,0.7400125496758,0.0
2012,OKLAHOMA,BEAVER,244,0,2062,2306,0.10581092801387684,0.8941890719861232,0.0
2012,OKLAHOMA,BECKHAM,1417,0,5508,6925,0.20462093862815883,0.7953790613718411,0.0
2012,OKLAHOMA,BLAINE,992,0,2824,3816,0.259958071278826,0.740041928721174,0.0
2012,OKLAHOMA,BRYAN,3681,0,9520,13201,0.2788425119309143,0.7211574880690856,0.0
2012,OKLAHOMA,CADDO,3164,0,5687,8851,0.3574737317817196,0.6425262682182804,0.0
2012,OKLAHOMA,CANADIAN,10537,0,35625,46162,0.22826134049651228,0.7717386595034877,0.0
2012,OKLAHOMA,CARTER,4908,0,12214,17122,0.2866487559864502,0.7133512440135498,0.0
2012,OKLAHOMA,CHEROKEE,6144,0,8162,14306,0.42947015238361524,0.5705298476163847,0.0
2012,OKLAHOMA,CHOCTAW,1494,0,3572,5066,0.2949072246348204,0.7050927753651797,0.0
2012,OKLAHOMA,CIMARRON,115,0,1082,1197,0.0960735171261487,0.9039264828738512,0.0
2012,OKLAHOMA,CLEVELAND,34771,0,59116,93887,0.3703494626519113,0.6296505373480886,0.0
2012,OKLAHOMA,COAL,649,0,1710,2359,0.2751165748198389,0.7248834251801611,0.0
2012,OKLAHOMA,COMANCHE,12521,0,17664,30185,0.4148086798078516,0.5851913201921484,0.0
2012,OKLAHOMA,COTTON,657,0,1796,2453,0.2678353037097432,0.7321646962902568,0.0
2012,OKLAHOMA,CRAIG,1747,0,3559,5306,0.32924990576705615,0.6707500942329438,0.0
2012,OKLAHOMA,CREEK,7128,0,18986,26114,0.2729570345408593,0.7270429654591407,0.0
2012,OKLAHOMA,CUSTER,2359,0,7446,9805,0.24059153493115756,0.7594084650688424,0.0
2012,OKLAHOMA,DELAWARE,4196,0,10080,14276,0.2939198655085458,0.7060801344914542,0.0
2012,OKLAHOMA,DEWEY,301,0,1792,2093,0.14381270903010032,0.8561872909698997,0.0
2012,OKLAHOMA,ELLIS,226,0,1575,1801,0.1254858411993337,0.8745141588006663,0.0
2012,OKLAHOMA,GARFIELD,4733,0,15177,19910,0.2377197388247112,0.7622802611752888,0.0
2012,OKLAHOMA,GARVIN,2559,0,6925,9484,0.2698228595529312,0.7301771404470687,0.0
2012,OKLAHOMA,GRADY,4786,0,14833,19619,0.2439471940465875,0.7560528059534125,0.0
2012,OKLAHOMA,GRANT,393,0,1675,2068,0.19003868471953578,0.8099613152804642,0.0
2012,OKLAHOMA,GREER,488,0,1344,1832,0.2663755458515284,0.7336244541484717,0.0
2012,OKLAHOMA,HARMON,264,0,659,923,0.28602383531960995,0.71397616468039,0.0
2012,OKLAHOMA,HARPER,173,0,1261,1434,0.1206415620641562,0.8793584379358438,0.0
2012,OKLAHOMA,HASKELL,1175,0,3069,4244,0.276861451460886,0.7231385485391141,0.0
2012,OKLAHOMA,HUGHES,1370,0,2838,4208,0.3255703422053232,0.6744296577946768,0.0
2012,OKLAHOMA,JACKSON,1954,0,5965,7919,0.24674832680894052,0.7532516731910595,0.0
2012,OKLAHOMA,JEFFERSON,605,0,1634,2239,0.2702099151406878,0.7297900848593122,0.0
2012,OKLAHOMA,JOHNSTON,1137,0,2649,3786,0.30031695721077656,0.6996830427892234,0.0
2012,OKLAHOMA,KAY,4627,0,11499,16126,0.2869279424531812,0.7130720575468188,0.0
2012,OKLAHOMA,KINGFISHER,898,0,4870,5768,0.15568654646324548,0.8443134535367545,0.0
2012,OKLAHOMA,KIOWA,1106,0,2316,3422,0.32320280537697255,0.6767971946230275,0.0
2012,OKLAHOMA,LATIMER,1170,0,2628,3798,0.3080568720379147,0.6919431279620853,0.0
2012,OKLAHOMA,LE FLORE,4662,0,11177,15839,0.29433676368457606,0.7056632363154239,0.0
2012,OKLAHOMA,LINCOLN,3273,0,9553,12826,0.2551847809137689,0.744815219086231,0.0
2012,OKLAHOMA,LOGAN,4724,0,12314,17038,0.27726258950581056,0.7227374104941895,0.0
2012,OKLAHOMA,LOVE,1034,0,2436,3470,0.2979827089337176,0.7020172910662824,0.0
2012,OKLAHOMA,MAJOR,446,0,2700,3146,0.1417673235855054,0.8582326764144946,0.0
2012,OKLAHOMA,MARSHALL,1396,0,3744,5140,0.2715953307392996,0.7284046692607004,0.0
2012,OKLAHOMA,MAYES,4823,0,9637,14460,0.33354080221300136,0.6664591977869986,0.0
2012,OKLAHOMA,MCCLAIN,3194,0,11112,14306,0.22326296658744582,0.7767370334125542,0.0
2012,OKLAHOMA,MCCURTAIN,2440,0,7635,10075,0.2421836228287841,0.7578163771712159,0.0
2012,OKLAHOMA,MCINTOSH,2779,0,4509,7288,0.38131174533479695,0.618688254665203,0.0
2012,OKLAHOMA,MURRAY,1540,0,3606,5146,0.29926156237854645,0.7007384376214536,0.0
2012,OKLAHOMA,MUSKOGEE,9952,0,13404,23356,0.4261003596506251,0.5738996403493749,0.0
2012,OKLAHOMA,NOBLE,1143,0,3488,4631,0.24681494277693802,0.753185057223062,0.0
2012,OKLAHOMA,NOWATA,1244,0,2832,4076,0.30520117762512267,0.6947988223748773,0.0
2012,OKLAHOMA,OKFUSKEE,1256,0,2335,3591,0.34976329713171816,0.6502367028682818,0.0
2012,OKLAHOMA,OKLAHOMA,106982,0,149728,256710,0.4167426278680223,0.5832573721319777,0.0
2012,OKLAHOMA,OKMULGEE,5432,0,7731,13163,0.412671883309276,0.587328116690724,0.0
2012,OKLAHOMA,OSAGE,6704,0,11242,17946,0.37356513986403656,0.6264348601359635,0.0
2012,OKLAHOMA,OTTAWA,3509,0,6466,9975,0.35177944862155386,0.6482205513784461,0.0
2012,OKLAHOMA,PAWNEE,1813,0,4232,6045,0.29991728701406123,0.7000827129859388,0.0
2012,OKLAHOMA,PAYNE,9198,0,16481,25679,0.3581915183613069,0.6418084816386931,0.0
2012,OKLAHOMA,PITTSBURG,4831,0,10841,15672,0.308256763654926,0.6917432363450741,0.0
2012,OKLAHOMA,PONTOTOC,3947,0,8945,12892,0.3061588582066398,0.6938411417933602,0.0
2012,OKLAHOMA,POTTAWATOMIE,7188,0,16250,23438,0.3066814574622408,0.6933185425377592,0.0
2012,OKLAHOMA,PUSHMATAHA,1043,0,3087,4130,0.25254237288135595,0.747457627118644,0.0
2012,OKLAHOMA,ROGER MILLS,272,0,1402,1674,0.16248506571087215,0.8375149342891278,0.0
2012,OKLAHOMA,ROGERS,9148,0,27553,36701,0.24925751341925287,0.7507424865807472,0.0
2012,OKLAHOMA,SEMINOLE,2600,0,4856,7456,0.3487124463519313,0.6512875536480687,0.0
2012,OKLAHOMA,SEQUOYAH,4193,0,9578,13771,0.30448042988889695,0.695519570111103,0.0
2012,OKLAHOMA,STEPHENS,3939,0,12908,16847,0.23381017391820502,0.766189826081795,0.0
2012,OKLAHOMA,TEXAS,862,0,4930,5792,0.14882596685082872,0.8511740331491713,0.0
2012,OKLAHOMA,TILLMAN,906,0,1815,2721,0.33296582138919517,0.6670341786108048,0.0
2012,OKLAHOMA,TULSA,82744,0,145062,227806,0.3632213374537984,0.6367786625462016,0.0
2012,OKLAHOMA,WAGONER,7791,0,20900,28691,0.27154856923774007,0.7284514307622599,0.0
2012,OKLAHOMA,WASHINGTON,5532,0,15668,21200,0.2609433962264151,0.739056603773585,0.0
2012,OKLAHOMA,WASHITA,822,0,3494,4316,0.19045412418906396,0.8095458758109361,0.0
2012,OKLAHOMA,WOODS,671,0,2727,3398,0.19746909947027663,0.8025309005297233,0.0
2012,OKLAHOMA,WOODWARD,1133,0,5945,7078,0.16007346708109635,0.8399265329189036,0.0
2012,OREGON,BAKER,2369,377,5702,8448,0.2804214015151515,0.6749526515151515,0.04462594696969697
2012,OREGON,BENTON,27776,2035,14991,44802,0.6199723226641668,0.3346055979643766,0.04542207937145663
2012,OREGON,CLACKAMAS,95493,5247,88592,189332,0.5043679885069613,0.46791878816048,0.02771322333255868
2012,OREGON,CLATSOP,9861,708,7249,17818,0.553429116623639,0.40683578403861265,0.039735099337748346
2012,OREGON,COLUMBIA,12004,1099,10772,23875,0.5027853403141361,0.4511832460732984,0.04603141361256544
2012,OREGON,COOS,12845,1168,14673,28686,0.44777940458760374,0.5115038694833717,0.04071672592902461
2012,OREGON,CROOK,3104,336,6790,10230,0.30342130987292276,0.6637341153470185,0.03284457478005865
2012,OREGON,CURRY,4625,455,6598,11678,0.39604384312382257,0.5649940058229149,0.03896215105326255
2012,OREGON,DESCHUTES,36961,2476,42463,81900,0.4512942612942613,0.5184737484737485,0.030231990231990233
2012,OREGON,DOUGLAS,17145,1882,30776,49803,0.3442563700981869,0.617954741682228,0.03778888821958516
2012,OREGON,GILLIAM,371,51,639,1061,0.34967012252591895,0.6022620169651273,0.04806786050895382
2012,OREGON,GRANT,853,132,2926,3911,0.21810278701099464,0.7481462541549476,0.033750958834057786
2012,OREGON,HARNEY,832,144,2607,3583,0.2322076472229975,0.7276025676807145,0.040189785096288025
2012,OREGON,HOOD RIVER,6058,351,3429,9838,0.6157755641390527,0.34854645253100225,0.03567798332994511
2012,OREGON,JACKSON,44468,3639,49020,97127,0.4578335581249292,0.5047000319169747,0.0374664099580961
2012,OREGON,JEFFERSON,3301,232,4642,8175,0.4037920489296636,0.56782874617737,0.028379204892966362
2012,OREGON,JOSEPHINE,14953,1612,23673,40238,0.37161389731099953,0.5883244694070282,0.040061633281972264
2012,OREGON,KLAMATH,8302,952,18898,28152,0.29489911906791705,0.67128445581131,0.033816425120772944
2012,OREGON,LAKE,770,132,2808,3710,0.20754716981132076,0.7568733153638814,0.03557951482479784
2012,OREGON,LANE,102652,6689,62509,171850,0.5973348850741926,0.3637416351469305,0.038923479778876925
2012,OREGON,LINCOLN,13401,897,8686,22984,0.5830577793247477,0.3779150713539854,0.03902714932126697
2012,OREGON,LINN,20378,2104,28944,51426,0.3962587018239801,0.5628281414070704,0.040913156768949556
2012,OREGON,MALHEUR,2759,346,6851,9956,0.2771193250301326,0.6881277621534753,0.034752912816392124
2012,OREGON,MARION,56376,3810,60190,120376,0.4683325579849804,0.500016614607563,0.03165082740745664
2012,OREGON,MORROW,1202,148,2532,3882,0.30963420917053064,0.652241112828439,0.0381246780010304
2012,OREGON,MULTNOMAH,274887,14533,75302,364722,0.7536891111586359,0.20646410142519508,0.039846787416169024
2012,OREGON,POLK,16292,1146,17819,35257,0.462092634086848,0.5054031823467681,0.03250418356638398
2012,OREGON,SHERMAN,319,29,678,1026,0.310916179337232,0.6608187134502924,0.028265107212475632
2012,OREGON,TILLAMOOK,6293,542,5684,12519,0.5026759325824747,0.4540298745906223,0.04329419282690311
2012,OREGON,UMATILLA,8584,886,15499,24969,0.3437862950058072,0.6207297048339941,0.03548400016019865
2012,OREGON,UNION,3973,461,7636,12070,0.3291632145816073,0.6326429163214582,0.03819386909693455
2012,OREGON,WALLOWA,1253,148,2804,4205,0.2979785969084423,0.6668252080856124,0.035196195005945306
2012,OREGON,WASCO,5211,433,5229,10873,0.47926055366504183,0.48091603053435117,0.039823415800607005
2012,OREGON,WASHINGTON,135291,7758,93974,237023,0.5707927078806698,0.3964762913303772,0.03273100078895297
2012,OREGON,WHEELER,266,47,545,858,0.31002331002331,0.6351981351981352,0.054778554778554776
2012,OREGON,YAMHILL,19260,1602,22045,42907,0.4488778054862843,0.5137856293844827,0.037336565129232994
2012,PENNSYLVANIA,ADAMS,15091,599,26767,42457,0.35544197658807736,0.630449631391761,0.014108392020161575
2012,PENNSYLVANIA,ALLEGHENY,352687,7355,262039,622081,0.566947069593831,0.42122971124339115,0.011823219162777837
2012,PENNSYLVANIA,ARMSTRONG,9045,415,20142,29602,0.3055536788054861,0.6804269981757989,0.014019323018714952
2012,PENNSYLVANIA,BEAVER,37055,1075,42344,80474,0.46045927877326837,0.5261823694609439,0.013358351765787708
2012,PENNSYLVANIA,BEDFORD,4788,207,16702,21697,0.22067566944738903,0.7697838410840209,0.009540489468590128
2012,PENNSYLVANIA,BERKS,83011,2607,84702,170320,0.48738257397839363,0.4973109441052137,0.015306481916392672
2012,PENNSYLVANIA,BLAIR,16276,646,33319,50241,0.3239585199339185,0.6631834557433172,0.012858024322764276
2012,PENNSYLVANIA,BRADFORD,8624,392,14410,23426,0.36813796636216173,0.6151284897122855,0.016733543925552805
2012,PENNSYLVANIA,BUCKS,160521,3916,156579,321016,0.5000404964238543,0.4877607346674309,0.012198768908714831
2012,PENNSYLVANIA,BUTLER,28550,1134,59761,89445,0.3191905640337638,0.6681312538431439,0.012678182123092404
2012,PENNSYLVANIA,CAMBRIA,24249,1114,35163,60526,0.4006377424577867,0.5809569441231868,0.018405313419026535
2012,PENNSYLVANIA,CAMERON,724,28,1359,2111,0.34296541923259116,0.6437707247749882,0.013263855992420654
2012,PENNSYLVANIA,CARBON,11580,497,13504,25581,0.45267972323208633,0.5278917946913725,0.019428482076541184
2012,PENNSYLVANIA,CENTRE,34176,1449,34001,69626,0.490851118834918,0.4883376899434119,0.020811191221670067
2012,PENNSYLVANIA,CHESTER,124311,2822,124840,251973,0.4933504780274077,0.49544990931568067,0.011199612656911653
2012,PENNSYLVANIA,CLARION,5056,302,10828,16186,0.3123687137032003,0.6689731867045595,0.01865809959224021
2012,PENNSYLVANIA,CLEARFIELD,11121,499,20347,31967,0.34789001157443616,0.6365001407701693,0.015609847655394625
2012,PENNSYLVANIA,CLINTON,5734,228,7303,13265,0.43226535996984544,0.5505465510742555,0.017188088955898982
2012,PENNSYLVANIA,COLUMBIA,10937,450,14236,25623,0.4268430706786871,0.5555945829918433,0.017562346329469618
2012,PENNSYLVANIA,CRAWFORD,13883,604,20901,35388,0.3923081270487171,0.5906239403187521,0.017067932632530803
2012,PENNSYLVANIA,CUMBERLAND,44367,1638,64809,110814,0.400373599003736,0.5848448751962748,0.01478152579998917
2012,PENNSYLVANIA,DAUPHIN,64965,1593,57450,124008,0.5238774917747242,0.46327656280239987,0.012845945422875944
2012,PENNSYLVANIA,DELAWARE,171792,2919,110853,285564,0.601588435517082,0.38818968777577006,0.01022187670714796
2012,PENNSYLVANIA,ELK,5463,196,7579,13238,0.4126756307599335,0.5725185073273908,0.014805861912675631
2012,PENNSYLVANIA,ERIE,68036,1558,49025,118619,0.5735674723273675,0.4132980382569403,0.013134489415692258
2012,PENNSYLVANIA,FAYETTE,21971,516,26018,48505,0.452963611998763,0.5363983094526338,0.010638078548603236
2012,PENNSYLVANIA,FOREST,896,33,1383,2312,0.3875432525951557,0.5981833910034602,0.014273356401384083
2012,PENNSYLVANIA,FRANKLIN,18995,823,43260,63078,0.3011351025714195,0.6858175592124037,0.013047338216176797
2012,PENNSYLVANIA,FULTON,1310,71,4814,6195,0.21146085552865213,0.7770782889426957,0.011460855528652138
2012,PENNSYLVANIA,GREENE,5852,184,8428,14464,0.4045907079646018,0.5826880530973452,0.012721238938053098
2012,PENNSYLVANIA,HUNTINGDON,5409,251,11979,17639,0.30665003685016157,0.6791201315267306,0.014229831623107887
2012,PENNSYLVANIA,INDIANA,14473,591,21257,36321,0.3984747115993502,0.5852537099749456,0.016271578425704137
2012,PENNSYLVANIA,JEFFERSON,4787,262,13048,18097,0.2645189810465823,0.7210034812399845,0.014477537713433165
2012,PENNSYLVANIA,JUNIATA,2547,126,6862,9535,0.2671211326691138,0.7196643943366544,0.013214472994231778
2012,PENNSYLVANIA,LACKAWANNA,61838,1092,35085,98015,0.6309034331479876,0.3579554149875019,0.011141151864510535
2012,PENNSYLVANIA,LANCASTER,88481,3286,130669,222436,0.39778183387581145,0.5874453775467999,0.014772788577388552
2012,PENNSYLVANIA,LAWRENCE,17513,476,21047,39036,0.44863715544625477,0.5391689722307613,0.012193872322983912
2012,PENNSYLVANIA,LEBANON,19900,808,35872,56580,0.3517143867090845,0.6340049487451396,0.014280664545775892
2012,PENNSYLVANIA,LEHIGH,78283,1845,66874,147002,0.5325301696575557,0.4549189806941402,0.012550849648304104
2012,PENNSYLVANIA,LUZERNE,64307,1807,58325,124439,0.5167752874902563,0.4687035414942261,0.014521171015517644
2012,PENNSYLVANIA,LYCOMING,15203,632,30658,46493,0.3269954616824038,0.6594110941432043,0.013593444174391844
2012,PENNSYLVANIA,MCKEAN,5297,266,9545,15108,0.3506089489012444,0.6317844850410379,0.017606566057717765
2012,PENNSYLVANIA,MERCER,24232,706,25925,50863,0.47641704185753886,0.5097025342586949,0.013880423883766195
2012,PENNSYLVANIA,MIFFLIN,4273,159,11939,16371,0.2610103231323682,0.7292773807342251,0.009712296133406633
2012,PENNSYLVANIA,MONROE,35221,829,26867,62917,0.5598010076767805,0.42702290318991687,0.013176089133302605
2012,PENNSYLVANIA,MONTGOMERY,233356,4463,174381,412200,0.5661232411450752,0.4230494905385735,0.010827268316351286
2012,PENNSYLVANIA,MONTOUR,3053,126,4652,7831,0.3898608096028604,0.5940492912782531,0.01608989911888648
2012,PENNSYLVANIA,NORTHAMPTON,67606,1683,61446,130735,0.5171224232225494,0.47000420698359274,0.012873369793857803
2012,PENNSYLVANIA,NORTHUMBERLAND,13072,622,19518,33212,0.39359267734553777,0.5876791521136938,0.018728170540768398
2012,PENNSYLVANIA,PERRY,5685,323,13120,19128,0.2972082810539523,0.6859054788791301,0.016886240066917607
2012,PENNSYLVANIA,PHILADELPHIA,588806,5054,96467,690327,0.8529378106317731,0.13974102128411608,0.0073211680841108635
2012,PENNSYLVANIA,PIKE,10210,283,12786,23279,0.43859272305511404,0.5492503973538382,0.012156879591047725
2012,PENNSYLVANIA,POTTER,1897,114,5231,7242,0.26194421430544046,0.7223142778238055,0.015741507870753936
2012,PENNSYLVANIA,SCHUYLKILL,24546,903,32278,57727,0.4252083080707468,0.5591490983421968,0.015642593587056317
2012,PENNSYLVANIA,SNYDER,4687,242,10073,15002,0.31242500999866685,0.6714438074923343,0.0161311825089988
2012,PENNSYLVANIA,SOMERSET,9436,522,23984,33942,0.27800365329090804,0.7066171704672677,0.015379176241824288
2012,PENNSYLVANIA,SULLIVAN,1034,47,1868,2949,0.35062733129874535,0.6334350627331299,0.01593760596812479
2012,PENNSYLVANIA,SUSQUEHANNA,6935,309,10800,18044,0.38433828419419197,0.5985369097761029,0.017124806029705165
2012,PENNSYLVANIA,TIOGA,5357,305,11342,17004,0.31504351917195955,0.66701952481769,0.017936956010350506
2012,PENNSYLVANIA,UNION,6109,263,9896,16268,0.37552249815588884,0.6083107941971969,0.016166707646914188
2012,PENNSYLVANIA,VENANGO,7945,407,13815,22167,0.35841566292236204,0.6232237109216403,0.018360626155997654
2012,PENNSYLVANIA,WARREN,6995,294,10010,17299,0.40435863344702005,0.5786461645181803,0.0169952020347997
2012,PENNSYLVANIA,WASHINGTON,40345,1175,53230,94750,0.4258047493403694,0.5617941952506597,0.012401055408970976
2012,PENNSYLVANIA,WAYNE,8396,315,12896,21607,0.3885777757208312,0.5968436154949784,0.014578608784190308
2012,PENNSYLVANIA,WESTMORELAND,63722,1918,103932,169572,0.3757813790012502,0.6129077913806524,0.011310829618097328
2012,PENNSYLVANIA,WYOMING,5061,224,6587,11872,0.42629716981132076,0.5548349056603774,0.018867924528301886
2012,PENNSYLVANIA,YORK,73191,2734,113304,189229,0.386785323602619,0.5987665738338204,0.014448102563560553
2012,RHODE ISLAND,BRISTOL,14974,471,9231,24676,0.6068244448046685,0.37408818284973255,0.01908737234559896
2012,RHODE ISLAND,FEDERAL PRECINCT,268,12,53,333,0.8048048048048048,0.15915915915915915,0.036036036036036036
2012,RHODE ISLAND,KENT,45564,1792,31567,78923,0.5773222001191034,0.3999721247291664,0.022705675151730168
2012,RHODE ISLAND,NEWPORT,23463,787,15202,39452,0.5947227010037514,0.3853290074013992,0.019948291594849437
2012,RHODE ISLAND,PROVIDENCE,159520,4484,75785,239789,0.6652515336399918,0.31604869280909464,0.018699773550913512
2012,RHODE ISLAND,WASHINGTON,35888,1625,25366,62879,0.5707469902511172,0.40340972343707754,0.025843286311805214
2012,SOUTH CAROLINA,ABBEVILLE,4543,147,5981,10671,0.4257332958485615,0.56049105051073,0.013775653640708463
2012,SOUTH CAROLINA,AIKEN,25322,999,44042,70363,0.35987663971121187,0.625925557466282,0.014197802822506147
2012,SOUTH CAROLINA,ALLENDALE,3297,28,838,4163,0.7919769397069422,0.20129714148450636,0.006725918808551525
2012,SOUTH CAROLINA,ANDERSON,22405,1098,48709,72212,0.31026699163573923,0.6745277793164571,0.015205229047803689
2012,SOUTH CAROLINA,BAMBERG,4624,64,2194,6882,0.6718977041557687,0.3188026736413833,0.00929962220284801
2012,SOUTH CAROLINA,BARNWELL,5188,76,4659,9923,0.522825758339212,0.46951526756021367,0.007658974100574423
2012,SOUTH CAROLINA,BEAUFORT,29848,762,42687,73297,0.4072199407888454,0.5823839993451301,0.01039605986602453
2012,SOUTH CAROLINA,BERKELEY,28542,1178,38475,68195,0.41853508321724464,0.564190923088203,0.017273993694552386
2012,SOUTH CAROLINA,CALHOUN,4045,82,3707,7834,0.5163390349757467,0.4731937707429155,0.010467194281337758
2012,SOUTH CAROLINA,CHARLESTON,81487,2591,77629,161707,0.5039175793255704,0.48005961399320995,0.016022806681219737
2012,SOUTH CAROLINA,CHEROKEE,7231,228,13314,20773,0.34809608626582583,0.6409281278582776,0.010975785875896597
2012,SOUTH CAROLINA,CHESTER,7891,149,6367,14407,0.5477198584021656,0.4419379468314014,0.010342194766432984
2012,SOUTH CAROLINA,CHESTERFIELD,7958,146,8490,16594,0.4795709292515367,0.5116307098951428,0.008798360853320477
2012,SOUTH CAROLINA,CLARENDON,9091,130,7071,16292,0.5580039283083722,0.4340166953105819,0.007979376381045912
2012,SOUTH CAROLINA,COLLETON,8475,168,8443,17086,0.49602013344258455,0.49414725506262436,0.009832611494791057
2012,SOUTH CAROLINA,DARLINGTON,15457,259,14434,30150,0.512669983416252,0.4787396351575456,0.008590381426202321
2012,SOUTH CAROLINA,DILLON,7523,85,5427,13035,0.577138473341005,0.41634062140391254,0.00652090525508247
2012,SOUTH CAROLINA,DORCHESTER,23445,879,32531,56855,0.4123647876176238,0.5721748307097001,0.015460381672676106
2012,SOUTH CAROLINA,EDGEFIELD,4967,107,6512,11586,0.42870706024512345,0.5620576557914725,0.009235283963404109
2012,SOUTH CAROLINA,FAIRFIELD,7777,119,3999,11895,0.6538041193778898,0.33619167717528375,0.010004203446826399
2012,SOUTH CAROLINA,FLORENCE,28614,547,28961,58122,0.4923092804789925,0.4982794810914972,0.009411238429510341
2012,SOUTH CAROLINA,GEORGETOWN,14163,276,16526,30965,0.45738737284030356,0.5336993379622154,0.008913289197481028
2012,SOUTH CAROLINA,GREENVILLE,68070,3434,121685,193189,0.35234925383950433,0.6298754069848698,0.017775339175625942
2012,SOUTH CAROLINA,GREENWOOD,11972,352,16348,28672,0.4175502232142857,0.5701729910714286,0.012276785714285714
2012,SOUTH CAROLINA,HAMPTON,5834,60,3312,9206,0.6337171409950033,0.3597653704106018,0.00651748859439496
2012,SOUTH CAROLINA,HORRY,38885,1381,72127,112393,0.3459735036879521,0.6417392542240176,0.012287242088030394
2012,SOUTH CAROLINA,JASPER,5757,95,4169,10021,0.5744935635166151,0.41602634467618005,0.00948009180720487
2012,SOUTH CAROLINA,KERSHAW,11259,363,16324,27946,0.4028841336863952,0.5841265297359193,0.012989336577685537
2012,SOUTH CAROLINA,LANCASTER,13419,392,19333,33144,0.404869659666908,0.5833031619599324,0.011827178373159546
2012,SOUTH CAROLINA,LAURENS,10318,352,14746,25416,0.4059647466163047,0.5801857097891092,0.013849543594586088
2012,SOUTH CAROLINA,LEE,5977,98,2832,8907,0.6710452453126754,0.3179521724486359,0.011002582238688672
2012,SOUTH CAROLINA,LEXINGTON,34148,1813,76662,112623,0.3032062722534473,0.6806957726219334,0.016097955124619305
2012,SOUTH CAROLINA,MARION,9688,134,5164,14986,0.6464700387027893,0.34458828239690376,0.008941678900306954
2012,SOUTH CAROLINA,MARLBORO,6100,77,3676,9853,0.6191007814878717,0.3730843397949863,0.007814878717141987
2012,SOUTH CAROLINA,MCCORMICK,2653,40,2467,5160,0.5141472868217054,0.47810077519379846,0.007751937984496124
2012,SOUTH CAROLINA,NEWBERRY,6913,178,9260,16351,0.42278759708886304,0.5663262185799034,0.010886184331233563
2012,SOUTH CAROLINA,OCONEE,8550,505,21611,30666,0.2788104089219331,0.7047218417791691,0.016467749298897803
2012,SOUTH CAROLINA,ORANGEBURG,30720,299,12022,43041,0.7137380637066982,0.27931507167584396,0.006946864617457773
2012,SOUTH CAROLINA,PICKENS,11156,919,33474,45549,0.244923049902303,0.7349008759797142,0.02017607411798283
2012,SOUTH CAROLINA,RICHLAND,103989,2060,53105,159154,0.6533860286263619,0.33367053294293575,0.012943438430702338
2012,SOUTH CAROLINA,SALUDA,3328,101,5135,8564,0.3886034563288183,0.5996029892573563,0.011793554413825316
2012,SOUTH CAROLINA,SPARTANBURG,41461,1476,66969,109906,0.37724055101632303,0.609329790912234,0.01342965807144287
2012,SOUTH CAROLINA,SUMTER,27589,446,19274,47309,0.5831659937855377,0.40740662453233,0.009427381682132363
2012,SOUTH CAROLINA,UNION,5796,161,6584,12541,0.4621641017462722,0.5249980065385536,0.012837891715174228
2012,SOUTH CAROLINA,WILLIAMSBURG,11335,145,4824,16304,0.6952281648675172,0.2958783120706575,0.00889352306182532
2012,SOUTH CAROLINA,YORK,39131,1533,59546,100210,0.3904899710607724,0.5942121544756013,0.015297874463626385
2012,SOUTH DAKOTA,AURORA,556,40,804,1400,0.39714285714285713,0.5742857142857143,0.02857142857142857
2012,SOUTH DAKOTA,BEADLE,2881,152,4230,7263,0.3966680435081922,0.5824039653035935,0.020927991188214236
2012,SOUTH DAKOTA,BENNETT,548,29,626,1203,0.45552784704904403,0.5203657522859518,0.024106400665004156
2012,SOUTH DAKOTA,BON HOMME,1167,77,1830,3074,0.3796356538711776,0.5953155497722836,0.025048796356538713
2012,SOUTH DAKOTA,BROOKINGS,5827,353,6220,12400,0.46991935483870967,0.5016129032258064,0.028467741935483872
2012,SOUTH DAKOTA,BROWN,7250,497,8321,16068,0.45120736868309685,0.5178615882499378,0.030931043066965397
2012,SOUTH DAKOTA,BRULE,824,56,1499,2379,0.346364018495166,0.6300966792770072,0.023539302227826818
2012,SOUTH DAKOTA,BUFFALO,472,3,166,641,0.7363494539781591,0.2589703588143526,0.0046801872074883
2012,SOUTH DAKOTA,BUTTE,1002,133,3073,4208,0.23811787072243346,0.7302756653992395,0.031606463878326996
2012,SOUTH DAKOTA,CAMPBELL,153,18,616,787,0.19440914866581957,0.7827191867852605,0.022871664548919948
2012,SOUTH DAKOTA,CHARLES MIX,1483,51,2230,3764,0.39399574920297553,0.5924548352816154,0.01354941551540914
2012,SOUTH DAKOTA,CLARK,713,41,1067,1821,0.3915431081823174,0.585941790225151,0.022515101592531575
2012,SOUTH DAKOTA,CLAY,2955,132,2147,5234,0.5645777607948033,0.41020252197172336,0.025219717233473445
2012,SOUTH DAKOTA,CODINGTON,4588,240,6696,11524,0.398125650815689,0.581048247136411,0.020826102047900034
2012,SOUTH DAKOTA,CORSON,648,37,515,1200,0.54,0.42916666666666664,0.030833333333333334
2012,SOUTH DAKOTA,CUSTER,1335,123,3062,4520,0.29535398230088494,0.6774336283185841,0.027212389380530975
2012,SOUTH DAKOTA,DAVISON,3042,172,4757,7971,0.3816334211516748,0.5967883577970142,0.021578221051311002
2012,SOUTH DAKOTA,DAY,1497,56,1320,2873,0.521058127392969,0.4594500522102332,0.01949182039679777
2012,SOUTH DAKOTA,DEUEL,941,55,1175,2171,0.4334408106863197,0.5412252418240442,0.025333947489636112
2012,SOUTH DAKOTA,DEWEY,1207,25,663,1895,0.6369393139841689,0.34986807387862795,0.013192612137203167
2012,SOUTH DAKOTA,DOUGLAS,332,24,1334,1690,0.19644970414201182,0.7893491124260354,0.014201183431952662
2012,SOUTH DAKOTA,EDMUNDS,622,50,1264,1936,0.3212809917355372,0.6528925619834711,0.025826446280991736
2012,SOUTH DAKOTA,FALL RIVER,1140,118,2258,3516,0.3242320819112628,0.6422070534698521,0.0335608646188851
2012,SOUTH DAKOTA,FAULK,331,31,765,1127,0.2937000887311446,0.678793256433008,0.027506654835847383
2012,SOUTH DAKOTA,GRANT,1493,79,2034,3606,0.4140321686078758,0.5640599001663894,0.021907931225734888
2012,SOUTH DAKOTA,GREGORY,599,45,1507,2151,0.27847512784751277,0.700604370060437,0.02092050209205021
2012,SOUTH DAKOTA,HAAKON,138,14,940,1092,0.12637362637362637,0.8608058608058609,0.01282051282051282
2012,SOUTH DAKOTA,HAMLIN,921,69,1803,2793,0.3297529538131042,0.6455424274973147,0.024704618689581095
2012,SOUTH DAKOTA,HAND,575,31,1242,1848,0.31114718614718617,0.672077922077922,0.016774891774891776
2012,SOUTH DAKOTA,HANSON,760,29,1627,2416,0.31456953642384106,0.6734271523178808,0.012003311258278146
2012,SOUTH DAKOTA,HARDING,82,19,638,739,0.11096075778078485,0.8633288227334236,0.02571041948579161
2012,SOUTH DAKOTA,HUGHES,2786,150,5219,8155,0.34163090128755363,0.6399754751686082,0.018393623543838136
2012,SOUTH DAKOTA,HUTCHINSON,923,51,2451,3425,0.2694890510948905,0.7156204379562043,0.01489051094890511
2012,SOUTH DAKOTA,HYDE,189,13,531,733,0.2578444747612551,0.7244201909959073,0.017735334242837655
2012,SOUTH DAKOTA,JACKSON,426,19,661,1106,0.38517179023508136,0.5976491862567812,0.017179023508137433
2012,SOUTH DAKOTA,JERAULD,452,16,538,1006,0.44930417495029823,0.5347912524850894,0.015904572564612324
2012,SOUTH DAKOTA,JONES,108,11,490,609,0.17733990147783252,0.8045977011494253,0.0180623973727422
2012,SOUTH DAKOTA,KINGSBURY,1092,65,1451,2608,0.4187116564417178,0.5563650306748467,0.02492331288343558
2012,SOUTH DAKOTA,LAKE,2724,142,3419,6285,0.4334128878281623,0.5439936356404137,0.022593476531424024
2012,SOUTH DAKOTA,LAWRENCE,3973,361,7025,11359,0.34976670481556477,0.6184523285500484,0.03178096663438683
2012,SOUTH DAKOTA,LINCOLN,7982,359,13611,21952,0.3636115160349854,0.6200346209912536,0.016353862973760933
2012,SOUTH DAKOTA,LYMAN,605,31,933,1569,0.38559592096876993,0.5946462715105163,0.019757807520713832
2012,SOUTH DAKOTA,MARSHALL,1061,37,889,1987,0.5339708102667338,0.447408152994464,0.018621036738802214
2012,SOUTH DAKOTA,MCCOOK,905,53,1655,2613,0.3463451970914658,0.6333716035208573,0.020283199387677
2012,SOUTH DAKOTA,MCPHERSON,272,22,921,1215,0.22386831275720165,0.7580246913580246,0.01810699588477366
2012,SOUTH DAKOTA,MEADE,2928,323,7566,10817,0.2706850328187113,0.6994545622631043,0.02986040491818434
2012,SOUTH DAKOTA,MELLETTE,375,13,381,769,0.48764629388816644,0.49544863459037713,0.016905071521456438
2012,SOUTH DAKOTA,MINER,479,25,636,1140,0.4201754385964912,0.5578947368421052,0.021929824561403508
2012,SOUTH DAKOTA,MINNEHAHA,34674,1567,40342,76583,0.4527636681770106,0.5267748717078202,0.020461460115169163
2012,SOUTH DAKOTA,MOODY,1429,69,1535,3033,0.4711506758984504,0.5060995713814704,0.02274975272007913
2012,SOUTH DAKOTA,OGLALA LAKOTA,2937,20,188,3145,0.9338632750397456,0.059777424483306835,0.006359300476947536
2012,SOUTH DAKOTA,PENNINGTON,15125,1107,28232,44464,0.3401628283555236,0.6349406261245052,0.02489654551997121
2012,SOUTH DAKOTA,PERKINS,319,66,1205,1590,0.20062893081761007,0.7578616352201258,0.04150943396226415
2012,SOUTH DAKOTA,POTTER,339,13,1029,1381,0.24547429398986242,0.7451122375090514,0.00941346850108617
2012,SOUTH DAKOTA,ROBERTS,2302,71,1883,4256,0.5408834586466166,0.44243421052631576,0.01668233082706767
2012,SOUTH DAKOTA,SANBORN,389,38,688,1115,0.3488789237668161,0.6170403587443947,0.034080717488789235
2012,SOUTH DAKOTA,SPINK,1300,71,1670,3041,0.4274909569220651,0.5491614600460375,0.023347583031897403
2012,SOUTH DAKOTA,STANLEY,435,42,1063,1540,0.2824675324675325,0.6902597402597402,0.02727272727272727
2012,SOUTH DAKOTA,SULLY,186,19,613,818,0.2273838630806846,0.7493887530562348,0.023227383863080684
2012,SOUTH DAKOTA,TODD,1976,23,498,2497,0.7913496195434522,0.19943932719263116,0.0092110532639167
2012,SOUTH DAKOTA,TRIPP,737,49,1905,2691,0.2738758825715347,0.7079152731326644,0.018208844295800816
2012,SOUTH DAKOTA,TURNER,1411,84,2715,4210,0.3351543942992874,0.6448931116389549,0.019952494061757718
2012,SOUTH DAKOTA,UNION,2782,116,4698,7596,0.366245392311743,0.6184834123222749,0.015271195365982097
2012,SOUTH DAKOTA,WALWORTH,671,60,1731,2462,0.2725426482534525,0.7030869212022746,0.024370430544272948
2012,SOUTH DAKOTA,YANKTON,4226,253,5495,9974,0.42370162422297974,0.5509324243031883,0.025365951473831964
2012,SOUTH DAKOTA,ZIEBACH,439,8,314,761,0.5768725361366623,0.4126149802890933,0.010512483574244415
2012,TENNESSEE,ANDERSON,10122,569,18968,29659,0.34127920698607506,0.6395360598806433,0.019184733133281635
2012,TENNESSEE,BEDFORD,4211,200,10034,14445,0.29151955694011766,0.6946348217376255,0.013845621322256836
2012,TENNESSEE,BENTON,2258,118,3850,6226,0.3626726630260199,0.6183745583038869,0.018952778670093158
2012,TENNESSEE,BLEDSOE,1267,70,3022,4359,0.29066299610002294,0.6932782748336774,0.01605872906629961
2012,TENNESSEE,BLOUNT,12934,859,35441,49234,0.2627046350083276,0.7198480724702442,0.017447292521428282
2012,TENNESSEE,BRADLEY,8037,504,27422,35963,0.22347968745655256,0.7625059088507633,0.014014403692684148
2012,TENNESSEE,CAMPBELL,3328,169,8604,12101,0.27501859350466906,0.711015618543922,0.013965787951408975
2012,TENNESSEE,CANNON,1564,100,3309,4973,0.31449829077015884,0.6653931228634627,0.020108586366378443
2012,TENNESSEE,CARROLL,3475,151,7225,10851,0.32024698184499123,0.6658372500230394,0.013915768131969404
2012,TENNESSEE,CARTER,4789,325,15503,20617,0.2322840374448271,0.7519522723965659,0.015763690158606975
2012,TENNESSEE,CHEATHAM,4659,255,10268,15182,0.30687656435252275,0.6763272296140166,0.016796206033460676
2012,TENNESSEE,CHESTER,1624,102,4684,6410,0.2533541341653666,0.7307332293291732,0.01591263650546022
2012,TENNESSEE,CLAIBORNE,2433,128,7617,10178,0.2390449990174887,0.7483788563568481,0.012576144625663196
2012,TENNESSEE,CLAY,1037,36,1747,2820,0.3677304964539007,0.6195035460992908,0.01276595744680851
2012,TENNESSEE,COCKE,2804,191,8459,11454,0.24480530818927884,0.7385192945695827,0.01667539724113847
2012,TENNESSEE,COFFEE,5870,366,13023,19259,0.3047925645152916,0.6762033335064126,0.019004101978295863
2012,TENNESSEE,CROCKETT,1669,46,3783,5498,0.303564932702801,0.6880683885049109,0.008366678792288106
2012,TENNESSEE,CUMBERLAND,6261,333,18653,25247,0.2479898601814077,0.7388204539153167,0.013189685903275636
2012,TENNESSEE,DAVIDSON,143120,4131,97622,244873,0.5844662335169659,0.39866379715199307,0.01686996933104099
2012,TENNESSEE,DECATUR,1303,74,2874,4251,0.3065161138555634,0.6760762173606211,0.017407668783815573
2012,TENNESSEE,DEKALB,2174,105,4143,6422,0.33852382435378386,0.645126128931797,0.016350046714419184
2012,TENNESSEE,DICKSON,6233,306,11296,17835,0.34948135688253434,0.6333613680964396,0.017157275021026073
2012,TENNESSEE,DYER,3757,122,9921,13800,0.2722463768115942,0.7189130434782609,0.008840579710144927
2012,TENNESSEE,FAYETTE,6688,197,12689,19574,0.3416777357719424,0.6482578931235312,0.010064371104526413
2012,TENNESSEE,FENTRESS,1561,91,5243,6895,0.2263959390862944,0.7604060913705584,0.013197969543147208
2012,TENNESSEE,FRANKLIN,5603,254,10262,16119,0.34760220857373286,0.6366399900738259,0.015757801352441217
2012,TENNESSEE,GIBSON,6564,220,12883,19667,0.3337570549651701,0.6550566939543397,0.011186251080490161
2012,TENNESSEE,GILES,3760,124,6915,10799,0.34818038707287713,0.6403370682470599,0.011482544680062969
2012,TENNESSEE,GRAINGER,1668,114,5470,7252,0.23000551571980143,0.7542746828461114,0.015719801434087147
2012,TENNESSEE,GREENE,6225,417,17245,23887,0.26060200108845816,0.7219408046217608,0.017457194289781052
2012,TENNESSEE,GRUNDY,1643,78,2516,4237,0.38777436865706866,0.593816379513807,0.018409251829124382
2012,TENNESSEE,HAMBLEN,5234,276,14522,20032,0.26128194888178913,0.7249400958466453,0.013777955271565496
2012,TENNESSEE,HAMILTON,58836,2412,79933,141181,0.4167416295393856,0.5661739185867787,0.017084451873835716
2012,TENNESSEE,HANCOCK,475,44,1527,2046,0.23216031280547408,0.7463343108504399,0.021505376344086023
2012,TENNESSEE,HARDEMAN,5482,92,4865,10439,0.5251460867899224,0.46604080850656193,0.008813104703515663
2012,TENNESSEE,HARDIN,2467,142,7886,10495,0.23506431634111483,0.7514054311576941,0.013530252501191043
2012,TENNESSEE,HAWKINS,5088,327,14382,19797,0.2570086376723746,0.7264737081375966,0.01651765419002879
2012,TENNESSEE,HAYWOOD,4569,40,2960,7569,0.6036464526357511,0.39106883339939225,0.005284713964856652
2012,TENNESSEE,HENDERSON,2517,117,7421,10055,0.2503232222774739,0.7380407757334659,0.011636001989060169
2012,TENNESSEE,HENRY,4339,207,8193,12739,0.34060758301279537,0.6431431038543056,0.01624931313289897
2012,TENNESSEE,HICKMAN,2698,146,4758,7602,0.35490660352538805,0.6258879242304657,0.019205472244146277
2012,TENNESSEE,HOUSTON,1400,48,1579,3027,0.46250412950115627,0.5216385860588041,0.015857284440039643
2012,TENNESSEE,HUMPHREYS,2905,125,3833,6863,0.423284278012531,0.5585021127786682,0.018213609208800816
2012,TENNESSEE,JACKSON,1739,62,2383,4184,0.41563097514340347,0.5695506692160612,0.014818355640535373
2012,TENNESSEE,JEFFERSON,4232,289,13038,17559,0.24101600318924768,0.7425252007517512,0.016458796059001083
2012,TENNESSEE,JOHNSON,1483,100,4611,6194,0.23942525024216985,0.7444300936390055,0.01614465611882467
2012,TENNESSEE,KNOX,59399,3401,109707,172507,0.3443280562527897,0.6359568017529723,0.019715141994237916
2012,TENNESSEE,LAKE,884,40,1163,2087,0.4235745088643987,0.5572592237661715,0.019166267369429803
2012,TENNESSEE,LAUDERDALE,4011,62,4616,8689,0.46161813787547473,0.5312464034986765,0.007135458625848775
2012,TENNESSEE,LAWRENCE,4237,212,10770,15219,0.2784019975031211,0.7076680465207964,0.013929955976082528
2012,TENNESSEE,LEWIS,1447,130,3117,4694,0.30826587132509586,0.664039198977418,0.027694929697486152
2012,TENNESSEE,LINCOLN,3290,175,9803,13268,0.24796502864033765,0.7388453421766656,0.013189629182996683
2012,TENNESSEE,LOUDON,5058,308,16707,22073,0.22914873374711187,0.7568975671635029,0.013953699089385221
2012,TENNESSEE,MACON,1552,93,5260,6905,0.22476466328747285,0.7617668356263577,0.013468501086169442
2012,TENNESSEE,MADISON,18367,342,21993,40702,0.45125546656183974,0.5403419979362194,0.008402535501940936
2012,TENNESSEE,MARION,3953,184,6272,10409,0.3797675088865405,0.6025554808338938,0.01767701027956576
2012,TENNESSEE,MARSHALL,3725,184,6832,10741,0.3468019737454613,0.636067405269528,0.017130620985010708
2012,TENNESSEE,MAURY,11825,473,20708,33006,0.3582681936617585,0.6274010785917712,0.014330727746470338
2012,TENNESSEE,MCMINN,4609,258,12967,17834,0.2584389368621734,0.7270943142312437,0.014466748906582932
2012,TENNESSEE,MCNAIRY,2645,142,7015,9802,0.2698428892062844,0.7156702713731892,0.014486839420526422
2012,TENNESSEE,MEIGS,1163,67,2734,3964,0.29339051463168514,0.6897073662966701,0.016902119071644805
2012,TENNESSEE,MONROE,4372,235,11731,16338,0.2675970130982984,0.7180193414126577,0.014383645489043946
2012,TENNESSEE,MONTGOMERY,24499,840,30245,55584,0.4407563327576281,0.5441314047207829,0.015112262521588947
2012,TENNESSEE,MOORE,705,41,2053,2799,0.25187566988210075,0.7334762415148267,0.014648088603072526
2012,TENNESSEE,MORGAN,1725,110,4669,6504,0.26522140221402213,0.7178659286592866,0.016912669126691267
2012,TENNESSEE,OBION,3321,162,8814,12297,0.270065869724323,0.7167601854110759,0.013173944864601122
2012,TENNESSEE,OVERTON,2805,84,4775,7664,0.36599686847599167,0.6230427974947808,0.010960334029227558
2012,TENNESSEE,PERRY,992,51,1578,2621,0.3784814956123617,0.6020602823349867,0.019458222052651658
2012,TENNESSEE,PICKETT,712,29,1712,2453,0.2902568283734203,0.6979209131675499,0.011822258459029759
2012,TENNESSEE,POLK,1856,95,4108,6059,0.3063211751114045,0.6779996699125268,0.015679154976068657
2012,TENNESSEE,PUTNAM,7802,444,17254,25500,0.3059607843137255,0.6766274509803921,0.017411764705882352
2012,TENNESSEE,RHEA,2628,160,7802,10590,0.2481586402266289,0.7367327667610953,0.015108593012275733
2012,TENNESSEE,ROANE,6018,348,14724,21090,0.28534850640113796,0.6981507823613087,0.016500711237553343
2012,TENNESSEE,ROBERTSON,8290,356,17643,26289,0.31534101715546425,0.6711171973068584,0.013541785537677356
2012,TENNESSEE,RUTHERFORD,36414,1588,60846,98848,0.3683837811589511,0.615551149239236,0.016065069601812886
2012,TENNESSEE,SCOTT,1452,99,5117,6668,0.21775644871025795,0.7673965206958608,0.014847030593881224
2012,TENNESSEE,SEQUATCHIE,1489,112,3541,5142,0.2895760404511863,0.6886425515363672,0.021781408012446518
2012,TENNESSEE,SEVIER,7418,462,25984,33864,0.21905268131348926,0.7673045121663123,0.01364280652019844
2012,TENNESSEE,SHELBY,232443,3017,135649,371109,0.6263469762253139,0.365523336809401,0.008129686965285132
2012,TENNESSEE,SMITH,2470,122,4495,7087,0.3485254691689008,0.6342599125158741,0.01721461831522506
2012,TENNESSEE,STEWART,2069,83,2963,5115,0.40449657869012706,0.5792766373411534,0.016226783968719453
2012,TENNESSEE,SULLIVAN,15321,1004,43562,59887,0.2558318165879072,0.7274032761701203,0.016764907241972382
2012,TENNESSEE,SUMNER,18579,784,46003,65366,0.2842303338126855,0.7037756631888138,0.01199400299850075
2012,TENNESSEE,TIPTON,7133,276,16672,24081,0.29620862920975044,0.6923300527386737,0.011461318051575931
2012,TENNESSEE,TROUSDALE,1240,53,1612,2905,0.4268502581755594,0.5549053356282272,0.018244406196213425
2012,TENNESSEE,UNICOI,1913,141,5032,7086,0.2699689528648038,0.7101326559412927,0.01989839119390347
2012,TENNESSEE,UNION,1478,68,4282,5828,0.25360329444063145,0.7347288949897048,0.011667810569663692
2012,TENNESSEE,VAN BUREN,875,39,1386,2300,0.3804347826086957,0.6026086956521739,0.016956521739130436
2012,TENNESSEE,WARREN,4752,253,8010,13015,0.36511717249327696,0.6154437187860161,0.019439108720706876
2012,TENNESSEE,WASHINGTON,14325,899,32808,48032,0.2982386742171885,0.6830446369087275,0.018716688874083943
2012,TENNESSEE,WAYNE,1163,70,4253,5486,0.2119941669704703,0.7752460809332847,0.012759752096244987
2012,TENNESSEE,WEAKLEY,3548,184,8605,12337,0.28759017589365327,0.6974953392234741,0.014914484882872659
2012,TENNESSEE,WHITE,2795,148,6197,9140,0.3057986870897155,0.6780087527352298,0.016192560175054705
2012,TENNESSEE,WILLIAMSON,25142,1233,69850,96225,0.2612834502468174,0.7259028319043908,0.012813717848791893
2012,TENNESSEE,WILSON,14695,695,36109,51499,0.2853453465115828,0.7011592458105983,0.013495407677818988
2012,TEXAS,ANDERSON,3813,137,12262,16212,0.2351961509992598,0.7563533185294843,0.00845053047125586
2012,TEXAS,ANDREWS,795,48,3639,4482,0.17737617135207498,0.8119143239625167,0.0107095046854083
2012,TEXAS,ANGELINA,7834,269,20303,28406,0.2757868056044498,0.7147433640780116,0.009469830317538548
2012,TEXAS,ARANSAS,2704,114,6830,9648,0.2802653399668325,0.7079187396351575,0.01181592039800995
2012,TEXAS,ARCHER,525,39,3600,4164,0.1260806916426513,0.8645533141210374,0.009365994236311239
2012,TEXAS,ARMSTRONG,98,9,828,935,0.10481283422459893,0.8855614973262033,0.009625668449197862
2012,TEXAS,ATASCOSA,5133,127,7461,12721,0.40350601367816996,0.5865104944579829,0.009983491863847182
2012,TEXAS,AUSTIN,2252,132,9265,11649,0.1933213151343463,0.7953472401064469,0.0113314447592068
2012,TEXAS,BAILEY,466,11,1339,1816,0.2566079295154185,0.7373348017621145,0.006057268722466961
2012,TEXAS,BANDERA,1864,158,7426,9448,0.19729043183742592,0.7859864521591872,0.01672311600338696
2012,TEXAS,BASTROP,9864,584,14033,24481,0.40292471712756833,0.5732200482006454,0.023855234671786282
2012,TEXAS,BAYLOR,267,28,1297,1592,0.16771356783919597,0.8146984924623115,0.017587939698492462
2012,TEXAS,BEE,3452,71,4356,7879,0.4381266658205356,0.5528620383297372,0.009011295849727123
2012,TEXAS,BELL,35512,1120,49574,86206,0.4119434842122358,0.575064380669559,0.012992135118205229
2012,TEXAS,BEXAR,264856,7208,241617,513681,0.5156040421973949,0.47036390288914715,0.014032054913457962
2012,TEXAS,BLANCO,1220,115,3638,4973,0.24532475366981701,0.7315503720088478,0.02312487432133521
2012,TEXAS,BORDEN,32,7,324,363,0.0881542699724518,0.8925619834710744,0.01928374655647383
2012,TEXAS,BOSQUE,1367,104,5885,7356,0.1858346927678086,0.8000271886895052,0.014138118542686243
2012,TEXAS,BOWIE,10196,339,24869,35404,0.28799005762060786,0.702434753135239,0.009575189244153202
2012,TEXAS,BRAZORIA,34421,1456,70862,106739,0.3224781944743721,0.6638810556591311,0.013640749866496781
2012,TEXAS,BRAZOS,17477,1276,37209,55962,0.3123012043886923,0.6648976090918838,0.022801186519423894
2012,TEXAS,BREWSTER,1765,126,1976,3867,0.456426170157745,0.5109904318593225,0.032583397982932506
2012,TEXAS,BRISCOE,117,7,578,702,0.16666666666666666,0.8233618233618234,0.009971509971509971
2012,TEXAS,BROOKS,1886,10,507,2403,0.7848522679983354,0.21098626716604243,0.004161464835622139
2012,TEXAS,BROWN,1904,148,11895,13947,0.13651681365168136,0.8528715852871586,0.010611601061160107
2012,TEXAS,BURLESON,1705,80,4671,6456,0.26409541511771994,0.7235130111524164,0.012391573729863693
2012,TEXAS,BURNET,3674,279,12843,16796,0.21874255775184567,0.7646463443677066,0.016611097880447727
2012,TEXAS,CALDWELL,4791,256,6021,11068,0.4328695337911095,0.5440007228044814,0.023129743404409108
2012,TEXAS,CALHOUN,2410,94,4144,6648,0.36251504211793023,0.6233453670276775,0.014139590854392299
2012,TEXAS,CALLAHAN,751,68,4378,5197,0.14450644602655377,0.8424090821627862,0.013084471810659996
2012,TEXAS,CAMERON,49975,821,26099,76895,0.6499122179595552,0.33941088497301514,0.010676897067429612
2012,TEXAS,CAMP,1428,26,2881,4335,0.32941176470588235,0.6645905420991927,0.0059976931949250285
2012,TEXAS,CARSON,292,35,2451,2778,0.10511159107271419,0.8822894168466523,0.01259899208063355
2012,TEXAS,CASS,2924,101,8763,11788,0.2480488632507635,0.7433831014591109,0.008568035290125552
2012,TEXAS,CASTRO,630,19,1470,2119,0.2973100519112789,0.6937234544596508,0.008966493629070316
2012,TEXAS,CHAMBERS,2790,158,11787,14735,0.18934509670851712,0.7999321343739396,0.010722768917543264
2012,TEXAS,CHEROKEE,3875,157,12094,16126,0.24029517549299267,0.7499689941709041,0.009735830336103188
2012,TEXAS,CHILDRESS,320,11,1665,1996,0.16032064128256512,0.8341683366733467,0.005511022044088177
2012,TEXAS,CLAY,740,51,4266,5057,0.1463318172829741,0.8435831520664425,0.01008503065058335
2012,TEXAS,COCHRAN,256,12,649,917,0.2791712104689204,0.707742639040349,0.013086150490730643
2012,TEXAS,COKE,179,11,1218,1408,0.12713068181818182,0.8650568181818182,0.0078125
2012,TEXAS,COLEMAN,442,38,3012,3492,0.1265750286368843,0.8625429553264605,0.010882016036655211
2012,TEXAS,COLLIN,101415,4518,196888,302821,0.33490081599360677,0.6501794789661219,0.014919705040271316
2012,TEXAS,COLLINGSWORTH,177,11,962,1150,0.15391304347826087,0.8365217391304348,0.009565217391304347
2012,TEXAS,COLORADO,2029,62,6026,8117,0.24996920044351362,0.7423925095478625,0.007638290008623876
2012,TEXAS,COMAL,11450,761,39318,51529,0.22220497195753847,0.7630266451900871,0.014768382852374392
2012,TEXAS,COMANCHE,890,72,3944,4906,0.18141051773338768,0.8039135752140236,0.014675907052588666
2012,TEXAS,CONCHO,194,14,793,1001,0.1938061938061938,0.7922077922077922,0.013986013986013986
2012,TEXAS,COOKE,2246,154,11951,14351,0.15650477318653752,0.8327642672984461,0.010730959515016375
2012,TEXAS,CORYELL,5158,226,11220,16604,0.3106480366176825,0.675740785352927,0.013611178029390509
2012,TEXAS,COTTLE,180,6,555,741,0.242914979757085,0.7489878542510121,0.008097165991902834
2012,TEXAS,CRANE,275,23,985,1283,0.21434138737334374,0.7677318784099766,0.017926734216679657
2012,TEXAS,CROCKETT,480,20,957,1457,0.32944406314344543,0.6568291008922443,0.013726835964310227
2012,TEXAS,CROSBY,639,16,1132,1787,0.35758254057078903,0.6334639059876889,0.008953553441522105
2012,TEXAS,CULBERSON,568,16,295,879,0.646188850967008,0.33560864618885095,0.01820250284414107
2012,TEXAS,DALLAM,253,33,1248,1534,0.16492829204693613,0.8135593220338984,0.02151238591916558
2012,TEXAS,DALLAS,405571,8733,295813,710117,0.5711326443388907,0.4165693822285623,0.012297973432547031
2012,TEXAS,DAWSON,1019,32,2591,3642,0.2797913234486546,0.7114222954420648,0.008786381109280615
2012,TEXAS,DEAF SMITH,1239,28,3042,4309,0.287537711766071,0.705964260849385,0.006498027384543977
2012,TEXAS,DELTA,454,40,1524,2018,0.22497522299306244,0.755203171456888,0.019821605550049554
2012,TEXAS,DENTON,80978,4224,157579,242781,0.3335433991951594,0.6490582047194797,0.01739839608536088
2012,TEXAS,DEWITT,1467,49,5122,6638,0.22100030129557097,0.7716179572160289,0.0073817414884001205
2012,TEXAS,DICKENS,216,10,793,1019,0.21197252208047104,0.7782139352306182,0.009813542688910697
2012,TEXAS,DIMMIT,2141,14,762,2917,0.7339732601988345,0.26122728830990743,0.0047994514912581415
2012,TEXAS,DONLEY,226,22,1287,1535,0.1472312703583062,0.8384364820846906,0.014332247557003257
2012,TEXAS,DUVAL,3331,33,980,4344,0.766804788213628,0.22559852670349909,0.007596685082872928
2012,TEXAS,EASTLAND,970,81,5444,6495,0.14934565050038492,0.8381832178598922,0.012471131639722863
2012,TEXAS,ECTOR,8118,385,24010,32513,0.24968474148802017,0.7384738412327376,0.01184141727924215
2012,TEXAS,EDWARDS,232,10,642,884,0.26244343891402716,0.7262443438914027,0.011312217194570135
2012,TEXAS,EL PASO,112952,2310,57150,172412,0.6551284133354986,0.33147344732385214,0.013398139340649142
2012,TEXAS,ELLIS,13881,696,39574,54151,0.2563387564403243,0.7308082953223394,0.012852948237336338
2012,TEXAS,ERATH,1965,179,10329,12473,0.15754028701996312,0.8281087148240199,0.014350998156016996
2012,TEXAS,FALLS,2033,45,3356,5434,0.3741258741258741,0.6175929333824071,0.008281192491718808
2012,TEXAS,FANNIN,2486,157,8161,10804,0.23009996297667532,0.7553683820807109,0.014531654942613846
2012,TEXAS,FAYETTE,2315,130,8106,10551,0.21941048241872807,0.7682684105771965,0.012321107004075443
2012,TEXAS,FISHER,512,23,1094,1629,0.31430325352977284,0.6715776550030693,0.014119091467157766
2012,TEXAS,FLOYD,551,11,1523,2085,0.2642685851318945,0.7304556354916067,0.005275779376498801
2012,TEXAS,FOARD,140,7,348,495,0.2828282828282828,0.703030303030303,0.014141414141414142
2012,TEXAS,FORT BEND,101144,2219,116126,219489,0.4608158039810651,0.5290743499674243,0.010109846051510553
2012,TEXAS,FRANKLIN,751,60,3446,4257,0.17641531595019966,0.8094902513507165,0.014094432699083862
2012,TEXAS,FREESTONE,1850,74,5646,7570,0.24438573315719947,0.7458388375165126,0.00977542932628798
2012,TEXAS,FRIO,2376,33,1559,3968,0.5987903225806451,0.3928931451612903,0.008316532258064516
2012,TEXAS,GAINES,535,47,3484,4066,0.13157894736842105,0.8568617806197737,0.011559272011805214
2012,TEXAS,GALVESTON,39511,1508,69059,110078,0.3589363905594215,0.6273642326350406,0.01369937680553789
2012,TEXAS,GARZA,279,18,1263,1560,0.17884615384615385,0.8096153846153846,0.011538461538461539
2012,TEXAS,GILLESPIE,2055,189,10306,12550,0.16374501992031873,0.821195219123506,0.015059760956175299
2012,TEXAS,GLASSCOCK,44,8,526,578,0.07612456747404844,0.9100346020761245,0.01384083044982699
2012,TEXAS,GOLIAD,1127,37,2294,3458,0.3259109311740891,0.6633892423366108,0.010699826489300174
2012,TEXAS,GONZALES,1777,64,4216,6057,0.29337956083869904,0.6960541522205712,0.010566286940729735
2012,TEXAS,GRAY,886,60,6443,7389,0.11990797130870212,0.8719718500473677,0.008120178643930167
2012,TEXAS,GRAYSON,10670,658,30936,42264,0.25246072307401096,0.7319704713231119,0.015568805602877153
2012,TEXAS,GREGG,12398,367,28742,41507,0.2986966053918616,0.6924615125159611,0.008841882092177223
2012,TEXAS,GRIMES,2339,121,6141,8601,0.2719451226601558,0.713986745727241,0.014068131612603186
2012,TEXAS,GUADALUPE,15744,653,33117,49514,0.3179706749606172,0.6688411358403684,0.01318818919901442
2012,TEXAS,HALE,2243,121,6490,8854,0.2533318274226338,0.7330020329794443,0.013666139597921843
2012,TEXAS,HALL,265,12,832,1109,0.23895401262398558,0.7502254283137962,0.010820559062218215
2012,TEXAS,HAMILTON,591,43,2918,3552,0.16638513513513514,0.821509009009009,0.012105855855855855
2012,TEXAS,HANSFORD,159,15,1788,1962,0.08103975535168195,0.9113149847094801,0.00764525993883792
2012,TEXAS,HARDEMAN,302,17,1176,1495,0.2020066889632107,0.7866220735785954,0.01137123745819398
2012,TEXAS,HARDIN,3359,192,17746,21297,0.15772174484669202,0.833262900878058,0.009015354275250036
2012,TEXAS,HARRIS,587044,15468,586073,1188585,0.49390157203733853,0.4930846342499695,0.013013793712691983
2012,TEXAS,HARRISON,8456,202,17512,26170,0.323118074130684,0.669163163928162,0.0077187619411539935
2012,TEXAS,HARTLEY,184,21,1708,1913,0.09618400418191322,0.8928384736016728,0.01097752221641401
2012,TEXAS,HASKELL,553,36,1424,2013,0.2747143566815698,0.7074018877297565,0.01788375558867362
2012,TEXAS,HAYS,25537,1813,31661,59011,0.4327498263035705,0.5365270881700022,0.030723085526427277
2012,TEXAS,HEMPHILL,192,19,1298,1509,0.1272365805168986,0.8601722995361166,0.012591119946984758
2012,TEXAS,HENDERSON,6106,290,21231,27627,0.22101567307344264,0.768487349332175,0.010496977594382307
2012,TEXAS,HIDALGO,97969,1325,39865,139159,0.7040076459301949,0.2864708714492056,0.009521482620599458
2012,TEXAS,HILL,2752,161,9132,12045,0.22847654628476546,0.7581569115815692,0.013366542133665421
2012,TEXAS,HOCKLEY,1486,102,5546,7134,0.2082982898794505,0.7774039809363611,0.014297729184188394
2012,TEXAS,HOOD,3843,283,18409,22535,0.17053472376303527,0.8169070335034391,0.012558242733525626
2012,TEXAS,HOPKINS,2777,140,9836,12753,0.2177526856425939,0.7712695052144594,0.010977809142946758
2012,TEXAS,HOUSTON,2265,69,5880,8214,0.27574872169466763,0.7158509861212564,0.008400292184075968
2012,TEXAS,HOWARD,2110,132,6453,8695,0.24266820011500861,0.7421506612995975,0.015181138585393904
2012,TEXAS,HUDSPETH,379,13,471,863,0.4391657010428737,0.5457705677867902,0.015063731170336037
2012,TEXAS,HUNT,6671,367,21011,28049,0.23783379086598452,0.749081963706371,0.01308424542764448
2012,TEXAS,HUTCHINSON,1045,79,6804,7928,0.13181130171543895,0.8582240161453077,0.00996468213925328
2012,TEXAS,IRION,112,8,668,788,0.14213197969543148,0.8477157360406091,0.01015228426395939
2012,TEXAS,JACK,303,25,2580,2908,0.10419532324621733,0.8872077028885832,0.00859697386519945
2012,TEXAS,JACKSON,1070,49,3906,5025,0.21293532338308457,0.7773134328358209,0.009751243781094527
2012,TEXAS,JASPER,3423,137,9957,13517,0.2532366649404454,0.7366279499889029,0.010135385070651771
2012,TEXAS,JEFF DAVIS,440,33,719,1192,0.3691275167785235,0.6031879194630873,0.027684563758389263
2012,TEXAS,JEFFERSON,44668,717,43242,88627,0.503999909734054,0.4879100048517946,0.008090085414151444
2012,TEXAS,JIM HOGG,1301,10,356,1667,0.7804439112177565,0.21355728854229153,0.00599880023995201
2012,TEXAS,JIM WELLS,6492,76,4598,11166,0.5814078452444922,0.41178577825541823,0.006806376500089558
2012,TEXAS,JOHNSON,10496,681,37661,48838,0.21491461566812728,0.7711413243785576,0.013944059953315041
2012,TEXAS,JONES,1226,79,4262,5567,0.22022633375246992,0.7655828992275912,0.014190767019938925
2012,TEXAS,KARNES,1325,35,2825,4185,0.31660692951015534,0.6750298685782556,0.008363201911589008
2012,TEXAS,KAUFMAN,9472,352,24846,34670,0.27320449956734927,0.7166426305162965,0.010152869916354198
2012,TEXAS,KENDALL,3043,232,14508,17783,0.17111848394534104,0.8158353483664174,0.01304616768824158
2012,TEXAS,KENEDY,82,1,84,167,0.49101796407185627,0.5029940119760479,0.005988023952095809
2012,TEXAS,KENT,66,4,335,405,0.16296296296296298,0.8271604938271605,0.009876543209876543
2012,TEXAS,KERR,4338,267,17274,21879,0.19827231591937475,0.7895242012889072,0.012203482791718085
2012,TEXAS,KIMBLE,217,8,1667,1892,0.11469344608879492,0.88107822410148,0.004228329809725159
2012,TEXAS,KING,5,1,139,145,0.034482758620689655,0.9586206896551724,0.006896551724137931
2012,TEXAS,KINNEY,522,23,880,1425,0.3663157894736842,0.6175438596491228,0.016140350877192983
2012,TEXAS,KLEBERG,4754,95,4058,8907,0.5337375098237341,0.4555967216795779,0.010665768496687999
2012,TEXAS,KNOX,332,18,1160,1510,0.21986754966887417,0.7682119205298014,0.011920529801324504
2012,TEXAS,LA SALLE,965,12,669,1646,0.586269744835966,0.40643985419198053,0.007290400972053463
2012,TEXAS,LAMAR,4181,190,12826,17197,0.24312380066290631,0.7458277606559284,0.01104843868116532
2012,TEXAS,LAMB,998,35,3058,4091,0.24395013444145686,0.7474945001222195,0.008555365436323637
2012,TEXAS,LAMPASAS,1479,104,5621,7204,0.2053026096612993,0.7802609661299278,0.014436424208772903
2012,TEXAS,LAVACA,1428,70,6796,8294,0.17217265493127562,0.8193875090426814,0.008439836026042922
2012,TEXAS,LEE,1632,82,4507,6221,0.262337244815946,0.7244815945989391,0.013181160585114933
2012,TEXAS,LEON,1062,69,5814,6945,0.15291576673866092,0.8371490280777538,0.009935205183585313
2012,TEXAS,LIBERTY,5202,221,17323,22746,0.22869955156950672,0.7615844544095666,0.009715994020926755
2012,TEXAS,LIMESTONE,2208,67,5288,7563,0.29194763982546607,0.6991934417559169,0.00885891841861695
2012,TEXAS,LIPSCOMB,119,5,1044,1168,0.10188356164383562,0.8938356164383562,0.004280821917808219
2012,TEXAS,LIVE OAK,919,40,3154,4113,0.22343787989302213,0.7668368587405786,0.009725261366399222
2012,TEXAS,LLANO,1822,126,7610,9558,0.19062565390249006,0.7961916718978865,0.013182674199623353
2012,TEXAS,LOVING,9,1,54,64,0.140625,0.84375,0.015625
2012,TEXAS,LUBBOCK,26271,1444,63469,91184,0.28810975609756095,0.696054132303913,0.01583611159852606
2012,TEXAS,LYNN,506,14,1439,1959,0.25829504849412965,0.734558448187851,0.0071465033180193975
2012,TEXAS,MADISON,967,33,3028,4028,0.2400695134061569,0.7517378351539226,0.008192651439920555
2012,TEXAS,MARION,1495,54,2733,4282,0.3491359177954227,0.638253152732368,0.012610929472209247
2012,TEXAS,MARTIN,248,8,1368,1624,0.15270935960591134,0.8423645320197044,0.0049261083743842365
2012,TEXAS,MASON,380,23,1565,1968,0.19308943089430894,0.7952235772357723,0.011686991869918699
2012,TEXAS,MATAGORDA,3980,113,8040,12133,0.32803098986235885,0.6626555674606445,0.00931344267699662
2012,TEXAS,MAVERICK,8303,89,2171,10563,0.7860456309760485,0.20552873236769856,0.008425636656252958
2012,TEXAS,MCCULLOCH,537,37,2419,2993,0.17941864350150352,0.8082191780821918,0.012362178416304711
2012,TEXAS,MCLENNAN,25694,944,47903,74541,0.3446962074562992,0.642639621148093,0.012664171395607786
2012,TEXAS,MCMULLEN,67,5,431,503,0.13320079522862824,0.856858846918489,0.009940357852882704
2012,TEXAS,MEDINA,4784,186,11079,16049,0.29808710823104245,0.6903233846345567,0.011589507134400897
2012,TEXAS,MENARD,171,13,665,849,0.20141342756183744,0.7832744405182568,0.015312131919905771
2012,TEXAS,MIDLAND,8286,622,35689,44597,0.18579725093616162,0.8002556225755095,0.013947126488328812
2012,TEXAS,MILAM,2636,113,5481,8230,0.3202916160388821,0.6659781287970838,0.013730255164034023
2012,TEXAS,MILLS,279,40,1882,2201,0.1267605633802817,0.8550658791458428,0.01817355747387551
2012,TEXAS,MITCHELL,538,22,1756,2316,0.23229706390328153,0.7582037996545768,0.009499136442141624
2012,TEXAS,MONTAGUE,1116,86,6549,7751,0.143981421752032,0.8449232357115211,0.01109534253644691
2012,TEXAS,MONTGOMERY,32920,2224,137969,173113,0.19016480564717844,0.7969880944816392,0.012847099871182406
2012,TEXAS,MOORE,964,53,3968,4985,0.19338014042126378,0.795987963891675,0.010631895687061183
2012,TEXAS,MORRIS,1858,49,3232,5139,0.3615489394823896,0.6289161315431018,0.00953492897450866
2012,TEXAS,MOTLEY,55,7,538,600,0.09166666666666666,0.8966666666666666,0.011666666666666667
2012,TEXAS,NACOGDOCHES,6465,263,13925,20653,0.3130295840797947,0.6742361884471989,0.012734227473006343
2012,TEXAS,NAVARRO,4350,167,10847,15364,0.2831293933871388,0.7060010413954699,0.010869565217391304
2012,TEXAS,NEWTON,1677,80,4112,5869,0.28573862668256944,0.7006304310785483,0.013630942238882263
2012,TEXAS,NOLAN,1216,77,3282,4575,0.26579234972677596,0.7173770491803279,0.016830601092896174
2012,TEXAS,NUECES,45772,1366,48966,96104,0.4762757013235661,0.5095105302588862,0.014213768417547656
2012,TEXAS,OCHILTREE,253,21,2719,2993,0.0845305713331106,0.908453057133311,0.0070163715335783495
2012,TEXAS,OLDHAM,71,8,790,869,0.08170310701956271,0.9090909090909091,0.009205983889528193
2012,TEXAS,ORANGE,6800,352,23366,30518,0.22281931974572383,0.7656465037027328,0.011534176551543351
2012,TEXAS,PALO PINTO,1811,133,7393,9337,0.1939595159044661,0.7917960801113848,0.014244403984149084
2012,TEXAS,PANOLA,2211,69,7950,10230,0.2161290322580645,0.7771260997067448,0.006744868035190616
2012,TEXAS,PARKER,7853,598,39243,47694,0.16465383486392418,0.8228079003648258,0.012538264771250052
2012,TEXAS,PARMER,529,14,2011,2554,0.2071260767423649,0.7873923257635083,0.00548159749412686
2012,TEXAS,PECOS,1591,47,2512,4150,0.3833734939759036,0.6053012048192771,0.011325301204819277
2012,TEXAS,POLK,4859,204,14071,19134,0.25394585554510296,0.7353924950350162,0.01066164941988084
2012,TEXAS,POTTER,7126,406,18918,26450,0.269413988657845,0.7152362948960302,0.015349716446124763
2012,TEXAS,PRESIDIO,1282,31,504,1817,0.7055586130985141,0.2773802971931756,0.0170610897083104
2012,TEXAS,RAINS,761,47,3279,4087,0.18620014680694885,0.8022999755321751,0.011499877660875948
2012,TEXAS,RANDALL,7574,675,41447,49696,0.15240663232453316,0.8340107855763039,0.01358258209916291
2012,TEXAS,REAGAN,158,9,676,843,0.1874258600237248,0.8018979833926453,0.010676156583629894
2012,TEXAS,REAL,277,22,1236,1535,0.18045602605863192,0.8052117263843648,0.014332247557003257
2012,TEXAS,RED RIVER,1482,43,3549,5074,0.2920772566022862,0.6994481671265274,0.00847457627118644
2012,TEXAS,REEVES,1655,34,1188,2877,0.5752519986096628,0.4129301355578728,0.011817865832464372
2012,TEXAS,REFUGIO,998,16,1663,2677,0.3728053791557714,0.6212177810982443,0.005976839745984311
2012,TEXAS,ROBERTS,33,7,468,508,0.06496062992125984,0.9212598425196851,0.013779527559055118
2012,TEXAS,ROBERTSON,2798,70,4419,7287,0.38397145601756555,0.6064223960477563,0.009606147934678195
2012,TEXAS,ROCKWALL,8120,445,27113,35678,0.2275912326924155,0.7599360950725937,0.012472672234990751
2012,TEXAS,RUNNELS,519,45,3104,3668,0.1414940021810251,0.8462377317339149,0.012268266085059978
2012,TEXAS,RUSK,4451,171,13924,18546,0.23999784320069018,0.7507818397498113,0.009220317049498545
2012,TEXAS,SABINE,807,44,3727,4578,0.17627785058977719,0.8141109654871123,0.009611183923110528
2012,TEXAS,SAN AUGUSTINE,1193,28,2469,3690,0.32330623306233064,0.6691056910569105,0.007588075880758808
2012,TEXAS,SAN JACINTO,2410,99,7107,9616,0.25062396006655574,0.7390806988352745,0.010295341098169717
2012,TEXAS,SAN PATRICIO,7856,217,12005,20078,0.39127403127801574,0.597918119334595,0.010807849387389183
2012,TEXAS,SAN SABA,323,31,1905,2259,0.14298362107127047,0.8432934926958832,0.013722886232846392
2012,TEXAS,SCHLEICHER,221,9,787,1017,0.21730580137659783,0.7738446411012783,0.008849557522123894
2012,TEXAS,SCURRY,838,65,4124,5027,0.1666998209667794,0.820370001989258,0.012930177043962602
2012,TEXAS,SHACKELFORD,131,14,1218,1363,0.09611151870873075,0.8936170212765957,0.010271460014673514
2012,TEXAS,SHELBY,2322,83,6879,9284,0.25010771219302025,0.740952175786299,0.008940112020680742
2012,TEXAS,SHERMAN,121,9,908,1038,0.11657032755298652,0.8747591522157996,0.008670520231213872
2012,TEXAS,SMITH,21456,814,57331,79601,0.2695443524578837,0.7202296453562141,0.010226002185902187
2012,TEXAS,SOMERVELL,613,54,2871,3538,0.17326172979084228,0.8114754098360656,0.015262860373092142
2012,TEXAS,STARR,10260,76,1547,11883,0.8634183287048726,0.1301859799713877,0.0063956913237397965
2012,TEXAS,STEPHENS,475,45,2892,3412,0.1392145369284877,0.8475967174677609,0.013188745603751465
2012,TEXAS,STERLING,31,4,459,494,0.06275303643724696,0.9291497975708503,0.008097165991902834
2012,TEXAS,STONEWALL,160,8,507,675,0.23703703703703705,0.7511111111111111,0.011851851851851851
2012,TEXAS,SUTTON,369,10,1110,1489,0.2478173270651444,0.7454667562122229,0.006715916722632639
2012,TEXAS,SWISHER,579,36,1655,2270,0.2550660792951542,0.7290748898678414,0.015859030837004406
2012,TEXAS,TARRANT,253071,8899,348920,610890,0.41426607081471295,0.5711666584818871,0.014567270703399958
2012,TEXAS,TAYLOR,9750,609,32904,43263,0.22536578600651827,0.7605575202829208,0.014076693710560988
2012,TEXAS,TERRELL,184,13,358,555,0.33153153153153153,0.645045045045045,0.023423423423423424
2012,TEXAS,TERRY,1059,48,2602,3709,0.28552170396333243,0.7015368023726072,0.012941493664060394
2012,TEXAS,THROCKMORTON,109,4,700,813,0.13407134071340712,0.8610086100861009,0.004920049200492005
2012,TEXAS,TITUS,2648,122,6084,8854,0.29907386491981025,0.6871470521798058,0.013779082900384007
2012,TEXAS,TOM GREEN,9294,548,26878,36720,0.2531045751633987,0.7319716775599129,0.014923747276688453
2012,TEXAS,TRAVIS,232788,14117,140152,387057,0.6014307970143933,0.36209653875269016,0.0364726642329166
2012,TEXAS,TRINITY,1614,84,4537,6235,0.2588612670408982,0.7276663993584603,0.01347233360064154
2012,TEXAS,TYLER,1668,76,5910,7654,0.21792526783381239,0.7721452835118892,0.009929448654298406
2012,TEXAS,UPSHUR,2971,152,12015,15138,0.19626106486986392,0.7936979785969085,0.01004095653322764
2012,TEXAS,UPTON,333,14,953,1300,0.2561538461538462,0.7330769230769231,0.010769230769230769
2012,TEXAS,UVALDE,3825,81,4529,8435,0.45346769413159455,0.5369294605809128,0.009602845287492591
2012,TEXAS,VAL VERDE,6285,161,5635,12081,0.5202383908616837,0.4664348977733631,0.013326711364953232
2012,TEXAS,VAN ZANDT,3084,222,15794,19100,0.16146596858638743,0.8269109947643979,0.01162303664921466
2012,TEXAS,VICTORIA,8802,359,19692,28853,0.3050635982393512,0.6824940214189166,0.012442380341732229
2012,TEXAS,WALKER,6252,293,12140,18685,0.3345999464811346,0.6497190259566498,0.01568102756221568
2012,TEXAS,WALLER,6514,144,9244,15902,0.4096340083008427,0.5813105269777387,0.00905546472141869
2012,TEXAS,WARD,841,38,2366,3245,0.25916795069337445,0.7291217257318953,0.011710323574730355
2012,TEXAS,WASHINGTON,3381,159,10857,14397,0.23484059178995625,0.754115440716816,0.011043967493227756
2012,TEXAS,WEBB,37597,435,11078,49110,0.7655670942781511,0.22557523925880676,0.00885766646304215
2012,TEXAS,WHARTON,4235,102,9750,14087,0.3006317881734933,0.6921274934336622,0.007240718392844466
2012,TEXAS,WHEELER,232,18,1878,2128,0.10902255639097744,0.8825187969924813,0.008458646616541353
2012,TEXAS,WICHITA,10525,681,29812,41018,0.25659466575649714,0.7268028670339851,0.016602467209517774
2012,TEXAS,WILBARGER,971,53,2956,3980,0.24396984924623116,0.742713567839196,0.013316582914572864
2012,TEXAS,WILLACY,3600,48,1416,5064,0.7109004739336493,0.2796208530805687,0.009478672985781991
2012,TEXAS,WILLIAMSON,61875,4390,97006,163271,0.3789711583808515,0.5941410293316021,0.026887812287546473
2012,TEXAS,WILSON,4821,166,12218,17205,0.28020924149956405,0.7101424004649811,0.00964835803545481
2012,TEXAS,WINKLER,398,16,1311,1725,0.23072463768115942,0.76,0.00927536231884058
2012,TEXAS,WISE,3221,317,17207,20745,0.15526632923596048,0.8294528802120993,0.015280790551940227
2012,TEXAS,WOOD,3056,174,14351,17581,0.173824014561174,0.8162789374893351,0.009897047949490928
2012,TEXAS,YOAKUM,409,21,1698,2128,0.19219924812030076,0.7979323308270677,0.009868421052631578
2012,TEXAS,YOUNG,992,99,6225,7316,0.13559322033898305,0.8508747949699289,0.013531984691088026
2012,TEXAS,ZAPATA,2527,19,997,3543,0.7132373694609089,0.2813999435506633,0.005362686988427886
2012,TEXAS,ZAVALA,3042,37,574,3653,0.8327402135231317,0.15713112510265534,0.010128661374212975
2012,UTAH,BEAVER,346,40,2174,2560,0.13515625,0.84921875,0.015625
2012,UTAH,BOX ELDER,1984,323,17101,19408,0.10222588623248145,0.8811314921681781,0.01664262159934048
2012,UTAH,CACHE,6244,1010,35039,42293,0.1476367247535053,0.8284822547466484,0.02388102049984631
2012,UTAH,CARBON,2275,202,5090,7567,0.30064754856614245,0.6726575921765561,0.026694859257301442
2012,UTAH,DAGGETT,94,20,406,520,0.18076923076923077,0.7807692307692308,0.038461538461538464
2012,UTAH,DAVIS,21889,2319,96861,121069,0.18079772691605614,0.8000479065656774,0.019154366518266443
2012,UTAH,DUCHESNE,581,100,5698,6379,0.09108010659978052,0.8932434550870042,0.015676438313215236
2012,UTAH,EMERY,569,103,3777,4449,0.12789390874353787,0.8489548213081591,0.02315126994830299
2012,UTAH,GARFIELD,308,42,1832,2182,0.14115490375802017,0.8395967002749771,0.01924839596700275
2012,UTAH,GRAND,1727,227,1996,3950,0.43721518987341773,0.5053164556962025,0.057468354430379745
2012,UTAH,IRON,2148,353,14200,16701,0.12861505299083886,0.8502484881144842,0.021136458894676965
2012,UTAH,JUAB,451,73,3448,3972,0.11354481369587109,0.8680765357502518,0.01837865055387714
2012,UTAH,KANE,744,105,2522,3371,0.22070602195194305,0.7481459507564521,0.031148027291604864
2012,UTAH,MILLARD,431,117,4478,5026,0.08575407879029048,0.8909669717469161,0.023278949462793474
2012,UTAH,MORGAN,403,80,4114,4597,0.08766586904502936,0.8949314770502501,0.01740265390472047
2012,UTAH,PIUTE,74,11,697,782,0.09462915601023018,0.8913043478260869,0.014066496163682864
2012,UTAH,RICH,83,9,915,1007,0.08242303872889771,0.9086395233366436,0.00893743793445879
2012,UTAH,SALT LAKE,146147,11841,223811,381799,0.3827851827794206,0.5862011162941757,0.031013700926403685
2012,UTAH,SAN JUAN,2139,94,3074,5307,0.4030525720746184,0.5792349726775956,0.017712455247785943
2012,UTAH,SANPETE,980,161,8406,9547,0.10265004713522573,0.8804860165497015,0.016863936315072797
2012,UTAH,SEVIER,738,124,7207,8069,0.09146114760193333,0.8931713967034329,0.015367455694633783
2012,UTAH,SUMMIT,8072,532,8884,17488,0.4615736505032022,0.5080054894784996,0.030420860018298263
2012,UTAH,TOOELE,4524,469,14268,19261,0.23487877057265977,0.7407715071906962,0.024349722236643997
2012,UTAH,UINTAH,997,165,10421,11583,0.08607441940775275,0.899680566347233,0.014245014245014245
2012,UTAH,UTAH,17281,3482,156950,177713,0.09724105721022097,0.8831655534485379,0.019593389341241215
2012,UTAH,WASATCH,2191,178,7220,9589,0.22849097924705392,0.7529460840546459,0.018562936698300135
2012,UTAH,WASHINGTON,8337,977,44698,54012,0.15435458786936238,0.8275568392209138,0.018088572909723766
2012,UTAH,WAYNE,215,23,1089,1327,0.16201959306706856,0.8206480783722683,0.01733232856066315
2012,UTAH,WEBER,19841,1847,54224,75912,0.26136842659922016,0.7143007693118347,0.024330804088945095
2012,VERMONT,ADDISON,12257,450,5203,17910,0.6843662758235622,0.29050809603573424,0.02512562814070352
2012,VERMONT,BENNINGTON,11514,392,5687,17593,0.6544648439720343,0.3232535667595066,0.022281589268459048
2012,VERMONT,CALEDONIA,8192,381,5088,13661,0.5996632750164702,0.3724471122172608,0.027889612766268942
2012,VERMONT,CHITTENDEN,53626,1883,21571,77080,0.6957187337830825,0.27985210171250646,0.024429164504411002
2012,VERMONT,ESSEX,1539,95,1164,2798,0.550035739814153,0.41601143674052893,0.03395282344531808
2012,VERMONT,FRANKLIN,12057,426,7405,19888,0.606244971842317,0.3723350764279968,0.02141995172968624
2012,VERMONT,GRAND ISLE,2531,73,1471,4075,0.6211042944785276,0.36098159509202454,0.017914110429447853
2012,VERMONT,LAMOILLE,8371,275,3342,11988,0.6982816149482817,0.27877877877877877,0.022939606272939606
2012,VERMONT,ORANGE,9076,389,4588,14053,0.6458407457482388,0.3264783320287483,0.02768092222301288
2012,VERMONT,ORLEANS,7117,269,4306,11692,0.6087068080738967,0.36828600752651386,0.023007184399589462
2012,VERMONT,RUTLAND,17088,686,10835,28609,0.5972945576566815,0.3787269740291517,0.02397846831416687
2012,VERMONT,WASHINGTON,20351,863,8093,29307,0.6944074794417716,0.2761456307366841,0.02944688982154434
2012,VERMONT,WINDHAM,16026,564,5347,21937,0.7305465651638784,0.24374344714409446,0.02570998769202717
2012,VERMONT,WINDSOR,19494,607,8598,28699,0.6792571169727168,0.29959232028990557,0.021150562737377608
2012,VIRGINIA,ACCOMACK,7655,183,8213,16051,0.4769173260233007,0.5116815151703944,0.011401158806304903
2012,VIRGINIA,ALBEMARLE,29757,853,23297,53907,0.5520062329567589,0.4321702190810099,0.01582354796223125
2012,VIRGINIA,ALEXANDRIA,52199,963,20249,73411,0.7110514772990424,0.27583059759436596,0.013117925106591655
2012,VIRGINIA,ALLEGHANY,3403,175,3595,7173,0.47441795622473165,0.5011849993029416,0.02439704447232678
2012,VIRGINIA,AMELIA,2490,94,4331,6915,0.3600867678958785,0.6263195950831526,0.013593637020968908
2012,VIRGINIA,AMHERST,5900,194,8876,14970,0.39412157648630597,0.5929191716766867,0.012959251837007349
2012,VIRGINIA,APPOMATTOX,2453,142,5340,7935,0.30913673597983615,0.6729678638941399,0.017895400126023944
2012,VIRGINIA,ARLINGTON,81269,1865,34474,117608,0.6910159172845385,0.2931263179375553,0.015857764777906264
2012,VIRGINIA,AUGUSTA,9451,597,23624,33672,0.2806783083867902,0.701591827037301,0.017729864575908767
2012,VIRGINIA,BATH,894,55,1274,2223,0.40215924426450744,0.5730994152046783,0.024741340530814216
2012,VIRGINIA,BEDFORD,11434,590,28206,40230,0.2842157593835446,0.7011185682326622,0.01466567238379319
2012,VIRGINIA,BLAND,735,69,2144,2948,0.24932157394843962,0.7272727272727273,0.023405698778833108
2012,VIRGINIA,BOTETOURT,5452,310,12479,18241,0.2988871224165342,0.6841181952743819,0.016994682309083933
2012,VIRGINIA,BRISTOL,2492,115,4780,7387,0.3373493975903614,0.6470827128739678,0.015567889535670773
2012,VIRGINIA,BRUNSWICK,4994,75,2968,8037,0.6213761353738957,0.36929202438720915,0.00933184023889511
2012,VIRGINIA,BUCHANAN,3094,116,6436,9646,0.32075471698113206,0.6672195728799503,0.012025710138917687
2012,VIRGINIA,BUCKINGHAM,3750,138,3569,7457,0.5028831969961111,0.47861070135443207,0.018506101649456885
2012,VIRGINIA,BUENA VISTA,919,43,1564,2526,0.36381631037212986,0.6191607284243864,0.017022961203483768
2012,VIRGINIA,CAMPBELL,7595,406,17695,25696,0.29557129514321295,0.6886285803237858,0.015800124533001246
2012,VIRGINIA,CAROLINE,7276,225,6151,13652,0.53296220334017,0.4505566949897451,0.016481101670084968
2012,VIRGINIA,CARROLL,3685,497,8736,12918,0.2852608762966403,0.6762656758012077,0.038473447902152035
2012,VIRGINIA,CHARLES CITY,2772,64,1396,4232,0.6550094517958412,0.32986767485822305,0.015122873345935728
2012,VIRGINIA,CHARLOTTE,2503,84,3311,5898,0.42438114615123773,0.5613767378772465,0.014242115971515769
2012,VIRGINIA,CHARLOTTESVILLE,16510,443,4844,21797,0.7574436849107675,0.22223241730513374,0.02032389778409873
2012,VIRGINIA,CHESAPEAKE,55052,1473,53900,110425,0.49854652479058187,0.48811410459587956,0.013339370613538602
2012,VIRGINIA,CHESTERFIELD,77694,2360,90934,170988,0.45438276370271596,0.5318150981355417,0.013802138161742344
2012,VIRGINIA,CLARKE,3239,227,4296,7762,0.4172893584127802,0.5534656016490596,0.02924503993816027
2012,VIRGINIA,COLONIAL HEIGHTS,2544,139,5941,8624,0.2949907235621521,0.68889146567718,0.016117810760667903
2012,VIRGINIA,COVINGTON,1319,36,975,2330,0.5660944206008584,0.4184549356223176,0.015450643776824034
2012,VIRGINIA,CRAIG,830,80,1757,2667,0.31121109861267343,0.6587926509186351,0.029996250468691414
2012,VIRGINIA,CULPEPER,8285,346,11580,20211,0.40992528820939095,0.5729553213596557,0.01711939043095344
2012,VIRGINIA,CUMBERLAND,2422,88,2538,5048,0.47979397781299526,0.5027733755942948,0.017432646592709985
2012,VIRGINIA,DANVILLE,12218,223,7763,20204,0.6047317362898436,0.384230845377153,0.011037418333003366
2012,VIRGINIA,DICKENSON,2473,157,4274,6904,0.3581981460023175,0.6190614136732329,0.022740440324449593
2012,VIRGINIA,DINWIDDIE,6550,164,6875,13589,0.4820075060710869,0.5059239090440798,0.012068584884833321
2012,VIRGINIA,EMPORIA,1793,17,886,2696,0.6650593471810089,0.32863501483679525,0.006305637982195846
2012,VIRGINIA,ESSEX,3016,57,2602,5675,0.5314537444933921,0.4585022026431718,0.010044052863436124
2012,VIRGINIA,FAIRFAX,321924,7444,211548,540916,0.5951460115803563,0.39109214739441983,0.013761841025223879
2012,VIRGINIA,FALLS CHURCH,5015,114,2147,7276,0.6892523364485982,0.2950797141286421,0.015667949422759758
2012,VIRGINIA,FAUQUIER,13965,556,21034,35555,0.39277176205878217,0.5915904936014625,0.01563774433975531
2012,VIRGINIA,FLOYD,2732,239,4673,7644,0.3574045002616431,0.6113291470434328,0.03126635269492412
2012,VIRGINIA,FLUVANNA,5893,178,6678,12749,0.4622323319476037,0.5238057886893089,0.013961879363087302
2012,VIRGINIA,FRANKLIN,11923,930,18214,31067,0.38378343580004504,0.5862812630765765,0.029935301123378503
2012,VIRGINIA,FREDERICK,12690,846,22858,36394,0.3486838489860966,0.628070561081497,0.02324558993240644
2012,VIRGINIA,FREDERICKSBURG,7131,246,4060,11437,0.6235026667832474,0.3549881962052986,0.021509137011454054
2012,VIRGINIA,GALAX,900,45,1332,2277,0.3952569169960474,0.5849802371541502,0.019762845849802372
2012,VIRGINIA,GILES,2730,168,4660,7558,0.3612066684308018,0.6165652288965334,0.022228102672664726
2012,VIRGINIA,GLOUCESTER,6764,382,12137,19283,0.35077529430067933,0.6294145101903231,0.019810195508997562
2012,VIRGINIA,GOOCHLAND,4676,191,8448,13315,0.3511828764551258,0.6344723995493804,0.014344723995493804
2012,VIRGINIA,GRAYSON,2068,252,4801,7121,0.29040865047043957,0.6742030613677854,0.035388288161775035
2012,VIRGINIA,GREENE,3290,164,5569,9023,0.3646237393328161,0.6172004876426909,0.018175773024492962
2012,VIRGINIA,GREENSVILLE,3135,25,1766,4926,0.6364190012180267,0.35850588712951686,0.005075111652456354
2012,VIRGINIA,HALIFAX,7766,232,8694,16692,0.46525281572010546,0.5208483105679368,0.013898873711957823
2012,VIRGINIA,HAMPTON,46966,884,18640,66490,0.7063618589261543,0.2803429087080764,0.013295232365769289
2012,VIRGINIA,HANOVER,18294,824,39940,59058,0.3097632835517627,0.6762843306579972,0.013952385790240104
2012,VIRGINIA,HARRISONBURG,8654,374,6565,15593,0.5549926248957866,0.42102225357532225,0.02398512152889117
2012,VIRGINIA,HENRICO,89594,2198,70449,162241,0.5522278585560987,0.43422439457350487,0.01354774687039651
2012,VIRGINIA,HENRY,10317,662,13984,24963,0.41329167167407765,0.5601890798381605,0.02651924848776189
2012,VIRGINIA,HIGHLAND,459,30,924,1413,0.3248407643312102,0.6539278131634819,0.021231422505307854
2012,VIRGINIA,HOPEWELL,5179,113,3739,9031,0.5734691617761045,0.4140183811316576,0.012512457092237847
2012,VIRGINIA,ISLE OF WIGHT,8761,264,11802,20827,0.42065587938733373,0.5666682671532146,0.012675853459451674
2012,VIRGINIA,JAMES CITY,17879,518,22843,41240,0.4335354025218235,0.5539039767216295,0.012560620756547042
2012,VIRGINIA,KING AND QUEEN,1745,45,1865,3655,0.4774281805745554,0.5102599179206566,0.012311901504787962
2012,VIRGINIA,KING GEORGE,4477,244,6604,11325,0.39532008830022075,0.5831346578366446,0.021545253863134658
2012,VIRGINIA,KING WILLIAM,3344,113,5466,8923,0.37476185139527063,0.6125742463297097,0.012663902275019612
2012,VIRGINIA,LANCASTER,3149,59,3753,6961,0.4523775319637983,0.5391466743284011,0.008475793707800603
2012,VIRGINIA,LEE,2583,168,6847,9598,0.2691185663679933,0.7133777870389665,0.017503646593040215
2012,VIRGINIA,LEXINGTON,1486,55,1146,2687,0.5530331224413845,0.4264979531075549,0.020468924451060664
2012,VIRGINIA,LOUDOUN,82479,2289,75292,160060,0.5153005123078845,0.4703986005248032,0.014300887167312258
2012,VIRGINIA,LOUISA,6953,284,9215,16452,0.42262338925358617,0.5601142718210552,0.017262338925358618
2012,VIRGINIA,LUNENBURG,2684,81,2969,5734,0.46808510638297873,0.5177886292291594,0.014126264387861876
2012,VIRGINIA,LYNCHBURG,15948,694,19806,36448,0.4375548726953468,0.5434043020193152,0.019040825285338014
2012,VIRGINIA,MADISON,2639,106,3869,6614,0.3990021167221046,0.5849712730571515,0.016026610220743878
2012,VIRGINIA,MANASSAS,8478,259,6463,15200,0.5577631578947368,0.42519736842105266,0.017039473684210528
2012,VIRGINIA,MANASSAS PARK,2879,78,1699,4656,0.6183419243986255,0.3649054982817869,0.01675257731958763
2012,VIRGINIA,MARTINSVILLE,3855,117,2312,6284,0.6134627625716105,0.3679185232336092,0.018618714194780395
2012,VIRGINIA,MATHEWS,1807,79,3488,5374,0.3362486043915147,0.6490509862299962,0.01470040937848902
2012,VIRGINIA,MECKLENBURG,6921,183,7973,15077,0.45904357630828413,0.528818730516681,0.012137693175034821
2012,VIRGINIA,MIDDLESEX,2370,91,3619,6080,0.38980263157894735,0.5952302631578947,0.014967105263157894
2012,VIRGINIA,MONTGOMERY,19903,1100,20006,41009,0.4853324879904411,0.4878441317759516,0.026823380233607256
2012,VIRGINIA,NELSON,4171,132,3947,8250,0.5055757575757576,0.4784242424242424,0.016
2012,VIRGINIA,NEW KENT,3555,152,7246,10953,0.3245686113393591,0.6615539121701817,0.013877476490459235
2012,VIRGINIA,NEWPORT NEWS,51100,1114,27230,79444,0.6432203816524847,0.34275716227783093,0.014022456069684306
2012,VIRGINIA,NORFOLK,62687,1209,23147,87043,0.7201842767367853,0.26592603655664443,0.013889686706570316
2012,VIRGINIA,NORTHAMPTON,3741,74,2676,6491,0.5763364658758281,0.41226313356955785,0.011400400554614082
2012,VIRGINIA,NORTHUMBERLAND,3191,57,4310,7558,0.42220164064567345,0.5702566816618153,0.007541677692511246
2012,VIRGINIA,NORTON,566,31,895,1492,0.37935656836461124,0.5998659517426274,0.020777479892761394
2012,VIRGINIA,NOTTOWAY,3344,93,3409,6846,0.48846041484078295,0.49795501022494887,0.013584574934268186
2012,VIRGINIA,ORANGE,6870,240,9244,16354,0.42008071419836124,0.5652439770086829,0.014675308792955852
2012,VIRGINIA,PAGE,3724,160,6344,10228,0.3640985529917872,0.6202581149784904,0.01564333202972233
2012,VIRGINIA,PATRICK,2417,220,5622,8259,0.29265044194212375,0.6807119505993462,0.02663760745853009
2012,VIRGINIA,PETERSBURG,14283,98,1527,15908,0.8978501382951973,0.09598943927583606,0.006160422428966558
2012,VIRGINIA,PITTSYLVANIA,10858,560,19263,30681,0.35389980769857565,0.6278478537205436,0.018252338580880677
2012,VIRGINIA,POQUOSON,1679,115,5312,7106,0.2362792006754855,0.7475372924289333,0.0161835068955812
2012,VIRGINIA,PORTSMOUTH,32501,563,12858,45922,0.7077435651757328,0.279996515831192,0.012259918993075214
2012,VIRGINIA,POWHATAN,4088,237,11200,15525,0.26331723027375203,0.7214170692431562,0.015265700483091787
2012,VIRGINIA,PRINCE EDWARD,5132,155,3952,9239,0.5554713713605368,0.42775192120359345,0.016776707435869682
2012,VIRGINIA,PRINCE GEORGE,6991,176,8879,16046,0.4356849058955503,0.5533466284432257,0.01096846566122398
2012,VIRGINIA,PRINCE WILLIAM,103331,2406,74458,180195,0.5734398845694941,0.41320791364910237,0.01335220178140348
2012,VIRGINIA,PULASKI,5292,468,8920,14680,0.36049046321525885,0.6076294277929155,0.03188010899182561
2012,VIRGINIA,RADFORD,2732,147,2520,5399,0.5060196332654195,0.46675310242637524,0.027227264308205223
2012,VIRGINIA,RAPPAHANNOCK,1980,66,2311,4357,0.4544411292173514,0.5304108331420703,0.01514803764057838
2012,VIRGINIA,RICHMOND,77495,1634,22210,101339,0.7647105260561087,0.21916537562044228,0.016124098323449017
2012,VIRGINIA,ROANOKE,42845,1912,46615,91372,0.46890732390666723,0.5101672284726174,0.02092544762071532
2012,VIRGINIA,ROCKBRIDGE,4088,191,5898,10177,0.4016900854868822,0.5795421047459959,0.018767809767121942
2012,VIRGINIA,ROCKINGHAM,10065,615,24186,34866,0.28867664773705043,0.6936843916709688,0.017638960591980727
2012,VIRGINIA,RUSSELL,3718,190,8180,12088,0.307577763070814,0.6767041694242224,0.0157180675049636
2012,VIRGINIA,SALEM,4760,259,7299,12318,0.38642636791686963,0.5925474914758889,0.021026140607241436
2012,VIRGINIA,SCOTT,2395,158,7439,9992,0.23969175340272217,0.7444955964771818,0.015812650120096076
2012,VIRGINIA,SHENANDOAH,6469,366,12538,19373,0.33391833995767306,0.6471893872915914,0.01889227275073556
2012,VIRGINIA,SMYTH,4171,227,8379,12777,0.3264459575800266,0.6557877436017845,0.017766298818188933
2012,VIRGINIA,SOUTHAMPTON,4437,94,4733,9264,0.4789507772020725,0.5109024179620034,0.010146804835924008
2012,VIRGINIA,SPOTSYLVANIA,25165,965,31844,57974,0.4340738951943975,0.5492807120433297,0.016645392762272743
2012,VIRGINIA,STAFFORD,27182,921,32480,60583,0.4486737203505934,0.5361239951801661,0.015202284469240546
2012,VIRGINIA,STAUNTON,5728,210,5272,11210,0.5109723461195361,0.47029438001784124,0.01873327386262266
2012,VIRGINIA,SUFFOLK,24267,479,17820,42566,0.5701028990273928,0.418643988159564,0.011253112813043274
2012,VIRGINIA,SURRY,2576,61,1671,4308,0.5979572887650882,0.387883008356546,0.014159702878365831
2012,VIRGINIA,SUSSEX,3358,61,2021,5440,0.6172794117647059,0.3715073529411765,0.011213235294117647
2012,VIRGINIA,TAZEWELL,3661,228,13843,17732,0.20646289194676293,0.7806789984209339,0.012858109632303182
2012,VIRGINIA,VIRGINIA BEACH,94299,3051,99291,196641,0.4795490258898195,0.5049353898729156,0.015515584237264863
2012,VIRGINIA,WARREN,6452,377,9869,16698,0.3863935800694694,0.5910288657324231,0.022577554198107558
2012,VIRGINIA,WASHINGTON,7076,415,18141,25632,0.2760611735330836,0.7077481273408239,0.016190699126092386
2012,VIRGINIA,WAYNESBORO,3840,161,4790,8791,0.43681037424638836,0.5448754407917188,0.018314184961892844
2012,VIRGINIA,WESTMORELAND,4295,94,3731,8120,0.5289408866995073,0.45948275862068966,0.011576354679802956
2012,VIRGINIA,WILLIAMSBURG,4903,163,2682,7748,0.6328084667010841,0.34615384615384615,0.021037687145069695
2012,VIRGINIA,WINCHESTER,5094,256,4946,10296,0.49475524475524474,0.48038073038073037,0.024864024864024864
2012,VIRGINIA,WISE,3760,182,11076,15018,0.25036622719403384,0.7375149820215741,0.012118790784392063
2012,VIRGINIA,WYTHE,3783,251,8324,12358,0.30611749474024924,0.6735717753681826,0.020310729891568215
2012,VIRGINIA,YORK,13183,566,20204,33953,0.3882720230907431,0.5950578741201072,0.016670102789149707
2012,WASHINGTON,ADAMS,1540,82,3171,4793,0.3213018986021281,0.6615898184852911,0.017108282912580847
2012,WASHINGTON,ASOTIN,4003,244,5654,9901,0.4043025956974043,0.5710534289465711,0.024643975356024642
2012,WASHINGTON,BENTON,28145,1953,49461,79559,0.353762616423032,0.6216895637200065,0.0245478198569615
2012,WASHINGTON,CHELAN,13112,736,18402,32250,0.4065736434108527,0.5706046511627907,0.02282170542635659
2012,WASHINGTON,CLALLAM,18580,1049,18437,38066,0.4880996164556297,0.4843429832396364,0.027557400304733883
2012,WASHINGTON,CLARK,93382,4472,92951,190805,0.489410654857053,0.4871518041980032,0.02343754094494379
2012,WASHINGTON,COLUMBIA,645,46,1568,2259,0.2855245683930943,0.6941124391323594,0.02036299247454626
2012,WASHINGTON,COWLITZ,22726,1148,20746,44620,0.509323173464814,0.46494845360824744,0.02572837292693859
2012,WASHINGTON,DOUGLAS,5166,351,9425,14942,0.3457368491500468,0.6307723196359256,0.023490831214027574
2012,WASHINGTON,FERRY,1294,151,1995,3440,0.37616279069767444,0.5799418604651163,0.0438953488372093
2012,WASHINGTON,FRANKLIN,8398,497,13748,22643,0.37088724992271344,0.6071633617453518,0.021949388331934813
2012,WASHINGTON,GARFIELD,336,29,913,1278,0.26291079812206575,0.7143974960876369,0.02269170579029734
2012,WASHINGTON,GRANT,8950,756,17852,27558,0.32476957689237246,0.647797372813702,0.027433050293925537
2012,WASHINGTON,GRAYS HARBOR,15960,810,11914,28684,0.5564077534514015,0.4153535071817041,0.028238739366894437
2012,WASHINGTON,ISLAND,21478,1016,19605,42099,0.510178389035369,0.4656880210931376,0.024133589871493385
2012,WASHINGTON,JEFFERSON,12739,685,6405,19829,0.6424428866811236,0.3230117504664885,0.03454536285238791
2012,WASHINGTON,KING,668004,23450,275700,967154,0.6906904174516157,0.2850631853872289,0.024246397161155307
2012,WASHINGTON,KITSAP,67277,3244,52846,123367,0.5453403260191138,0.42836414924574645,0.026295524735139866
2012,WASHINGTON,KITTITAS,7949,440,9782,18171,0.43745528589510757,0.5383303065323868,0.02421440757250564
2012,WASHINGTON,KLICKITAT,4598,360,5316,10274,0.4475374732334047,0.5174226202063461,0.035039906560249176
2012,WASHINGTON,LEWIS,12664,928,20452,34044,0.3719891904594055,0.6007519680413582,0.027258841499236283
2012,WASHINGTON,LINCOLN,1673,136,4063,5872,0.2849114441416894,0.6919277929155313,0.02316076294277929
2012,WASHINGTON,MASON,14764,710,12761,28235,0.5228971135115991,0.45195679121657517,0.02514609527182575
2012,WASHINGTON,OKANOGAN,7108,517,9221,16846,0.4219399263920218,0.5473702956191381,0.03068977798884008
2012,WASHINGTON,PACIFIC,5711,314,4499,10524,0.5426643861649563,0.427499049790954,0.0298365640440897
2012,WASHINGTON,PEND OREILLE,2508,208,3952,6668,0.376124775044991,0.5926814637072585,0.03119376124775045
2012,WASHINGTON,PIERCE,186430,8013,148467,342910,0.5436703508209151,0.4329620016914059,0.023367647487678982
2012,WASHINGTON,SAN JUAN,7125,358,3111,10594,0.6725505002831792,0.2936567868604871,0.03379271285633378
2012,WASHINGTON,SKAGIT,28688,1510,25071,55269,0.5190613182796866,0.4536177604081854,0.027320921312127957
2012,WASHINGTON,SKAMANIA,2628,151,2687,5466,0.4807903402854007,0.4915843395536041,0.027625320160995243
2012,WASHINGTON,SNOHOMISH,188516,8285,133016,329817,0.5715775718049706,0.40330243741226196,0.025119990782767415
2012,WASHINGTON,SPOKANE,102295,6250,115285,223830,0.45702095340213555,0.5150560693383371,0.02792297725952732
2012,WASHINGTON,STEVENS,7762,708,13691,22161,0.350254952393845,0.6177970308199089,0.031948016786246106
2012,WASHINGTON,THURSTON,74037,3739,49287,127063,0.5826794582215121,0.387894194218616,0.029426347559871873
2012,WASHINGTON,WAHKIAKUM,1094,81,1119,2294,0.4768962510897995,0.48779424585876197,0.03530950305143853
2012,WASHINGTON,WALLA WALLA,9768,692,14648,25108,0.3890393500079656,0.5833997132388083,0.027560936753226063
2012,WASHINGTON,WHATCOM,57089,3237,42703,103029,0.554106125459822,0.41447553601413195,0.031418338526046065
2012,WASHINGTON,WHITMAN,8037,577,8507,17121,0.46942351498160156,0.4968751825243853,0.0337013024940132
2012,WASHINGTON,YAKIMA,33217,1517,42239,76973,0.43154092993647125,0.5487508606914113,0.019708209372117497
2012,WEST VIRGINIA,BARBOUR,1768,169,3824,5761,0.30689116472834577,0.6637736504079152,0.029335184863738935
2012,WEST VIRGINIA,BERKELEY,14275,741,22156,37172,0.38402561067470137,0.5960400301302056,0.01993435919509308
2012,WEST VIRGINIA,BOONE,2790,243,5467,8500,0.32823529411764707,0.6431764705882353,0.028588235294117647
2012,WEST VIRGINIA,BRAXTON,1998,81,2725,4804,0.41590341382181517,0.5672356369691923,0.016860949208992507
2012,WEST VIRGINIA,BROOKE,4005,229,5060,9294,0.43092317624273724,0.5444372713578652,0.02463955239939746
2012,WEST VIRGINIA,CABELL,13568,591,17985,32144,0.4221005475360876,0.5595134395221503,0.01838601294176207
2012,WEST VIRGINIA,CALHOUN,818,70,1319,2207,0.37063887630267334,0.5976438604440417,0.031717263253285
2012,WEST VIRGINIA,CLAY,931,110,1971,3012,0.3090969455511288,0.6543824701195219,0.03652058432934927
2012,WEST VIRGINIA,DODDRIDGE,575,64,2130,2769,0.20765619357168652,0.7692307692307693,0.02311303719754424
2012,WEST VIRGINIA,FAYETTE,5419,301,8350,14070,0.3851457000710732,0.5934612651030562,0.021393034825870648
2012,WEST VIRGINIA,GILMER,840,74,1595,2509,0.33479473893981665,0.6357114388202472,0.02949382223993623
2012,WEST VIRGINIA,GRANT,718,85,3783,4586,0.15656345399040558,0.8249018752725686,0.01853467073702573
2012,WEST VIRGINIA,GREENBRIER,4710,323,7930,12963,0.3633418190233742,0.6117411093111162,0.02491707166550953
2012,WEST VIRGINIA,HAMPSHIRE,2299,164,5523,7986,0.2878787878787879,0.6915852742299023,0.02053593789130979
2012,WEST VIRGINIA,HANCOCK,4627,265,7226,12118,0.3818286846014194,0.5963030203003796,0.021868295098201023
2012,WEST VIRGINIA,HARDY,1482,150,3536,5168,0.2867647058823529,0.6842105263157895,0.029024767801857584
2012,WEST VIRGINIA,HARRISON,9732,539,15876,26147,0.37220331204344664,0.6071824683520098,0.020614219604543543
2012,WEST VIRGINIA,JACKSON,3854,282,7408,11544,0.3338530838530839,0.6417186417186417,0.02442827442827443
2012,WEST VIRGINIA,JEFFERSON,10398,482,11258,22138,0.46969012557593276,0.5085373565814437,0.021772517842623542
2012,WEST VIRGINIA,KANAWHA,32480,1233,41364,75077,0.4326225075589062,0.5509543535303755,0.016423138910718327
2012,WEST VIRGINIA,LEWIS,1736,176,4375,6287,0.27612533799904565,0.6958803881024336,0.027994273898520758
2012,WEST VIRGINIA,LINCOLN,2227,208,4383,6818,0.3266353769433852,0.6428571428571429,0.030507480199471988
2012,WEST VIRGINIA,LOGAN,3469,255,8222,11946,0.29039008873263017,0.6882638540097104,0.02134605725765947
2012,WEST VIRGINIA,MARION,8959,529,12054,21542,0.4158852474236375,0.5595580726023582,0.02455667997400427
2012,WEST VIRGINIA,MARSHALL,4484,297,8135,12916,0.3471663053576959,0.6298389594301641,0.02299473521213998
2012,WEST VIRGINIA,MASON,3778,270,5741,9789,0.3859434058637246,0.5864746143630606,0.027581979773214832
2012,WEST VIRGINIA,MCDOWELL,2109,120,3959,6188,0.34082094376212024,0.6397866839043309,0.019392372333548805
2012,WEST VIRGINIA,MERCER,5432,394,15450,21276,0.2553111487121639,0.7261703327693175,0.018518518518518517
2012,WEST VIRGINIA,MINERAL,2885,261,7833,10979,0.2627743874669824,0.7134529556425904,0.02377265689042718
2012,WEST VIRGINIA,MINGO,2428,211,6191,8830,0.27497168742921857,0.701132502831257,0.02389580973952435
2012,WEST VIRGINIA,MONONGALIA,13826,818,16831,31475,0.43926926131850674,0.5347418586179508,0.025988880063542493
2012,WEST VIRGINIA,MONROE,1455,141,3616,5212,0.2791634689178818,0.693783576362241,0.027052954719877207
2012,WEST VIRGINIA,MORGAN,2363,168,4513,7044,0.3354628052243044,0.64068710959682,0.02385008517887564
2012,WEST VIRGINIA,NICHOLAS,2664,223,5898,8785,0.3032441661923734,0.671371656232214,0.025384177575412635
2012,WEST VIRGINIA,OHIO,6786,357,10768,17911,0.37887331807269276,0.6011947964937748,0.019931885433532467
2012,WEST VIRGINIA,PENDLETON,1074,70,2095,3239,0.3315838221673356,0.6468045693115159,0.021611608521148504
2012,WEST VIRGINIA,PLEASANTS,955,60,1825,2840,0.3362676056338028,0.6426056338028169,0.02112676056338028
2012,WEST VIRGINIA,POCAHONTAS,1303,91,2182,3576,0.3643736017897092,0.610178970917226,0.025447427293064876
2012,WEST VIRGINIA,PRESTON,2931,335,7889,11155,0.26275212909009416,0.7072164948453609,0.03003137606454505
2012,WEST VIRGINIA,PUTNAM,7256,385,16032,23673,0.3065095256199045,0.677227220884552,0.016263253495543445
2012,WEST VIRGINIA,RALEIGH,7739,476,20614,28829,0.2684449686079989,0.7150438794269659,0.016511151965035206
2012,WEST VIRGINIA,RANDOLPH,3342,254,6160,9756,0.34255842558425587,0.6314063140631406,0.026035260352603527
2012,WEST VIRGINIA,RITCHIE,768,99,2921,3788,0.20274551214361142,0.7711193241816262,0.02613516367476241
2012,WEST VIRGINIA,ROANE,1939,126,2982,5047,0.3841886269070735,0.5908460471567267,0.024965325936199722
2012,WEST VIRGINIA,SUMMERS,1621,133,2981,4735,0.3423442449841605,0.6295670538542767,0.02808870116156283
2012,WEST VIRGINIA,TAYLOR,1941,127,3840,5908,0.3285375761679079,0.6499661475964793,0.02149627623561273
2012,WEST VIRGINIA,TUCKER,880,82,2176,3138,0.2804333970681963,0.6934353091140854,0.026131293817718292
2012,WEST VIRGINIA,TYLER,890,75,2314,3279,0.27142421469960354,0.7057029582189692,0.022872827081427266
2012,WEST VIRGINIA,UPSHUR,2158,176,5939,8273,0.2608485434546114,0.7178774326121117,0.021274023933276924
2012,WEST VIRGINIA,WAYNE,4931,336,8688,13955,0.3533500537441777,0.622572554639914,0.024077391615908276
2012,WEST VIRGINIA,WEBSTER,947,98,1710,2755,0.34373865698729583,0.6206896551724138,0.035571687840290384
2012,WEST VIRGINIA,WETZEL,2217,166,3473,5856,0.3785860655737705,0.5930669398907104,0.028346994535519126
2012,WEST VIRGINIA,WIRT,676,68,1427,2171,0.31137724550898205,0.6573007830492861,0.03132197144173192
2012,WEST VIRGINIA,WOOD,11230,564,22183,33977,0.3305177031521323,0.6528828325043412,0.016599464343526504
2012,WEST VIRGINIA,WYOMING,1583,171,5769,7523,0.21042137445168152,0.7668483317825335,0.022730293765784927
2012,WISCONSIN,ADAMS,5542,101,4644,10287,0.5387382132788957,0.45144356955380577,0.009818217167298532
2012,WISCONSIN,ASHLAND,5399,153,2820,8372,0.6448877209746775,0.3368370759675107,0.018275203057811752
2012,WISCONSIN,BARRON,10890,359,11443,22692,0.47990481226864096,0.5042746342323285,0.015820553499030495
2012,WISCONSIN,BAYFIELD,6033,152,3603,9788,0.6163669799754802,0.36810380057212916,0.015529219452390683
2012,WISCONSIN,BROWN,62526,1566,64836,128928,0.4849683544303797,0.502885331347729,0.012146314221891288
2012,WISCONSIN,BUFFALO,3570,105,3364,7039,0.5071743145333144,0.4779087938627646,0.014916891603921012
2012,WISCONSIN,BURNETT,3986,141,4550,8677,0.4593753601475164,0.5243747839114902,0.01624985594099343
2012,WISCONSIN,CALUMET,11489,392,14539,26420,0.43485995457986376,0.5503028009084028,0.014837244511733535
2012,WISCONSIN,CHIPPEWA,15237,373,15322,30932,0.4925966636492952,0.4953446269235743,0.01205870942713048
2012,WISCONSIN,CLARK,6172,217,7412,13801,0.4472139700021738,0.5370625317006014,0.015723498297224837
2012,WISCONSIN,COLUMBIA,17175,345,13026,30546,0.5622667452366922,0.42643881359261443,0.01129444117069338
2012,WISCONSIN,CRAWFORD,4629,121,3067,7817,0.5921709095560956,0.39235000639631573,0.015479084047588588
2012,WISCONSIN,DANE,216071,4466,83644,304181,0.7103369375470526,0.27498101459328494,0.014682047859662503
2012,WISCONSIN,DODGE,18762,515,25211,44488,0.4217317029311275,0.5666921417011329,0.011576155367739616
2012,WISCONSIN,DOOR,9357,193,8121,17671,0.5295116292230208,0.4595665214192745,0.010921849357704714
2012,WISCONSIN,DOUGLAS,14863,326,7705,22894,0.6492093998427536,0.3365510614134708,0.014239538743775662
2012,WISCONSIN,DUNN,11316,452,10224,21992,0.5145507457257185,0.46489632593670427,0.0205529283375773
2012,WISCONSIN,EAU CLAIRE,30666,884,23256,54806,0.5595372769404809,0.42433310221508597,0.01612962084443309
2012,WISCONSIN,FLORENCE,953,27,1645,2625,0.36304761904761906,0.6266666666666667,0.010285714285714285
2012,WISCONSIN,FOND DU LAC,22379,668,30355,53402,0.4190667016216621,0.5684244035803903,0.012508894797947642
2012,WISCONSIN,FOREST,2425,51,2172,4648,0.5217297762478486,0.46729776247848537,0.010972461273666093
2012,WISCONSIN,GRANT,13594,399,10255,24248,0.5606235565819861,0.4229214780600462,0.016454965357967668
2012,WISCONSIN,GREEN,11206,259,7857,19322,0.5799606665976607,0.40663492392091916,0.013404409481420142
2012,WISCONSIN,GREEN LAKE,3793,100,5782,9675,0.39204134366925064,0.5976227390180878,0.0103359173126615
2012,WISCONSIN,IOWA,8105,142,4287,12534,0.6466411361097814,0.34202967927237915,0.011329184617839477
2012,WISCONSIN,IRON,1784,58,1790,3632,0.4911894273127753,0.49284140969163,0.015969162995594713
2012,WISCONSIN,JACKSON,5298,115,3900,9313,0.5688822076667025,0.4187694620423065,0.012348330290991088
2012,WISCONSIN,JEFFERSON,20158,606,23517,44281,0.4552291050337617,0.5310855671732797,0.013685327792958606
2012,WISCONSIN,JUNEAU,6242,174,5411,11827,0.5277754291029001,0.45751247146360025,0.01471209943349962
2012,WISCONSIN,KENOSHA,44867,1053,34977,80897,0.5546188362980086,0.4323646117903012,0.013016551911690174
2012,WISCONSIN,KEWAUNEE,5153,137,5747,11037,0.4668841170607955,0.5207030896076833,0.012412793331521246
2012,WISCONSIN,LA CROSSE,36693,1018,25751,63462,0.5781885222652926,0.4057703822760077,0.016041095458699695
2012,WISCONSIN,LAFAYETTE,4536,102,3314,7952,0.5704225352112676,0.4167505030181087,0.012826961770623743
2012,WISCONSIN,LANGLADE,4573,130,5816,10519,0.43473714231390814,0.5529042684665842,0.012358589219507558
2012,WISCONSIN,LINCOLN,7563,198,7455,15216,0.49704258675078866,0.4899447949526814,0.013012618296529969
2012,WISCONSIN,MANITOWOC,20403,610,21604,42617,0.4787526104606143,0.5069338526878945,0.014313536851491188
2012,WISCONSIN,MARATHON,32363,882,36617,69862,0.4632418195871862,0.524133291345796,0.012624889067017836
2012,WISCONSIN,MARINETTE,9882,276,10619,20777,0.4756220821100255,0.5110939981710545,0.01328391971891996
2012,WISCONSIN,MARQUETTE,4014,99,3992,8105,0.49524984577421344,0.49253547193090685,0.012214682294879703
2012,WISCONSIN,MENOMINEE,1191,7,179,1377,0.8649237472766884,0.1299927378358751,0.005083514887436456
2012,WISCONSIN,MILWAUKEE,332438,5214,154924,492576,0.674896868706555,0.3145179627103229,0.010585168583122199
2012,WISCONSIN,MONROE,9515,295,9675,19485,0.4883243520656916,0.49653579676674364,0.015139851167564793
2012,WISCONSIN,OCONTO,8865,253,10741,19859,0.4463970995518405,0.5408630847474697,0.012739815700689864
2012,WISCONSIN,ONEIDA,10452,283,10917,21652,0.48272676888970995,0.5042028450027711,0.013070386107518936
2012,WISCONSIN,OUTAGAMIE,45659,1565,47372,94596,0.482673685990951,0.5007822740919278,0.01654403991712123
2012,WISCONSIN,OZAUKEE,19159,581,36077,55817,0.3432466811186556,0.646344303706756,0.010409015174588388
2012,WISCONSIN,PEPIN,1876,29,1794,3699,0.5071640984049743,0.48499594484995945,0.007839956745066235
2012,WISCONSIN,PIERCE,10235,388,10397,21020,0.4869172216936251,0.49462416745956234,0.018458610846812558
2012,WISCONSIN,POLK,10073,406,12094,22573,0.44624108448146016,0.5357728259424976,0.017986089576042176
2012,WISCONSIN,PORTAGE,22075,647,16615,39337,0.5611765004957165,0.42237588021455624,0.01644761928972723
2012,WISCONSIN,PRICE,3887,130,3884,7901,0.49196304265282875,0.49158334388052144,0.01645361346664979
2012,WISCONSIN,RACINE,53008,1009,49347,103364,0.5128284509113424,0.477409929956271,0.009761619132386518
2012,WISCONSIN,RICHLAND,4969,113,3573,8655,0.5741190063547083,0.4128249566724437,0.013056036972848064
2012,WISCONSIN,ROCK,49219,954,30517,80690,0.6099764530920808,0.3782005205105961,0.011823026397323088
2012,WISCONSIN,RUSK,3397,118,3676,7191,0.4723960506188291,0.5111945487414824,0.0164094006396885
2012,WISCONSIN,SAUK,18736,353,12838,31927,0.5868387258433301,0.4021048015786012,0.011056472578068719
2012,WISCONSIN,SAWYER,4486,97,4442,9025,0.49706371191135734,0.4921883656509695,0.01074792243767313
2012,WISCONSIN,SHAWANO,9000,257,11022,20279,0.44380886631490707,0.5435179249469895,0.012673208738103457
2012,WISCONSIN,SHEBOYGAN,27918,661,34072,62651,0.44561140285071266,0.5438380871813698,0.010550509967917511
2012,WISCONSIN,ST. CROIX,19910,812,25503,46225,0.4307193077339102,0.5517144402379665,0.01756625202812331
2012,WISCONSIN,TAYLOR,3763,148,5601,9512,0.395605550883095,0.5888351555929352,0.015559293523969722
2012,WISCONSIN,TREMPEALEAU,7605,169,5707,13481,0.5641272902603665,0.42333654773384766,0.01253616200578592
2012,WISCONSIN,VERNON,8044,283,5942,14269,0.5637395753031046,0.41642721984722125,0.01983320484967412
2012,WISCONSIN,VILAS,5951,142,7749,13842,0.4299234214708857,0.5598179453836151,0.010258633145499206
2012,WISCONSIN,WALWORTH,22552,745,29006,52303,0.4311798558400092,0.5545762193373229,0.014243924822667916
2012,WISCONSIN,WASHBURN,4447,141,4699,9287,0.4788413911919888,0.5059760956175299,0.015182513190481318
2012,WISCONSIN,WASHINGTON,23166,811,54765,78742,0.29420131568921287,0.6954992253181276,0.010299458992659572
2012,WISCONSIN,WAUKESHA,78779,2279,162798,243856,0.3230554097500164,0.6675989108326226,0.009345679417361065
2012,WISCONSIN,WAUPACA,11578,260,17002,28840,0.4014563106796116,0.5895284327323163,0.009015256588072122
2012,WISCONSIN,WAUSHARA,5335,151,6562,12048,0.4428120849933599,0.5446547144754316,0.012533200531208499
2012,WISCONSIN,WINNEBAGO,45449,1602,42122,89173,0.5096722101981541,0.47236271068596997,0.01796507911587588
2012,WISCONSIN,WOOD,18581,615,19704,38900,0.4776606683804627,0.5065295629820051,0.015809768637532133
2012,WYOMING,ALBANY,7458,976,7866,16300,0.45754601226993863,0.48257668711656443,0.059877300613496935
2012,WYOMING,BIG HORN,868,171,4285,5324,0.16303531179564237,0.8048459804658151,0.03211870773854245
2012,WYOMING,CAMPBELL,2163,455,14953,17571,0.1231005634283763,0.851004496044619,0.025894940527004723
2012,WYOMING,CARBON,2110,251,4148,6509,0.3241665386388078,0.6372714702719312,0.038561991089261026
2012,WYOMING,CONVERSE,1089,211,5043,6343,0.17168532240264858,0.7950496610436701,0.03326501655368122
2012,WYOMING,CROOK,426,150,3109,3685,0.11560379918588874,0.8436906377204885,0.0407055630936228
2012,WYOMING,FREMONT,5333,531,11075,16939,0.31483558651632326,0.6538166361650629,0.03134777731861385
2012,WYOMING,GOSHEN,1458,170,4178,5806,0.25111953151911814,0.719600413365484,0.029280055115397864
2012,WYOMING,HOT SPRINGS,523,97,1895,2515,0.20795228628230616,0.7534791252485089,0.03856858846918489
2012,WYOMING,JOHNSON,749,147,3363,4259,0.17586287861000235,0.7896219769899038,0.03451514440009392
2012,WYOMING,LARAMIE,14295,1306,23904,39505,0.36185293000885965,0.6050879635489178,0.033059106442222506
2012,WYOMING,LINCOLN,1287,187,7144,8618,0.14933859364121607,0.8289626363425389,0.021698770016245067
2012,WYOMING,NATRONA,8961,1280,22132,32373,0.27680474469465294,0.6836561331974176,0.039539122107929446
2012,WYOMING,NIOBRARA,200,54,1022,1276,0.15673981191222572,0.8009404388714734,0.04231974921630094
2012,WYOMING,PARK,2927,447,11234,14608,0.20036966046002191,0.7690306681270537,0.030599671412924426
2012,WYOMING,PLATTE,1223,172,3136,4531,0.26991834032222467,0.6921209446038402,0.037960715073935114
2012,WYOMING,SHERIDAN,3618,437,10267,14322,0.25261834939254296,0.7168691523530233,0.030512498254433737
2012,WYOMING,SUBLETTE,767,137,3472,4376,0.17527422303473492,0.793418647166362,0.031307129798903106
2012,WYOMING,SWEETWATER,4774,693,11428,16895,0.28256880733944956,0.6764131399822433,0.041018052678307194
2012,WYOMING,TETON,6213,393,4858,11464,0.5419574319609212,0.4237613398464759,0.03428122819260293
2012,WYOMING,UINTA,1628,296,6615,8539,0.1906546434008666,0.774680875980794,0.034664480618339384
2012,WYOMING,WASHAKIE,794,136,3014,3944,0.2013184584178499,0.7641987829614605,0.034482758620689655
2012,WYOMING,WESTON,422,116,2821,3359,0.1256326287585591,0.8398332837153915,0.03453408752604942
2016,ALABAMA,AUTAUGA,5936,865,18172,24973,0.2376967124494454,0.7276658791494814,0.03463740840107316
2016,ALABAMA,BALDWIN,18458,3874,72883,95215,0.193856010082445,0.765457123352413,0.040686866565142046
2016,ALABAMA,BARBOUR,4871,144,5454,10469,0.46527844111185407,0.5209666634826631,0.013754895405482854
2016,ALABAMA,BIBB,1874,207,6738,8819,0.21249574781721284,0.7640322031976414,0.023472048985145707
2016,ALABAMA,BLOUNT,2156,573,22859,25588,0.08425824605283727,0.8933484445833985,0.022393309363764265
2016,ALABAMA,BULLOCK,3530,40,1140,4710,0.7494692144373672,0.24203821656050956,0.008492569002123142
2016,ALABAMA,BUTLER,3726,105,4901,8732,0.4267063673843335,0.5612688960146587,0.012024736601007788
2016,ALABAMA,CALHOUN,13242,1757,32865,47864,0.2766588667892362,0.6866329600534848,0.03670817315727896
2016,ALABAMA,CHAMBERS,5784,273,7843,13900,0.41611510791366907,0.5642446043165468,0.019640287769784173
2016,ALABAMA,CHEROKEE,1547,233,8953,10733,0.14413491102208142,0.8341563402590143,0.021708748718904314
2016,ALABAMA,CHILTON,2911,377,15081,18369,0.15847351516141325,0.8210027764167892,0.020523708421797595
2016,ALABAMA,CHOCTAW,3109,77,4106,7292,0.4263576522216127,0.5630828304991772,0.010559517279210093
2016,ALABAMA,CLARKE,5749,142,7140,13031,0.4411787276494513,0.5479241807996317,0.010897091550917044
2016,ALABAMA,CLAY,1237,142,5245,6624,0.1867451690821256,0.7918176328502415,0.021437198067632852
2016,ALABAMA,CLEBURNE,684,145,5764,6593,0.1037463976945245,0.8742605794023964,0.021993022903079022
2016,ALABAMA,COFFEE,4221,671,15875,20767,0.20325516444358838,0.7644339577213849,0.03231087783502672
2016,ALABAMA,COLBERT,7312,857,16746,24915,0.2934778246036524,0.6721252257676099,0.03439694962873771
2016,ALABAMA,CONECUH,3080,85,3420,6585,0.4677296886864085,0.5193621867881549,0.012908124525436599
2016,ALABAMA,COOSA,1782,89,3381,5252,0.3392993145468393,0.6437547600913938,0.016945925361766947
2016,ALABAMA,COVINGTON,2387,286,13267,15940,0.14974905897114177,0.8323086574654956,0.01794228356336261
2016,ALABAMA,CRENSHAW,1664,90,4513,6267,0.2655177916068294,0.720121270145205,0.014360938247965534
2016,ALABAMA,CULLMAN,3798,1086,32989,37873,0.10028252316954031,0.8710426953238455,0.028674781506614212
2016,ALABAMA,DALE,4413,528,13808,18749,0.23537255320283748,0.7364659448503921,0.028161501946770494
2016,ALABAMA,DALLAS,12836,167,5789,18792,0.6830566198382291,0.308056619838229,0.008886760323541933
2016,ALABAMA,DEKALB,3622,799,21405,25826,0.1402462634554325,0.8288159219391311,0.030937814605436383
2016,ALABAMA,ELMORE,8443,1183,27634,37260,0.22659688674181427,0.7416532474503489,0.03174986580783682
2016,ALABAMA,ESCAMBIA,4605,305,9935,14845,0.3102054563826204,0.6692489053553385,0.02054563826204109
2016,ALABAMA,ETOWAH,10442,1369,32353,44164,0.2364369169459288,0.7325649850557014,0.030998097998369712
2016,ALABAMA,FAYETTE,1362,175,6712,8249,0.165110922536065,0.813674384773912,0.021214692690023032
2016,ALABAMA,FRANKLIN,2197,377,9466,12040,0.18247508305647842,0.7862126245847176,0.031312292358803985
2016,ALABAMA,GENEVA,1525,239,9994,11758,0.12969892838918184,0.8499744854567103,0.02032658615410784
2016,ALABAMA,GREENE,4013,29,838,4880,0.8223360655737705,0.17172131147540984,0.005942622950819672
2016,ALABAMA,HALE,4775,92,3173,8040,0.5939054726368159,0.39465174129353237,0.011442786069651741
2016,ALABAMA,HENRY,2292,148,5632,8072,0.2839444995044599,0.6977205153617443,0.018334985133795837
2016,ALABAMA,HOUSTON,10664,1247,30728,42639,0.25009967400736416,0.7206547995966134,0.02924552639602242
2016,ALABAMA,JACKSON,3673,639,16672,20984,0.17503812428516966,0.79451010293557,0.030451772779260387
2016,ALABAMA,JEFFERSON,156873,12550,134768,304191,0.5157055928676391,0.4430374337176314,0.04125697341472956
2016,ALABAMA,LAMAR,1036,107,5823,6966,0.14872236577662934,0.8359173126614987,0.01536032156187195
2016,ALABAMA,LAUDERDALE,9952,1674,27899,39525,0.25179000632511067,0.7058570524984187,0.042352941176470586
2016,ALABAMA,LAWRENCE,3627,369,10833,14829,0.24458830669633824,0.730528019421404,0.024883673882257738
2016,ALABAMA,LEE,21230,3344,34617,59191,0.35866939230626277,0.5848355324289165,0.056495075264820664
2016,ALABAMA,LIMESTONE,9468,1759,29067,40294,0.23497294882612796,0.7213729091179828,0.04365414205588922
2016,ALABAMA,LOWNDES,4883,50,1751,6684,0.7305505685218432,0.26196888090963494,0.007480550568521843
2016,ALABAMA,MACON,7566,143,1431,9140,0.8277899343544858,0.15656455142231948,0.015645514223194747
2016,ALABAMA,MADISON,62822,11047,89520,163389,0.38449344815134434,0.5478949011255347,0.06761165072312089
2016,ALABAMA,MARENGO,5615,146,5233,10994,0.5107331271602692,0.47598690194651627,0.01327997089321448
2016,ALABAMA,MARION,1432,278,11274,12984,0.11028958718422674,0.8682994454713494,0.021410967344423906
2016,ALABAMA,MARSHALL,4917,1166,29233,35316,0.1392286782195039,0.8277551251557368,0.03301619662475932
2016,ALABAMA,MOBILE,72186,5435,95116,172737,0.417895413258306,0.5506405691889983,0.03146401755269572
2016,ALABAMA,MONROE,4332,144,5795,10271,0.4217700321292961,0.564209911401032,0.014020056469671891
2016,ALABAMA,MONTGOMERY,58916,2959,34003,95878,0.6144892467510795,0.35464861594943575,0.03086213729948476
2016,ALABAMA,MORGAN,11254,1904,37486,50644,0.22221783429428954,0.7401863991785799,0.03759576652713056
2016,ALABAMA,PERRY,3824,47,1407,5278,0.7245168624478969,0.26657824933687,0.008904888215233043
2016,ALABAMA,PICKENS,3972,114,5456,9542,0.41626493397610564,0.5717878851393837,0.011947180884510585
2016,ALABAMA,PIKE,5056,419,7693,13168,0.3839611178614824,0.5842193195625759,0.03181956257594168
2016,ALABAMA,RANDOLPH,2291,191,7705,10187,0.2248944733483852,0.756356140178659,0.018749386472955726
2016,ALABAMA,RUSSELL,9579,467,9210,19256,0.49745533859576235,0.47829248026589116,0.024252181138346488
2016,ALABAMA,SHELBY,22977,5257,73020,101254,0.22692436842001304,0.7211566950441464,0.05191893653584056
2016,ALABAMA,ST. CLAIR,5589,1160,31651,38400,0.145546875,0.8242447916666666,0.030208333333333334
2016,ALABAMA,SUMTER,4746,84,1581,6411,0.740290126345344,0.2466073935423491,0.013102480112306972
2016,ALABAMA,TALLADEGA,12121,672,20614,33407,0.3628281497889664,0.617056305564702,0.02011554464633161
2016,ALABAMA,TALLAPOOSA,5519,373,13594,19486,0.2832289849122447,0.6976290670224776,0.019141948065277636
2016,ALABAMA,TUSCALOOSA,31762,3215,47723,82700,0.38406287787182586,0.577061668681983,0.038875453446191054
2016,ALABAMA,WALKER,4497,709,24266,29472,0.15258550488599348,0.82335776330076,0.02405673181324647
2016,ALABAMA,WASHINGTON,2374,117,6042,8533,0.2782139927340912,0.7080745341614907,0.01371147310441814
2016,ALABAMA,WILCOX,4339,42,1737,6118,0.709218698921216,0.28391631252043154,0.006864988558352402
2016,ALABAMA,WINSTON,872,213,9228,10313,0.08455347619509357,0.8947929797343159,0.020653544070590515
2016,ALASKA,DISTRICT 1,2573,885,3180,6638,0.3876167520337451,0.47905995781862004,0.13332329014763483
2016,ALASKA,DISTRICT 10,1808,977,6255,9040,0.2,0.691924778761062,0.10807522123893805
2016,ALASKA,DISTRICT 11,2142,1103,6444,9689,0.22107544638249563,0.6650841160078439,0.11384043760966044
2016,ALASKA,DISTRICT 12,1928,986,6629,9543,0.20203290369904642,0.6946452897411716,0.10332180655978204
2016,ALASKA,DISTRICT 13,1684,821,4028,6533,0.2577682534823205,0.6165620694933415,0.12566967702433798
2016,ALASKA,DISTRICT 14,3043,1399,5978,10420,0.29203454894433784,0.573704414587332,0.13426103646833012
2016,ALASKA,DISTRICT 15,1828,629,2525,4982,0.3669209152950622,0.5068245684464071,0.1262545162585307
2016,ALASKA,DISTRICT 16,3294,939,3203,7436,0.44298009682625067,0.43074233458848843,0.1262775685852609
2016,ALASKA,DISTRICT 17,3290,880,2618,6788,0.48467884502062464,0.3856806128461992,0.1296405421331762
2016,ALASKA,DISTRICT 18,3909,809,2684,7402,0.5281005133747636,0.3626047014320454,0.10929478519319102
2016,ALASKA,DISTRICT 19,2669,487,1636,4792,0.5569699499165276,0.34140233722871455,0.10162771285475793
2016,ALASKA,DISTRICT 2,1585,719,3188,5492,0.2886016023306628,0.5804806991988347,0.13091769847050255
2016,ALASKA,DISTRICT 20,4151,802,2187,7140,0.5813725490196079,0.3063025210084034,0.1123249299719888
2016,ALASKA,DISTRICT 21,4224,944,3479,8647,0.48849311900080955,0.4023360703134035,0.10917081068578698
2016,ALASKA,DISTRICT 22,3270,899,4203,8372,0.39058767319636883,0.5020305781175346,0.10738174868609651
2016,ALASKA,DISTRICT 23,2894,784,3246,6924,0.41796649335644137,0.46880415944540726,0.11322934719815136
2016,ALASKA,DISTRICT 24,3578,793,4709,9080,0.39405286343612334,0.5186123348017622,0.08733480176211454
2016,ALASKA,DISTRICT 25,3378,933,3816,8127,0.4156515319306017,0.4695459579180509,0.11480251015134736
2016,ALASKA,DISTRICT 26,3374,983,4548,8905,0.3788882650196519,0.5107243121841663,0.11038742279618192
2016,ALASKA,DISTRICT 27,3729,969,4085,8783,0.42457019241716953,0.465103039963566,0.11032676761926449
2016,ALASKA,DISTRICT 28,4749,1255,5423,11427,0.4155946442635862,0.4745777544412357,0.10982760129517809
2016,ALASKA,DISTRICT 29,2101,946,6347,9394,0.22365339578454332,0.6756440281030445,0.10070257611241218
2016,ALASKA,DISTRICT 3,1241,969,5403,7613,0.1630106396952581,0.7097070799947458,0.12728228030999605
2016,ALASKA,DISTRICT 30,1816,940,6194,8950,0.2029050279329609,0.6920670391061452,0.10502793296089385
2016,ALASKA,DISTRICT 31,3466,1099,5617,10182,0.3404046356315066,0.5516597917894324,0.10793557257906108
2016,ALASKA,DISTRICT 32,2701,1007,3764,7472,0.36148286937901497,0.5037473233404711,0.1347698072805139
2016,ALASKA,DISTRICT 33,5978,1224,2732,9934,0.6017716931749547,0.27501509965774107,0.1232132071673042
2016,ALASKA,DISTRICT 34,4220,1256,3955,9431,0.4474605025978157,0.4193616795673842,0.13317781783480012
2016,ALASKA,DISTRICT 35,3749,1188,4105,9042,0.4146206591462066,0.4539924795399248,0.13138686131386862
2016,ALASKA,DISTRICT 36,2693,1111,4460,8264,0.32587124878993223,0.5396902226524686,0.13443852855759922
2016,ALASKA,DISTRICT 37,2421,703,1938,5062,0.4782694587119716,0.3828526274199921,0.13887791386803636
2016,ALASKA,DISTRICT 38,2758,1194,1143,5095,0.5413150147203141,0.22433758586849853,0.23434739941118743
2016,ALASKA,DISTRICT 39,3142,1092,1405,5639,0.5571909913105161,0.24915765206596915,0.19365135662351482
2016,ALASKA,DISTRICT 4,4162,1289,4070,9521,0.43713895599201763,0.4274761054511081,0.13538493855687428
2016,ALASKA,DISTRICT 40,2338,895,1377,4610,0.5071583514099783,0.2986984815618221,0.19414316702819956
2016,ALASKA,DISTRICT 5,3187,1036,3683,7906,0.40311156083986843,0.4658487224892487,0.13103971667088288
2016,ALASKA,DISTRICT 6,2536,995,4929,8460,0.29976359338061465,0.5826241134751773,0.11761229314420804
2016,ALASKA,DISTRICT 7,1510,849,5935,8294,0.18205931999035446,0.7155775259223535,0.10236315408729202
2016,ALASKA,DISTRICT 8,1218,729,6126,8073,0.1508732813080639,0.7588257153474545,0.0903010033444816
2016,ALASKA,DISTRICT 9,1843,1011,6100,8954,0.20582979673888765,0.6812597721688631,0.11291043109224927
2016,ALASKA,DISTRICT 99,274,28,40,342,0.8011695906432749,0.11695906432748537,0.08187134502923976
2016,ARIZONA,APACHE,17083,2338,8240,27661,0.6175843245001988,0.2978923393948158,0.08452333610498536
2016,ARIZONA,COCHISE,17450,4473,28092,50015,0.3488953314005798,0.5616714985504349,0.08943317004898531
2016,ARIZONA,COCONINO,32404,6272,21108,59784,0.5420179312190553,0.35307105580088316,0.10491101298006156
2016,ARIZONA,GILA,7003,1127,14182,22312,0.3138669774112585,0.6356220867694514,0.050510935819290066
2016,ARIZONA,GRAHAM,3301,808,8025,12134,0.27204549200593375,0.6613647601780122,0.06658974781605406
2016,ARIZONA,GREENLEE,1092,286,1892,3270,0.3339449541284404,0.5785932721712538,0.0874617737003058
2016,ARIZONA,LA PAZ,1575,373,4003,5951,0.2646614014451353,0.6726600571332549,0.0626785414216098
2016,ARIZONA,MARICOPA,702907,117566,747361,1567834,0.44832998901669435,0.4766837560609095,0.07498625492239612
2016,ARIZONA,MOHAVE,17455,4206,58282,79943,0.21834306943697385,0.7290444441664686,0.05261248639655755
2016,ARIZONA,NAVAJO,16459,3258,20577,40294,0.4084727254678116,0.5106715640045665,0.08085571052762199
2016,ARIZONA,PIMA,224661,29551,167428,421640,0.5328265819182241,0.3970875628498245,0.07008585523195143
2016,ARIZONA,PINAL,47892,8835,72819,129546,0.3696910749849474,0.5621092121717383,0.06819971284331434
2016,ARIZONA,SANTA CRUZ,11690,846,3897,16433,0.7113734558510315,0.2371447696707844,0.05148177447818414
2016,ARIZONA,YAVAPAI,35590,7530,71330,114450,0.3109654871122761,0.6232415902140673,0.06579292267365662
2016,ARIZONA,YUMA,24605,3240,25165,53010,0.46415770609318996,0.47472175061309185,0.06112054329371817
2016,ARKANSAS,ARKANSAS,1939,447,3826,6212,0.312137797810689,0.6159047005795235,0.0719575016097875
2016,ARKANSAS,ASHLEY,2408,337,5338,8083,0.2979091921316343,0.6603983669429667,0.041692440925398984
2016,ARKANSAS,BAXTER,4169,915,14682,19766,0.21091773752909035,0.7427906506121623,0.04629161185874734
2016,ARKANSAS,BENTON,28005,7948,60871,96824,0.2892361398000496,0.628676774353466,0.08208708584648435
2016,ARKANSAS,BOONE,2926,950,12235,16111,0.18161504562100428,0.7594190304760723,0.05896592390292347
2016,ARKANSAS,BRADLEY,1317,172,2164,3653,0.36052559540104023,0.5923898165891048,0.04708458800985491
2016,ARKANSAS,CALHOUN,639,74,1556,2269,0.28162185985015425,0.6857646540326134,0.03261348611723226
2016,ARKANSAS,CARROLL,3342,630,6786,10758,0.31065253764640266,0.6307863915225879,0.05856107083100948
2016,ARKANSAS,CHICOT,2350,110,1716,4176,0.5627394636015326,0.4109195402298851,0.026340996168582376
2016,ARKANSAS,CLARK,3620,502,4404,8526,0.4245836265540699,0.5165376495425756,0.05887872390335445
2016,ARKANSAS,CLAY,1199,220,3781,5200,0.23057692307692307,0.7271153846153846,0.04230769230769231
2016,ARKANSAS,CLEBURNE,2101,526,9458,12085,0.17385188249896566,0.7826230864708316,0.04352503103020273
2016,ARKANSAS,CLEVELAND,723,169,2462,3354,0.21556350626118068,0.7340488968395945,0.050387596899224806
2016,ARKANSAS,COLUMBIA,3140,291,5456,8887,0.3533250815798357,0.6139304602227973,0.03274445819736694
2016,ARKANSAS,CONWAY,2656,422,4849,7927,0.3350573987637189,0.6117068247760817,0.05323577646019932
2016,ARKANSAS,CRAIGHEAD,10538,2143,22892,35573,0.29623590925702076,0.6435217721305484,0.060242318612430776
2016,ARKANSAS,CRAWFORD,4488,1276,16686,22450,0.1999109131403118,0.7432516703786192,0.05683741648106904
2016,ARKANSAS,CRITTENDEN,8410,578,6964,15952,0.5272066198595787,0.43655967903711135,0.03623370110330993
2016,ARKANSAS,CROSS,1999,291,4584,6874,0.29080593540878674,0.6668606342740763,0.04233343031713704
2016,ARKANSAS,DALLAS,1165,97,1509,2771,0.4204258390472754,0.5445687477444966,0.03500541320822808
2016,ARKANSAS,DESHA,2228,110,1919,4257,0.5233732675593141,0.4507869391590322,0.025839793281653745
2016,ARKANSAS,DREW,2365,262,3968,6595,0.35860500379075055,0.6016679302501895,0.03972706595905989
2016,ARKANSAS,FAULKNER,14629,3552,29346,47527,0.3078039851032045,0.617459549308814,0.07473646558798157
2016,ARKANSAS,FRANKLIN,1376,355,5039,6770,0.20324963072378138,0.7443131462333825,0.05243722304283604
2016,ARKANSAS,FULTON,1067,234,3471,4772,0.2235959765297569,0.7273679798826488,0.0490360435875943
2016,ARKANSAS,GARLAND,12311,2407,26087,40805,0.3017032226442838,0.6393089082220316,0.058987869133684596
2016,ARKANSAS,GRANT,1373,347,5725,7445,0.18441907320349227,0.7689724647414372,0.046608462055070514
2016,ARKANSAS,GREENE,3071,809,10720,14600,0.21034246575342466,0.7342465753424657,0.05541095890410959
2016,ARKANSAS,HEMPSTEAD,2377,271,4401,7049,0.33721095190807204,0.6243438785643354,0.03844516952759257
2016,ARKANSAS,HOT SPRING,3149,623,8172,11944,0.26364701942397856,0.6841929002009377,0.052160080375083726
2016,ARKANSAS,HOWARD,1351,166,3157,4674,0.28904578519469404,0.6754385964912281,0.03551561831407788
2016,ARKANSAS,INDEPENDENCE,2881,797,9936,13614,0.21162039077420303,0.7298369325694138,0.05854267665638314
2016,ARKANSAS,IZARD,1113,293,4042,5448,0.20429515418502203,0.7419236417033774,0.05378120411160059
2016,ARKANSAS,JACKSON,1583,306,3267,5156,0.3070209464701319,0.6336307214895268,0.05934833204034135
2016,ARKANSAS,JEFFERSON,15772,872,9250,25894,0.6090986328879278,0.35722561211091375,0.03367575500115857
2016,ARKANSAS,JOHNSON,2427,594,6091,9112,0.26635206321334504,0.668459174714662,0.06518876207199298
2016,ARKANSAS,LAFAYETTE,1032,70,1758,2860,0.36083916083916084,0.6146853146853147,0.024475524475524476
2016,ARKANSAS,LAWRENCE,1263,358,4064,5685,0.22216358839050132,0.7148636763412489,0.06297273526824979
2016,ARKANSAS,LEE,1735,62,1229,3026,0.5733641771315268,0.4061467283542631,0.020489094514210177
2016,ARKANSAS,LINCOLN,1252,119,2455,3826,0.32723470987977,0.641662310507057,0.031102979613173026
2016,ARKANSAS,LITTLE RIVER,1397,225,3605,5227,0.2672661182322556,0.6896881576430075,0.043045724124736943
2016,ARKANSAS,LOGAN,1715,460,5746,7921,0.21651306653200353,0.7254134578967302,0.058073475571266256
2016,ARKANSAS,LONOKE,5664,1478,19958,27100,0.20900369003690036,0.7364575645756457,0.054538745387453874
2016,ARKANSAS,MADISON,1588,325,4928,6841,0.23212980558397894,0.7203625200994007,0.047507674316620375
2016,ARKANSAS,MARION,1434,337,5336,7107,0.2017728999577881,0.7508090614886731,0.047418038553538766
2016,ARKANSAS,MILLER,4273,524,11294,16091,0.265552172021627,0.7018830402088124,0.03256478776956062
2016,ARKANSAS,MISSISSIPPI,5670,473,7061,13204,0.42941532868827625,0.5347621932747653,0.0358224780369585
2016,ARKANSAS,MONROE,1312,83,1489,2884,0.4549237170596394,0.5162968099861304,0.028779472954230237
2016,ARKANSAS,MONTGOMERY,748,168,2643,3559,0.2101713964596797,0.7426243326777184,0.04720427086260186
2016,ARKANSAS,NEVADA,1157,89,2000,3246,0.35643869377695625,0.6161429451632778,0.027418361059765865
2016,ARKANSAS,NEWTON,699,179,2875,3753,0.18625099920063948,0.7660538236077804,0.04769517719158007
2016,ARKANSAS,OUACHITA,4321,263,5351,9935,0.43492702566683444,0.5386009058882738,0.0264720684448918
2016,ARKANSAS,PERRY,1049,249,3008,4306,0.24361356247097074,0.6985601486298189,0.057826288899210404
2016,ARKANSAS,PHILLIPS,4310,197,2446,6953,0.619876312383144,0.35179059398820656,0.028333093628649504
2016,ARKANSAS,PIKE,685,146,3150,3981,0.1720673197689023,0.7912584777694047,0.03667420246169304
2016,ARKANSAS,POINSETT,1880,340,5502,7722,0.24346024346024345,0.7125097125097125,0.04403004403004403
2016,ARKANSAS,POLK,1212,401,6618,8231,0.14724820799416838,0.8040335317701373,0.048718260235694325
2016,ARKANSAS,POPE,5000,1313,16256,22569,0.22154282422792326,0.7202800301298241,0.058177145642252646
2016,ARKANSAS,PRAIRIE,814,125,2505,3444,0.23635307781649245,0.7273519163763066,0.03629500580720093
2016,ARKANSAS,PULASKI,89574,8945,61257,159776,0.5606223713198478,0.3833930002002804,0.05598462847987182
2016,ARKANSAS,RANDOLPH,1425,445,4509,6379,0.22338924596331713,0.7068506035428751,0.06976015049380781
2016,ARKANSAS,SALINE,13256,2981,35863,52100,0.2544337811900192,0.6883493282149712,0.0572168905950096
2016,ARKANSAS,SCOTT,602,177,2731,3510,0.17150997150997152,0.778062678062678,0.05042735042735043
2016,ARKANSAS,SEARCY,601,172,2955,3728,0.16121244635193133,0.7926502145922747,0.046137339055793994
2016,ARKANSAS,SEBASTIAN,12300,3210,29127,44637,0.2755561529672693,0.6525304119900531,0.0719134350426776
2016,ARKANSAS,SEVIER,1075,205,3282,4562,0.2356422621657168,0.7194213064445418,0.04493643138974134
2016,ARKANSAS,SHARP,1472,370,5407,7249,0.20306249137812113,0.7458959856531936,0.05104152296868534
2016,ARKANSAS,ST. FRANCIS,4031,204,3195,7430,0.5425302826379542,0.4300134589502019,0.027456258411843876
2016,ARKANSAS,STONE,1203,302,4113,5618,0.21413314346742612,0.7321110715557138,0.053755784976860094
2016,ARKANSAS,UNION,5855,583,10456,16894,0.34657274772108443,0.6189179590387119,0.034509293240203624
2016,ARKANSAS,VAN BUREN,1549,408,5382,7339,0.21106417768088295,0.7333424172230549,0.055593405096062136
2016,ARKANSAS,WASHINGTON,33366,7019,41476,81861,0.407593359475208,0.5066637348676415,0.08574290565715054
2016,ARKANSAS,WHITE,5170,972,21077,27219,0.18994085014144532,0.7743488004702598,0.03571034938829494
2016,ARKANSAS,WOODRUFF,1118,106,1347,2571,0.4348502528199144,0.5239206534422404,0.041229093737845196
2016,ARKANSAS,YELL,1480,351,4608,6439,0.22984935548998292,0.7156390743904333,0.05451157011958379
2016,CALIFORNIA,ALAMEDA,514842,43502,95922,654266,0.7869001293052061,0.14661009436528874,0.06648977632950512
2016,CALIFORNIA,ALPINE,334,51,217,602,0.5548172757475083,0.36046511627906974,0.08471760797342193
2016,CALIFORNIA,AMADOR,6004,1245,10485,17734,0.33855870080072176,0.5912371715349047,0.07020412766437352
2016,CALIFORNIA,BUTTE,41567,8853,45144,95564,0.4349650496002679,0.47239546272654975,0.09263948767318236
2016,CALIFORNIA,CALAVERAS,7944,1681,13511,23136,0.3433609958506224,0.583981673582296,0.07265733056708161
2016,CALIFORNIA,COLUSA,2661,420,3551,6632,0.4012364294330519,0.5354342581423401,0.06332931242460796
2016,CALIFORNIA,CONTRA COSTA,319287,30932,115956,466175,0.684908028101035,0.24873920737920308,0.0663527645197619
2016,CALIFORNIA,DEL NORTE,3485,939,5134,9558,0.36461602845783636,0.5371416614354467,0.09824231010671688
2016,CALIFORNIA,EL DORADO,36404,7940,49247,93591,0.3889690247993931,0.5261937579468111,0.08483721725379577
2016,CALIFORNIA,FRESNO,141341,16929,124049,282319,0.500642889780709,0.43939302703679173,0.05996408318249923
2016,CALIFORNIA,GLENN,3065,617,5788,9470,0.3236536430834213,0.6111932418162619,0.0651531151003168
2016,CALIFORNIA,HUMBOLDT,33200,7673,18373,59246,0.5603753839921682,0.3101137629544611,0.12951085305337068
2016,CALIFORNIA,IMPERIAL,32667,2720,12704,48091,0.6792747083653906,0.26416585223846456,0.05655943939614481
2016,CALIFORNIA,INYO,3155,683,4248,8086,0.39018055899084836,0.5253524610437794,0.08446697996537225
2016,CALIFORNIA,KERN,98689,15890,129584,244163,0.4041931005107244,0.530727423893055,0.06507947559622056
2016,CALIFORNIA,KINGS,13617,2205,18093,33915,0.40150375939849625,0.5334807607253428,0.06501547987616099
2016,CALIFORNIA,LAKE,11496,2401,10599,24496,0.46930111038536904,0.4326828870019595,0.09801600261267146
2016,CALIFORNIA,LASSEN,2224,726,7574,10524,0.2113264918282022,0.7196883314329152,0.06898517673888255
2016,CALIFORNIA,LOS ANGELES,2464364,200201,769743,3434308,0.7175722154215638,0.22413336252892868,0.0582944220495075
2016,CALIFORNIA,MADERA,17029,2726,23357,43112,0.3949944331044721,0.5417749118574875,0.06323065503804046
2016,CALIFORNIA,MARIN,108707,8795,21771,139273,0.7805317613607806,0.15631888449304604,0.06314935414617334
2016,CALIFORNIA,MARIPOSA,3122,570,5185,8877,0.3516953925875859,0.5840937253576659,0.06421088205474823
2016,CALIFORNIA,MENDOCINO,22079,4510,10888,37477,0.5891346692638152,0.29052485524455,0.12034047549163487
2016,CALIFORNIA,MERCED,37317,4747,28725,70789,0.5271581742926161,0.4057833844241337,0.06705844128325023
2016,CALIFORNIA,MODOC,877,215,2696,3788,0.23152059134107708,0.7117212249208026,0.05675818373812038
2016,CALIFORNIA,MONO,2773,392,2111,5276,0.525587566338135,0.4001137225170584,0.07429871114480667
2016,CALIFORNIA,MONTEREY,89088,9425,34895,133408,0.6677860398177021,0.2615660230271048,0.07064793715519309
2016,CALIFORNIA,NAPA,39199,4762,17411,61372,0.6387114645115036,0.28369614808055793,0.07759238740793847
2016,CALIFORNIA,NEVADA,26053,5517,23365,54935,0.47425138800400474,0.4253208337125694,0.10042777828342586
2016,CALIFORNIA,ORANGE,609961,80412,507148,1197521,0.5093530718876746,0.4234982100522663,0.06714871806005908
2016,CALIFORNIA,PLACER,73509,14192,95138,182839,0.40204223387789256,0.5203375647427518,0.0776202013793556
2016,CALIFORNIA,PLUMAS,3459,797,5420,9676,0.357482430756511,0.5601488218272013,0.08236874741628772
2016,CALIFORNIA,RIVERSIDE,373695,44453,333243,751391,0.49733760452281167,0.4435014526391719,0.05916094283801643
2016,CALIFORNIA,SACRAMENTO,326023,43518,189789,559330,0.5828813044177855,0.3393148946060465,0.07780380097616792
2016,CALIFORNIA,SAN BENITO,12521,1562,7841,21924,0.571109286626528,0.3576445904032111,0.0712461229702609
2016,CALIFORNIA,SAN BERNARDINO,340833,41910,271240,653983,0.5211649232472404,0.4147508421472729,0.06408423460548669
2016,CALIFORNIA,SAN DIEGO,735476,93158,477766,1306400,0.5629791794243724,0.3657118799755052,0.07130894060012248
2016,CALIFORNIA,SAN FRANCISCO,345084,23020,37688,405792,0.8503962621244381,0.09287516757353521,0.05672857030202665
2016,CALIFORNIA,SAN JOAQUIN,121124,14106,88936,224166,0.5403317184586423,0.39674170034706424,0.06292658119429352
2016,CALIFORNIA,SAN LUIS OBISPO,67107,11738,56164,135009,0.4970557518387663,0.416001896169885,0.08694235199134873
2016,CALIFORNIA,SAN MATEO,237882,18573,57929,314384,0.7566606443075984,0.1842619217262965,0.059077433966105146
2016,CALIFORNIA,SANTA BARBARA,107142,13279,56365,176786,0.6060547780932879,0.3188318079485932,0.07511341395811885
2016,CALIFORNIA,SANTA CLARA,511684,47199,144826,703709,0.7271244221688227,0.20580381947651658,0.06707175835466081
2016,CALIFORNIA,SANTA CRUZ,95249,11134,22438,128821,0.7393903167961745,0.17417967567399725,0.08643000752982821
2016,CALIFORNIA,SHASTA,22301,5974,51778,80053,0.2785779421133499,0.6467964973205251,0.07462556056612495
2016,CALIFORNIA,SIERRA,601,181,1048,1830,0.3284153005464481,0.5726775956284152,0.09890710382513661
2016,CALIFORNIA,SISKIYOU,7234,1917,11341,20492,0.35301581104821395,0.5534354870193247,0.09354870193246145
2016,CALIFORNIA,SOLANO,102360,11833,51920,166113,0.6162070397861696,0.31255831873483714,0.07123464147899322
2016,CALIFORNIA,SONOMA,160435,19410,51408,231253,0.6937639727917043,0.22230198094727419,0.08393404626102148
2016,CALIFORNIA,STANISLAUS,81647,12005,78494,172146,0.474289266088088,0.455973417912702,0.06973731599920997
2016,CALIFORNIA,SUTTER,13076,2271,18176,33523,0.390060555439549,0.5421949109566566,0.06774453360379441
2016,CALIFORNIA,TEHAMA,6809,1605,15494,23908,0.28480006692320564,0.6480675924376778,0.06713234063911662
2016,CALIFORNIA,TRINITY,2214,660,2812,5686,0.38937741822018995,0.4945480126626803,0.1160745691171298
2016,CALIFORNIA,TULARE,47585,6450,58299,112334,0.42360282728292414,0.5189791158509445,0.057418056866131356
2016,CALIFORNIA,TUOLUMNE,9123,1855,14551,25529,0.35735829840573463,0.5699792392964863,0.07266246229777899
2016,CALIFORNIA,VENTURA,194402,25001,132323,351726,0.5527086425228729,0.3762104592779607,0.0710808981991664
2016,CALIFORNIA,YOLO,54752,6599,20739,82090,0.6669752710439761,0.25263734925082226,0.08038737970520161
2016,CALIFORNIA,YUBA,7910,1918,13170,22998,0.3439429515610053,0.5726584920427863,0.08339855639620837
2016,COLORADO,ADAMS,96558,17025,80082,193665,0.4985826039811014,0.41350786151343816,0.08790953450546046
2016,COLORADO,ALAMOSA,3189,704,3046,6939,0.45957630782533504,0.4389681510304078,0.1014555411442571
2016,COLORADO,ARAPAHOE,159885,26108,117053,303046,0.5275931706737591,0.3862548919965946,0.08615193732964632
2016,COLORADO,ARCHULETA,2500,575,4264,7339,0.34064586455920426,0.5810055865921788,0.07834854884861697
2016,COLORADO,BACA,283,117,1753,2153,0.13144449605202044,0.8142127264282397,0.0543427775197399
2016,COLORADO,BENT,590,149,1188,1927,0.3061754021795537,0.6165023352361183,0.07732226258432798
2016,COLORADO,BOULDER,132334,14412,41396,188142,0.7033729842353116,0.220025300039332,0.07660171572535637
2016,COLORADO,BROOMFIELD,19731,3591,14367,37689,0.5235214518825121,0.3811987582583778,0.09527978985911008
2016,COLORADO,CHAFFEE,4888,971,5391,11250,0.43448888888888887,0.4792,0.08631111111111112
2016,COLORADO,CHEYENNE,132,45,925,1102,0.11978221415607986,0.8393829401088929,0.04083484573502722
2016,COLORADO,CLEAR CREEK,2729,562,2575,5866,0.4652233208319127,0.4389703375383566,0.09580634162973065
2016,COLORADO,CONEJOS,1771,337,1914,4022,0.44032819492789654,0.47588264545002484,0.08378915962207857
2016,COLORADO,COSTILLA,1125,135,588,1848,0.6087662337662337,0.3181818181818182,0.07305194805194805
2016,COLORADO,CROWLEY,339,109,1079,1527,0.2220039292730845,0.7066142763588736,0.07138179436804191
2016,COLORADO,CUSTER,797,208,2061,3066,0.2599478147423353,0.6722113502935421,0.06784083496412263
2016,COLORADO,DELTA,4087,1048,11655,16790,0.24341870160810006,0.6941631923764146,0.062418106015485406
2016,COLORADO,DENVER,244551,24611,62690,331852,0.7369279076214698,0.1889095138796813,0.07416257849884889
2016,COLORADO,DOLORES,242,69,944,1255,0.19282868525896416,0.7521912350597609,0.0549800796812749
2016,COLORADO,DOUGLAS,68657,16269,102573,187499,0.36617261958730446,0.5470589176475608,0.08676846276513475
2016,COLORADO,EAGLE,14099,2134,8990,25223,0.5589739523450818,0.35642072711414186,0.08460532054077627
2016,COLORADO,EL PASO,108010,31729,179228,318967,0.3386243718002176,0.5619013879178724,0.09947424028191004
2016,COLORADO,ELBERT,3134,1139,11705,15978,0.19614469896107148,0.7325697834522469,0.07128551758668168
2016,COLORADO,FREMONT,5297,1554,15122,21973,0.2410685841714832,0.6882082555864015,0.07072316024211532
2016,COLORADO,GARFIELD,11271,2067,13132,26470,0.4258027956176804,0.4961088024178315,0.0780884019644881
2016,COLORADO,GILPIN,1634,376,1566,3576,0.4569351230425056,0.43791946308724833,0.10514541387024609
2016,COLORADO,GRAND,3358,736,4494,8588,0.3910107126222636,0.5232883092687471,0.08570097810898929
2016,COLORADO,GUNNISON,5128,995,3289,9412,0.5448363790905227,0.3494475138121547,0.10571610709732257
2016,COLORADO,HINSDALE,197,53,339,589,0.33446519524617996,0.5755517826825127,0.0899830220713073
2016,COLORADO,HUERFANO,1633,267,1883,3783,0.4316679883690193,0.4977531060005287,0.07057890563045202
2016,COLORADO,JACKSON,171,61,629,861,0.1986062717770035,0.7305458768873403,0.07084785133565621
2016,COLORADO,JEFFERSON,160776,29929,138177,328882,0.4888561855011828,0.4201415705328963,0.09100224396592091
2016,COLORADO,KIOWA,91,36,728,855,0.1064327485380117,0.8514619883040936,0.042105263157894736
2016,COLORADO,KIT CARSON,536,199,2967,3702,0.14478660183684494,0.8014586709886548,0.05375472717450027
2016,COLORADO,LA PLATA,15525,3038,12587,31150,0.4983948635634029,0.40407704654895665,0.09752808988764045
2016,COLORADO,LAKE,1616,313,1270,3199,0.5051578618318224,0.39699906220693965,0.09784307596123788
2016,COLORADO,LARIMER,93113,19437,83430,195980,0.475114807633432,0.4257067047657924,0.09917848760077559
2016,COLORADO,LAS ANIMAS,2650,433,3710,6793,0.390107463565435,0.546150448991609,0.06374208744295598
2016,COLORADO,LINCOLN,409,135,1892,2436,0.16789819376026272,0.7766830870279147,0.05541871921182266
2016,COLORADO,LOGAN,1851,589,7282,9722,0.19039292326681753,0.7490228348076527,0.060584241925529726
2016,COLORADO,MESA,21729,6145,49779,77653,0.2798217712129602,0.6410441322292764,0.07913409655776338
2016,COLORADO,MINERAL,237,71,344,652,0.36349693251533743,0.5276073619631901,0.10889570552147239
2016,COLORADO,MOFFAT,874,346,5305,6525,0.1339463601532567,0.8130268199233717,0.053026819923371646
2016,COLORADO,MONTEZUMA,3973,1032,7853,12858,0.30899051174366154,0.610748172344066,0.08026131591227252
2016,COLORADO,MONTROSE,5466,1338,14382,21186,0.2580005664117814,0.6788445199660152,0.06315491362220334
2016,COLORADO,MORGAN,3151,664,8145,11960,0.26346153846153847,0.6810200668896321,0.05551839464882943
2016,COLORADO,OTERO,2943,581,4928,8452,0.34820160908660674,0.5830572645527686,0.06874112636062471
2016,COLORADO,OURAY,1697,262,1351,3310,0.5126888217522658,0.4081570996978852,0.07915407854984895
2016,COLORADO,PARK,3421,861,6135,10417,0.32840549102428723,0.5889411538830758,0.08265335509263703
2016,COLORADO,PHILLIPS,436,105,1791,2332,0.18696397941680962,0.7680102915951973,0.04502572898799314
2016,COLORADO,PITKIN,7333,640,2550,10523,0.6968545091703887,0.24232633279483037,0.060819158034780954
2016,COLORADO,PROWERS,1186,299,3531,5016,0.2364433811802233,0.7039473684210527,0.059609250398724084
2016,COLORADO,PUEBLO,35875,6506,36265,78646,0.45615797370495637,0.46111690359331686,0.08272512270172673
2016,COLORADO,RIO BLANCO,436,223,2791,3450,0.1263768115942029,0.8089855072463769,0.06463768115942028
2016,COLORADO,RIO GRANDE,2001,448,3085,5534,0.3615829418142392,0.5574629562703288,0.08095410191543187
2016,COLORADO,ROUTT,7600,1156,5230,13986,0.5434005434005434,0.37394537394537397,0.08265408265408265
2016,COLORADO,SAGUACHE,1417,271,1147,2835,0.4998236331569665,0.40458553791887125,0.09559082892416226
2016,COLORADO,SAN JUAN,265,26,215,506,0.5237154150197628,0.424901185770751,0.05138339920948617
2016,COLORADO,SAN MIGUEL,2975,321,1033,4329,0.6872256872256872,0.23862323862323861,0.07415107415107415
2016,COLORADO,SEDGWICK,267,82,1015,1364,0.19574780058651026,0.7441348973607038,0.060117302052785926
2016,COLORADO,SUMMIT,9557,1517,5100,16174,0.5908866081365154,0.31532088537158404,0.09379250649190059
2016,COLORADO,TELLER,3603,1096,9745,14444,0.24944613680420935,0.674674605372473,0.07587925782331764
2016,COLORADO,WASHINGTON,296,138,2299,2733,0.10830589096231248,0.8412001463593121,0.050493962678375415
2016,COLORADO,WELD,46519,12258,76651,135428,0.3434961750893464,0.5659907847712438,0.09051304013940988
2016,COLORADO,YUMA,726,215,3850,4791,0.15153412648716344,0.8035900647046545,0.04487580880818201
2016,CONNECTICUT,FAIRFIELD,243852,17280,160077,421209,0.5789334985719679,0.38004173699992166,0.04102476442811051
2016,CONNECTICUT,HARTFORD,240403,18288,148173,406864,0.5908682016595226,0.36418311770026346,0.04494868064021393
2016,CONNECTICUT,LITCHFIELD,39775,4616,53051,97442,0.40819153958252086,0.5444366905441186,0.047371769873360565
2016,CONNECTICUT,MIDDLESEX,45357,4400,38867,88624,0.511791388337245,0.4385606607690919,0.04964795089366312
2016,CONNECTICUT,NEW HAVEN,205609,14349,159048,379006,0.5424953694664464,0.4196450715819802,0.03785955895157333
2016,CONNECTICUT,NEW LONDON,62278,7192,54058,123528,0.5041609999352373,0.4376173822938929,0.05822161777086976
2016,CONNECTICUT,STATEWIDE WRITEIN,0,2616,0,2616,0.0,0.0,1.0
2016,CONNECTICUT,TOLLAND,38506,4724,34194,77424,0.4973393263070882,0.4416460012399256,0.061014672452986154
2016,CONNECTICUT,WINDHAM,21792,3284,25747,50823,0.4287822442594888,0.5066013419121264,0.06461641382838479
2016,DELAWARE,KENT,33351,4256,36991,74598,0.4470763291241052,0.49587120298131315,0.05705246789458163
2016,DELAWARE,NEW CASTLE,162919,13947,85525,262391,0.6209016315346182,0.3259448685358873,0.05315349992949453
2016,DELAWARE,SUSSEX,39333,4064,62611,106008,0.3710380348652932,0.590625235831258,0.038336729303448794
2016,DISTRICT OF COLUMBIA,DISTRICT OF COLUMBIA,282830,15715,12723,311268,0.9086382152999987,0.040874744593083774,0.05048704010691751
2016,FLORIDA,ALACHUA,75820,5917,46834,128571,0.5897130768213672,0.3642656586633067,0.04602126451532616
2016,FLORIDA,BAKER,2112,228,10294,12634,0.16716795947443408,0.8147854994459395,0.018046541079626405
2016,FLORIDA,BAY,21797,3462,62194,87453,0.24924245023040947,0.711170571621328,0.039586978148262494
2016,FLORIDA,BRADFORD,2924,261,8913,12098,0.24169284179203174,0.7367333443544387,0.021573813853529508
2016,FLORIDA,BREVARD,119679,13225,181848,314752,0.38023269113460756,0.5777501016673444,0.04201720719804799
2016,FLORIDA,BROWARD,553320,17680,260951,831951,0.6650872467248672,0.31366150169901835,0.021251251576114457
2016,FLORIDA,CALHOUN,1241,185,4655,6081,0.20407827659924355,0.7654990955434962,0.03042262785726032
2016,FLORIDA,CHARLOTTE,33445,2711,60218,96374,0.34703343225351235,0.624836574179758,0.028129993566729617
2016,FLORIDA,CITRUS,22789,2455,54456,79700,0.28593475533249685,0.6832622333751568,0.030803011292346298
2016,FLORIDA,CLAY,27822,3698,74963,106483,0.2612811434689105,0.703990308312125,0.03472854821896453
2016,FLORIDA,COLLIER,61085,4281,105423,170789,0.35766354976023046,0.6172704331075186,0.025066017132250908
2016,FLORIDA,COLUMBIA,7601,738,20368,28707,0.26477862542237085,0.7095133591110182,0.02570801546661093
2016,FLORIDA,DESOTO,3781,259,6778,10818,0.34951007579959326,0.626548345350342,0.023941578850064708
2016,FLORIDA,DIXIE,1270,110,5822,7202,0.17633990558178284,0.8083865592890863,0.015273535129130798
2016,FLORIDA,DUVAL,205704,15319,211672,432695,0.47540184194409457,0.4891944672344261,0.03540369082147933
2016,FLORIDA,ESCAMBIA,57461,6200,88808,152469,0.37687005227292103,0.5824659438967922,0.040664003830286816
2016,FLORIDA,FLAGLER,22026,1627,33850,57503,0.38304088482340054,0.5886649392205624,0.028294175956037077
2016,FLORIDA,FRANKLIN,1744,146,4125,6015,0.28994181213632586,0.685785536159601,0.02427265170407315
2016,FLORIDA,GADSDEN,15020,365,6728,22113,0.6792384570162348,0.3042554153665265,0.016506127617238728
2016,FLORIDA,GILCHRIST,1458,222,6740,8420,0.17315914489311163,0.8004750593824228,0.026365795724465558
2016,FLORIDA,GLADES,1271,86,2996,4353,0.291982540776476,0.6882609694463588,0.019756489777165175
2016,FLORIDA,GULF,1720,244,5329,7293,0.23584258878376527,0.7307006718771425,0.03345673933909228
2016,FLORIDA,HAMILTON,1904,113,3443,5460,0.3487179487179487,0.6305860805860806,0.020695970695970695
2016,FLORIDA,HARDEE,2149,192,5242,7583,0.28339707239878675,0.6912831333245417,0.0253197942766715
2016,FLORIDA,HENDRY,4615,305,6195,11115,0.4152046783625731,0.5573549257759784,0.027440395861448492
2016,FLORIDA,HERNANDO,31795,3031,58970,93796,0.33898034031301977,0.6287048488208452,0.03231481086613502
2016,FLORIDA,HIGHLANDS,14937,1184,29565,45686,0.32694917480190866,0.6471347896510966,0.025916035546994703
2016,FLORIDA,HILLSBOROUGH,307896,22894,266870,597660,0.5151691597229194,0.44652477997523676,0.03830606030184386
2016,FLORIDA,HOLMES,853,178,7483,8514,0.10018792576932112,0.8789053323937045,0.020906741836974396
2016,FLORIDA,INDIAN RIVER,29043,2346,48620,80009,0.36299666287542653,0.6076816358159707,0.02932170130860278
2016,FLORIDA,JACKSON,6397,387,14257,21041,0.3040254740744261,0.6775818639798489,0.018392661945725013
2016,FLORIDA,JEFFERSON,3541,174,3930,7645,0.4631785480706344,0.514061478090255,0.02275997383911053
2016,FLORIDA,LAFAYETTE,518,65,2809,3392,0.15271226415094338,0.828125,0.019162735849056603
2016,FLORIDA,LAKE,62838,5436,102188,170462,0.36863347842921,0.5994767162182774,0.03188980535251258
2016,FLORIDA,LEE,124908,9961,191551,326420,0.3826603762024386,0.5868237240365174,0.030515899761044053
2016,FLORIDA,LEON,92068,6243,53821,152132,0.6051849709462835,0.353778297794021,0.04103673125969553
2016,FLORIDA,LEVY,5101,519,13775,19395,0.26300592936323797,0.7102345965455015,0.026759474091260633
2016,FLORIDA,LIBERTY,651,102,2543,3296,0.1975121359223301,0.7715412621359223,0.030946601941747573
2016,FLORIDA,MADISON,3526,128,4851,8505,0.4145796590241035,0.5703703703703704,0.015049970605526162
2016,FLORIDA,MANATEE,71224,5790,101944,178958,0.3979928251321539,0.5696532147207725,0.03235396014707362
2016,FLORIDA,MARION,62041,4826,107833,174700,0.3551287922152261,0.6172467086433887,0.02762449914138523
2016,FLORIDA,MARTIN,30185,2403,53204,85792,0.3518393323386796,0.6201510630361805,0.028009604625139874
2016,FLORIDA,MIAMI-DADE,624146,22059,333999,980204,0.636751125275963,0.3407443756605768,0.02250449906346026
2016,FLORIDA,MONROE,18971,1603,21904,42478,0.4466076557276708,0.5156551626724422,0.037737181599887
2016,FLORIDA,NASSAU,10869,1472,34266,46607,0.233205312506705,0.7352114489239814,0.031583238569313624
2016,FLORIDA,OKALOOSA,23780,5182,71893,100855,0.2357840464032522,0.7128352585394874,0.05138069505726042
2016,FLORIDA,OKEECHOBEE,3959,338,9356,13653,0.2899728997289973,0.6852706364901486,0.024756463780854023
2016,FLORIDA,ORANGE,329894,21165,195216,546275,0.6038973044711913,0.3573584732964166,0.03874422223239211
2016,FLORIDA,OSCEOLA,85458,4447,50301,140206,0.609517424361297,0.3587649601300943,0.031717615508608764
2016,FLORIDA,PALM BEACH,374673,15257,272402,662332,0.5656876007802734,0.4112771238593334,0.02303527536039328
2016,FLORIDA,PASCO,90142,8896,142101,241139,0.37381759068421117,0.5892908239646013,0.036891585351187486
2016,FLORIDA,PINELLAS,233701,19501,239201,492403,0.4746132740864698,0.48578298669991854,0.03960373921361161
2016,FLORIDA,POLK,117433,9451,157430,284314,0.41303980809949564,0.5537187757198028,0.033241416180701616
2016,FLORIDA,PUTNAM,10094,885,22138,33117,0.3047981399281336,0.6684784249781079,0.026723435093758494
2016,FLORIDA,SANTA ROSA,18464,3942,65339,87745,0.2104279446122286,0.7446464185993504,0.04492563678842099
2016,FLORIDA,SARASOTA,97870,6755,124438,229063,0.4272623688679534,0.5432479274260793,0.029489703705967353
2016,FLORIDA,SEMINOLE,105914,9539,109443,224896,0.4709465708594195,0.48663826835515084,0.04241516078542971
2016,FLORIDA,ST. JOHNS,43099,4731,88684,136514,0.31571120910675826,0.6496330046735134,0.03465578621972838
2016,FLORIDA,ST. LUCIE,66881,3677,70289,140847,0.4748485945742543,0.49904506308263574,0.0261063423431099
2016,FLORIDA,SUMTER,22638,1297,52730,76665,0.29528468010174136,0.6877975608165395,0.016917759081719167
2016,FLORIDA,SUWANNEE,3964,443,14287,18694,0.21204664598266823,0.7642559109874826,0.02369744302984915
2016,FLORIDA,TAYLOR,2152,208,6930,9290,0.23164693218514532,0.7459634015069968,0.022389666307857912
2016,FLORIDA,UNION,1014,112,4568,5694,0.1780821917808219,0.8022479803301721,0.01966982788900597
2016,FLORIDA,VOLUSIA,109091,8771,143007,260869,0.4181830727299909,0.5481946877551568,0.033622239514852284
2016,FLORIDA,WAKULLA,4348,491,10512,15351,0.28323887694612726,0.6847762360758257,0.03198488697804703
2016,FLORIDA,WALTON,6876,1005,25756,33637,0.2044177542587032,0.7657044326188424,0.02987781312245444
2016,FLORIDA,WASHINGTON,2264,255,8637,11156,0.20294012190749372,0.7742022230190032,0.02285765507350305
2016,GEORGIA,APPLING,1434,84,5494,7012,0.2045065601825442,0.7835139760410724,0.011979463776383342
2016,GEORGIA,ATKINSON,697,35,1878,2610,0.2670498084291188,0.7195402298850575,0.013409961685823755
2016,GEORGIA,BACON,608,48,3364,4020,0.15124378109452735,0.83681592039801,0.011940298507462687
2016,GEORGIA,BAKER,650,15,775,1440,0.4513888888888889,0.5381944444444444,0.010416666666666666
2016,GEORGIA,BALDWIN,7970,449,7697,16116,0.4945395879870936,0.4775999007197816,0.027860511293124845
2016,GEORGIA,BANKS,684,157,6134,6975,0.09806451612903226,0.879426523297491,0.0225089605734767
2016,GEORGIA,BARROW,6580,1372,21108,29060,0.2264280798348245,0.7263592567102547,0.04721266345492085
2016,GEORGIA,BARTOW,8212,1427,29911,39550,0.20763590391908976,0.756283185840708,0.036080910240202275
2016,GEORGIA,BEN HILL,2101,96,3739,5936,0.3539420485175202,0.6298854447439353,0.016172506738544475
2016,GEORGIA,BERRIEN,1047,121,5422,6590,0.15887708649468893,0.8227617602427921,0.018361153262518966
2016,GEORGIA,BIBB,36787,1766,24043,62596,0.5876893092210365,0.38409802543293503,0.0282126653460285
2016,GEORGIA,BLECKLEY,1101,154,3719,4974,0.22135102533172496,0.7476879774829112,0.03096099718536389
2016,GEORGIA,BRANTLEY,619,115,5567,6301,0.09823837486113315,0.8835105538803365,0.018251071258530392
2016,GEORGIA,BROOKS,2528,107,3701,6336,0.398989898989899,0.5841224747474747,0.016887626262626264
2016,GEORGIA,BRYAN,4014,630,10529,15173,0.2645488697027615,0.6939300072497199,0.04152112304751862
2016,GEORGIA,BULLOCH,9261,958,15097,25316,0.3658160846895244,0.5963422341602149,0.0378416811502607
2016,GEORGIA,BURKE,4731,129,4491,9351,0.505935194096888,0.480269489894129,0.013795316008982997
2016,GEORGIA,BUTTS,2566,231,6717,9514,0.269707799033004,0.7060121925583351,0.02428000840866092
2016,GEORGIA,CALHOUN,1179,16,830,2025,0.5822222222222222,0.40987654320987654,0.007901234567901235
2016,GEORGIA,CAMDEN,5930,661,12310,18901,0.31374001375588595,0.6512882916247817,0.03497169461933231
2016,GEORGIA,CANDLER,1026,73,2664,3763,0.27265479670475684,0.7079457879351582,0.019399415360085038
2016,GEORGIA,CARROLL,12464,1628,30029,44121,0.28249586364769613,0.680605607307178,0.0368985290451259
2016,GEORGIA,CATOOSA,4771,1110,20876,26757,0.17830848002391897,0.7802070486227903,0.041484471353290725
2016,GEORGIA,CHARLTON,1004,61,2951,4016,0.25,0.7348107569721115,0.015189243027888447
2016,GEORGIA,CHATHAM,62290,4164,45688,112142,0.5554564748265591,0.40741203117476055,0.037131493998680244
2016,GEORGIA,CHATTAHOOCHEE,594,45,751,1390,0.4273381294964029,0.5402877697841727,0.03237410071942446
2016,GEORGIA,CHATTOOGA,1613,177,6462,8252,0.19546776539020844,0.7830828889966068,0.02144934561318468
2016,GEORGIA,CHEROKEE,25231,6163,80649,112043,0.22519032871308337,0.719804003819962,0.05500566746695465
2016,GEORGIA,CLARKE,29603,2656,12717,44976,0.658195482034863,0.2827508004268943,0.059053717538242616
2016,GEORGIA,CLAY,697,10,566,1273,0.5475255302435192,0.44461901021209743,0.007855459544383346
2016,GEORGIA,CLAYTON,78220,1994,12645,92859,0.8423523837215563,0.13617419959293123,0.021473416685512444
2016,GEORGIA,CLINCH,686,42,1727,2455,0.2794297352342159,0.7034623217922606,0.017107942973523423
2016,GEORGIA,COBB,160121,17786,152912,330819,0.4840139169757481,0.4622225446543276,0.05376353836992434
2016,GEORGIA,COFFEE,4094,233,9588,13915,0.29421487603305785,0.6890406036651096,0.016744520301832554
2016,GEORGIA,COLQUITT,3463,263,9898,13624,0.2541837933059307,0.7265120375807399,0.019304169113329418
2016,GEORGIA,COLUMBIA,18887,2771,43085,64743,0.29172265727569,0.665477348902584,0.042799993821725904
2016,GEORGIA,COOK,1753,128,4176,6057,0.2894172032359254,0.6894502228826151,0.02113257388145947
2016,GEORGIA,COWETA,16583,2629,42533,61745,0.2685723540367641,0.6888492995384241,0.042578346424811724
2016,GEORGIA,CRAWFORD,1421,120,3635,5176,0.2745363214837713,0.7022797527047914,0.023183925811437404
2016,GEORGIA,CRISP,2837,126,4549,7512,0.37766240681576146,0.6055644302449414,0.016773162939297124
2016,GEORGIA,DADE,965,226,5051,6242,0.15459788529317525,0.8091957705863505,0.03620634412047421
2016,GEORGIA,DAWSON,1448,417,9900,11765,0.12307692307692308,0.8414789630259244,0.035444113897152574
2016,GEORGIA,DECATUR,4124,142,6020,10286,0.40093330740812755,0.585261520513319,0.013805172078553373
2016,GEORGIA,DEKALB,251370,11919,51468,314757,0.7986160752580562,0.16351661758118166,0.037867307160762115
2016,GEORGIA,DODGE,1839,149,5021,7009,0.26237694392923383,0.7163646739905836,0.021258382080182624
2016,GEORGIA,DOOLY,1872,36,1951,3859,0.4850997667789583,0.5055713915522156,0.00932884166882612
2016,GEORGIA,DOUGHERTY,23311,544,10232,34087,0.6838677501686861,0.3001730865139203,0.015959163317393728
2016,GEORGIA,DOUGLAS,31005,1916,24817,57738,0.5369947001974437,0.4298209151685199,0.03318438463403651
2016,GEORGIA,EARLY,2168,65,2552,4785,0.45308254963427375,0.5333333333333333,0.013584117032392894
2016,GEORGIA,ECHOLS,156,19,1007,1182,0.1319796954314721,0.8519458544839256,0.016074450084602367
2016,GEORGIA,EFFINGHAM,4853,731,17874,23458,0.20688038195924632,0.7619575411373518,0.031162076903401826
2016,GEORGIA,ELBERT,2539,156,5292,7987,0.3178915738074371,0.6625766871165644,0.0195317390759985
2016,GEORGIA,EMANUEL,2435,90,5335,7860,0.3097964376590331,0.6787531806615776,0.011450381679389313
2016,GEORGIA,EVANS,1130,79,2404,3613,0.3127594796567949,0.6653750345972875,0.02186548574591752
2016,GEORGIA,FANNIN,1923,257,9632,11812,0.16280054182187606,0.81544192346766,0.021757534710463936
2016,GEORGIA,FAYETTE,23284,2581,35048,60913,0.38225009439692675,0.5753779981284783,0.04237190747459491
2016,GEORGIA,FLOYD,9159,1335,24114,34608,0.2646497919556172,0.6967753120665742,0.038574895977808596
2016,GEORGIA,FORSYTH,23462,4908,69851,98221,0.23886948819498885,0.7111615642276091,0.04996894757740198
2016,GEORGIA,FRANKLIN,1243,205,7054,8502,0.14620089390731592,0.829687132439426,0.024111973653258057
2016,GEORGIA,FULTON,297051,16557,117783,431391,0.6885887744528746,0.2730307308219226,0.03838049472520289
2016,GEORGIA,GILMER,1965,331,10477,12773,0.1538401315274407,0.8202458310498708,0.025914037422688482
2016,GEORGIA,GLASCOCK,138,17,1235,1390,0.09928057553956834,0.8884892086330936,0.01223021582733813
2016,GEORGIA,GLYNN,11775,976,21512,34263,0.3436651781805446,0.6278492834836412,0.028485538335814145
2016,GEORGIA,GORDON,3181,587,15191,18959,0.16778311092357193,0.8012553404715439,0.030961548604884225
2016,GEORGIA,GRADY,3013,147,6053,9213,0.32703788125474875,0.6570064039943558,0.015955714750895474
2016,GEORGIA,GREENE,3199,163,5490,8852,0.3613872571170357,0.6201988251242657,0.0184139177586986
2016,GEORGIA,GWINNETT,166153,15189,146989,328331,0.5060533425110635,0.447685415023254,0.0462612424656825
2016,GEORGIA,HABERSHAM,2483,570,13190,16243,0.15286584990457427,0.8120421104475775,0.0350920396478483
2016,GEORGIA,HALL,16180,2781,51733,70694,0.22887373751662093,0.7317877047557076,0.03933855772767137
2016,GEORGIA,HANCOCK,2701,36,843,3580,0.7544692737430168,0.23547486033519552,0.01005586592178771
2016,GEORGIA,HARALSON,1475,297,9585,11357,0.12987584749493705,0.8439728801620147,0.02615127234304834
2016,GEORGIA,HARRIS,4086,480,11936,16502,0.2476063507453642,0.7233062659071627,0.029087383347473034
2016,GEORGIA,HART,2585,246,7286,10117,0.2555105268360186,0.7201739646140161,0.024315508549965406
2016,GEORGIA,HEARD,743,110,3370,4223,0.17594127397584655,0.7980108927302866,0.02604783329386692
2016,GEORGIA,HENRY,50057,2985,45724,98766,0.5068242107607881,0.46295283802118137,0.030222951218030498
2016,GEORGIA,HOUSTON,22553,2096,35430,60079,0.37538907105644237,0.5897235306845986,0.034887398258959035
2016,GEORGIA,IRWIN,891,63,2716,3670,0.24277929155313352,0.7400544959128066,0.017166212534059946
2016,GEORGIA,JACKSON,4491,915,21784,27190,0.1651710187568959,0.8011769032732622,0.033652077969841855
2016,GEORGIA,JASPER,1544,141,4360,6045,0.2554177005789909,0.7212572373862697,0.023325062034739455
2016,GEORGIA,JEFF DAVIS,901,91,4104,5096,0.17680533751962324,0.8053375196232339,0.017857142857142856
2016,GEORGIA,JEFFERSON,3821,84,3063,6968,0.5483639494833524,0.4395809414466131,0.012055109070034443
2016,GEORGIA,JENKINS,1123,38,1895,3056,0.36747382198952877,0.6200916230366492,0.012434554973821989
2016,GEORGIA,JOHNSON,1136,31,2519,3686,0.3081931633206728,0.6833966359196961,0.008410200759631037
2016,GEORGIA,JONES,3961,285,8305,12551,0.3155923830770457,0.6617002629272568,0.022707353995697555
2016,GEORGIA,LAMAR,2270,152,5190,7612,0.29821334734629534,0.6818181818181818,0.019968470835522858
2016,GEORGIA,LANIER,806,81,1984,2871,0.28073841866945315,0.6910484151863462,0.02821316614420063
2016,GEORGIA,LAURENS,6752,367,12411,19530,0.34572452636968765,0.635483870967742,0.018791602662570406
2016,GEORGIA,LEE,3170,327,10646,14143,0.22413915010959484,0.7527398713144312,0.02312097857597398
2016,GEORGIA,LIBERTY,9556,453,6134,16143,0.5919593631914761,0.3799789382394846,0.02806169856903921
2016,GEORGIA,LINCOLN,1273,70,2759,4102,0.310336421257923,0.6725987323256948,0.017064846416382253
2016,GEORGIA,LONG,1360,131,2626,4117,0.33033762448384746,0.6378430896283702,0.031819285887782364
2016,GEORGIA,LOWNDES,15064,1106,21635,37805,0.3984658114006084,0.572278799100648,0.029255389498743553
2016,GEORGIA,LUMPKIN,2220,586,9619,12425,0.17867203219315894,0.7741649899396378,0.04716297786720322
2016,GEORGIA,MACON,2705,42,1540,4287,0.6309773734546302,0.3592255656636342,0.00979706088173548
2016,GEORGIA,MADISON,2425,372,9201,11998,0.20211701950325053,0.7668778129688282,0.03100516752792132
2016,GEORGIA,MARION,1213,56,1921,3190,0.38025078369905957,0.6021943573667712,0.01755485893416928
2016,GEORGIA,MCDUFFIE,3699,137,5432,9268,0.3991152352179543,0.5861027190332326,0.01478204574881312
2016,GEORGIA,MCINTOSH,2303,113,3487,5903,0.3901406064712858,0.5907165847873962,0.019142808741317973
2016,GEORGIA,MERIWETHER,3804,191,5222,9217,0.41271563415428014,0.566561788000434,0.020722577845285885
2016,GEORGIA,MILLER,623,30,1891,2544,0.24488993710691823,0.7433176100628931,0.01179245283018868
2016,GEORGIA,MITCHELL,3493,108,4279,7880,0.4432741116751269,0.5430203045685279,0.013705583756345178
2016,GEORGIA,MONROE,3571,284,8832,12687,0.2814692204618901,0.6961456609127453,0.022385118625364547
2016,GEORGIA,MONTGOMERY,847,59,2670,3576,0.23685682326621924,0.7466442953020134,0.016498881431767337
2016,GEORGIA,MORGAN,2663,253,6559,9475,0.28105540897097625,0.6922427440633245,0.02670184696569921
2016,GEORGIA,MURRAY,1800,317,10341,12458,0.14448547118317548,0.830069031947343,0.025445496869481457
2016,GEORGIA,MUSCOGEE,39851,2205,26976,69032,0.577282999188782,0.3907752926179163,0.03194170819330166
2016,GEORGIA,NEWTON,21943,1131,20913,43987,0.4988519335258145,0.4754359242503467,0.02571214222383886
2016,GEORGIA,OCONEE,5581,1143,13425,20149,0.27698645094049335,0.6662861680480421,0.05672738101146459
2016,GEORGIA,OGLETHORPE,1831,218,4625,6674,0.27434821696134254,0.6929877135151333,0.032664069523524124
2016,GEORGIA,PAULDING,18025,2203,44662,64890,0.2777777777777778,0.6882724610879951,0.03394976113422715
2016,GEORGIA,PEACH,5100,239,5413,10752,0.47433035714285715,0.5034412202380952,0.02222842261904762
2016,GEORGIA,PICKENS,1979,408,11651,14038,0.14097449779170823,0.8299615329819062,0.029063969226385523
2016,GEORGIA,PIERCE,903,106,6302,7311,0.12351251538777185,0.8619887840240733,0.014498700588154835
2016,GEORGIA,PIKE,1240,207,7278,8725,0.14212034383954156,0.8341547277936963,0.02372492836676218
2016,GEORGIA,POLK,2867,334,11014,14215,0.20168835736897645,0.7748153359127682,0.023496306718255363
2016,GEORGIA,PULASKI,1104,64,2437,3605,0.3062413314840499,0.676005547850208,0.017753120665742025
2016,GEORGIA,PUTNAM,2758,186,6544,9488,0.2906829679595278,0.6897133220910624,0.01960370994940978
2016,GEORGIA,QUITMAN,461,8,575,1044,0.44157088122605365,0.5507662835249042,0.007662835249042145
2016,GEORGIA,RABUN,1444,261,6287,7992,0.1806806806806807,0.7866616616616616,0.03265765765765766
2016,GEORGIA,RANDOLPH,1598,30,1271,2899,0.55122456019317,0.43842704380820974,0.010348395998620214
2016,GEORGIA,RICHMOND,48814,2240,24461,75515,0.6464146196119976,0.3239223995232735,0.029662980864728863
2016,GEORGIA,ROCKDALE,23255,1136,13478,37869,0.6140906810319786,0.355911167445668,0.029998151522353377
2016,GEORGIA,SCHLEY,401,36,1472,1909,0.21005762179151388,0.7710843373493976,0.01885804085908853
2016,GEORGIA,SCREVEN,2300,110,3305,5715,0.40244969378827644,0.5783027121609798,0.019247594050743656
2016,GEORGIA,SEMINOLE,1189,54,2345,3588,0.33138238573021184,0.6535674470457079,0.015050167224080268
2016,GEORGIA,SPALDING,9357,701,15646,25704,0.36402894491129784,0.6086990351696234,0.02727201991907874
2016,GEORGIA,STEPHENS,1837,292,7686,9815,0.18716250636780438,0.7830871115639327,0.029750382068262863
2016,GEORGIA,STEWART,1222,31,805,2058,0.5937803692905733,0.391156462585034,0.015063168124392614
2016,GEORGIA,SUMTER,5520,178,5276,10974,0.5030071077091307,0.4807727355567705,0.016220156734098778
2016,GEORGIA,TALBOT,2002,48,1196,3246,0.6167590881084412,0.36845348120764015,0.014787430683918669
2016,GEORGIA,TALIAFERRO,545,3,349,897,0.6075808249721293,0.3890746934225195,0.0033444816053511705
2016,GEORGIA,TATTNALL,1681,126,5096,6903,0.2435173113139215,0.7382297551789078,0.018252933507170794
2016,GEORGIA,TAYLOR,1296,48,2064,3408,0.38028169014084506,0.6056338028169014,0.014084507042253521
2016,GEORGIA,TELFAIR,1313,33,2450,3796,0.3458904109589041,0.6454162276080084,0.00869336143308746
2016,GEORGIA,TERRELL,2267,48,1874,4189,0.5411792790642158,0.44736213893530674,0.011458582000477441
2016,GEORGIA,THOMAS,7142,432,11228,18802,0.3798532071056271,0.5971705137751303,0.022976279119242635
2016,GEORGIA,TIFT,4347,288,9584,14219,0.30571770166678386,0.6740277094029116,0.02025458893030452
2016,GEORGIA,TOOMBS,2338,185,6615,9138,0.2558546727949223,0.7239001969796455,0.02024513022543226
2016,GEORGIA,TOWNS,1210,171,5383,6764,0.1788882318154938,0.7958308693081018,0.025280898876404494
2016,GEORGIA,TREUTLEN,862,32,1809,2703,0.3189049204587495,0.6692563817980022,0.011838697743248243
2016,GEORGIA,TROUP,9713,648,15750,26111,0.37198881697368924,0.6031940561449197,0.024817126881390986
2016,GEORGIA,TURNER,1246,57,2095,3398,0.36668628605061804,0.6165391406709829,0.016774573278399058
2016,GEORGIA,TWIGGS,1971,53,2035,4059,0.48558758314855877,0.5013550135501355,0.013057403301305741
2016,GEORGIA,UNION,1963,248,9852,12063,0.16272900605156262,0.8167122606316837,0.02055873331675371
2016,GEORGIA,UPSON,3475,167,7292,10934,0.31781598683007134,0.6669105542344979,0.015273458935430766
2016,GEORGIA,WALKER,4215,791,18950,23956,0.175947570546001,0.7910335615294707,0.0330188679245283
2016,GEORGIA,WALTON,8292,1281,31125,40698,0.20374465575703965,0.7647795960489459,0.03147574819401445
2016,GEORGIA,WARE,3440,231,8513,12184,0.28233749179251477,0.6987032173342088,0.018959290873276427
2016,GEORGIA,WARREN,1314,29,991,2334,0.5629820051413882,0.4245929734361611,0.012425021422450729
2016,GEORGIA,WASHINGTON,4200,112,4149,8461,0.4963952251506914,0.49036756884529015,0.013237206004018438
2016,GEORGIA,WAYNE,2041,219,8153,10413,0.19600499375780275,0.7829636031883223,0.021031403053874964
2016,GEORGIA,WEBSTER,473,13,630,1116,0.42383512544802865,0.5645161290322581,0.011648745519713262
2016,GEORGIA,WHEELER,646,35,1421,2102,0.3073263558515699,0.6760228353948621,0.01665080875356803
2016,GEORGIA,WHITE,1674,388,9761,11823,0.1415884293326567,0.8255941808339677,0.03281738983337562
2016,GEORGIA,WHITFIELD,7937,1184,21537,30658,0.2588883814991193,0.7024920086111293,0.03861960988975145
2016,GEORGIA,WILCOX,852,28,2096,2976,0.2862903225806452,0.7043010752688172,0.009408602150537635
2016,GEORGIA,WILKES,1848,66,2572,4486,0.4119482835488186,0.5733392777530094,0.014712438698172091
2016,GEORGIA,WILKINSON,1894,60,2333,4287,0.4418007930954047,0.5442034056449732,0.013995801259622114
2016,GEORGIA,WORTH,2020,123,6152,8295,0.2435201928872815,0.7416515973477998,0.014828209764918625
2016,HAWAII,HAWAII,41259,6107,17501,64867,0.6360553131792746,0.2697982024758352,0.09414648434489031
2016,HAWAII,HONOLULU,175696,19768,90326,285790,0.6147730851324399,0.31605724483012004,0.06916967003744008
2016,HAWAII,KAUAI,16456,2305,7574,26335,0.6248718435542054,0.2876020505031327,0.08752610594266186
2016,HAWAII,MAUI,33480,5019,13446,51945,0.6445278660121282,0.2588507074790644,0.0966214265088074
2016,IDAHO,ADA,75677,26240,93752,195669,0.3867602941702569,0.47913568322013195,0.13410402260961113
2016,IDAHO,ADAMS,415,212,1556,2183,0.19010535959688502,0.7127805771873569,0.09711406321575813
2016,IDAHO,BANNOCK,10342,5894,17180,33416,0.309492458702418,0.514124970074216,0.17638257122336606
2016,IDAHO,BEAR LAKE,255,470,2203,2928,0.08709016393442623,0.7523907103825137,0.16051912568306012
2016,IDAHO,BENEWAH,770,312,3103,4185,0.18399044205495818,0.741457586618877,0.07455197132616488
2016,IDAHO,BINGHAM,2924,2794,10907,16625,0.1758796992481203,0.6560601503759399,0.16806015037593985
2016,IDAHO,BLAINE,6416,968,3340,10724,0.59828422230511,0.3114509511376352,0.09026482655725476
2016,IDAHO,BOISE,777,364,2673,3814,0.2037231253277399,0.7008390141583639,0.09543786051389617
2016,IDAHO,BONNER,5819,1781,13343,20943,0.2778494007544287,0.6371102516353913,0.08504034761018
2016,IDAHO,BONNEVILLE,8930,8592,26699,44221,0.20194025463015308,0.6037629180705999,0.19429682729924697
2016,IDAHO,BOUNDARY,933,441,3789,5163,0.18070889018012784,0.7338756536897153,0.08541545613015689
2016,IDAHO,BUTTE,160,156,914,1230,0.13008130081300814,0.7430894308943089,0.12682926829268293
2016,IDAHO,CAMAS,110,70,410,590,0.1864406779661017,0.6949152542372882,0.11864406779661017
2016,IDAHO,CANYON,16883,8680,47222,72785,0.23195713402486776,0.648787524902109,0.11925534107302328
2016,IDAHO,CARIBOU,271,489,2275,3035,0.08929159802306424,0.7495881383855024,0.16112026359143328
2016,IDAHO,CASSIA,1036,1193,5949,8178,0.12668134018097335,0.727439471753485,0.1458791880655417
2016,IDAHO,CLARK,44,36,203,283,0.15547703180212014,0.7173144876325088,0.127208480565371
2016,IDAHO,CLEARWATER,704,245,2852,3801,0.18521441725861615,0.7503288608260984,0.06445672191528545
2016,IDAHO,CUSTER,427,210,1777,2414,0.17688483844241923,0.7361226180613091,0.08699254349627175
2016,IDAHO,ELMORE,1814,892,5816,8522,0.21286083079089416,0.6824689040131424,0.10467026519596338
2016,IDAHO,FRANKLIN,385,1213,3901,5499,0.07001272958719768,0.7094017094017094,0.22058556101109292
2016,IDAHO,FREMONT,651,974,4090,5715,0.11391076115485564,0.715660542432196,0.1704286964129484
2016,IDAHO,GEM,1229,745,5980,7954,0.15451345235101835,0.7518229821473472,0.09366356550163439
2016,IDAHO,GOODING,930,518,3743,5191,0.17915623193989597,0.7210556732806781,0.09978809477942593
2016,IDAHO,IDAHO,1196,596,6441,8233,0.1452690392323576,0.7823393659662334,0.07239159480140897
2016,IDAHO,JEFFERSON,976,2063,8436,11475,0.08505446623093682,0.7351633986928104,0.17978213507625274
2016,IDAHO,JEROME,1329,778,4644,6751,0.19685972448526146,0.6878980891719745,0.11524218634276404
2016,IDAHO,KOOTENAI,16264,5597,44449,66310,0.24527220630372493,0.6703212185190771,0.084406575177198
2016,IDAHO,LATAH,8093,2815,7265,18173,0.44533098552798106,0.39976888791063664,0.15490012656138227
2016,IDAHO,LEMHI,733,352,3011,4096,0.178955078125,0.735107421875,0.0859375
2016,IDAHO,LEWIS,270,118,1202,1590,0.16981132075471697,0.7559748427672957,0.07421383647798742
2016,IDAHO,LINCOLN,360,204,1184,1748,0.20594965675057209,0.6773455377574371,0.11670480549199085
2016,IDAHO,MADISON,1201,5546,8941,15688,0.07655532891381948,0.5699260581336053,0.3535186129525752
2016,IDAHO,MINIDOKA,1167,817,4887,6871,0.169844273031582,0.7112501819240286,0.11890554504438947
2016,IDAHO,NEZ PERCE,4828,1674,10699,17201,0.2806813557351317,0.6219987210045927,0.09731992326027557
2016,IDAHO,ONEIDA,184,353,1531,2068,0.08897485493230174,0.7403288201160542,0.1706963249516441
2016,IDAHO,OWYHEE,591,282,3052,3925,0.1505732484076433,0.7775796178343949,0.07184713375796178
2016,IDAHO,PAYETTE,1507,708,6489,8704,0.17313878676470587,0.7455193014705882,0.08134191176470588
2016,IDAHO,POWER,699,393,1666,2758,0.2534445250181291,0.6040609137055838,0.14249456127628715
2016,IDAHO,SHOSHONE,1384,439,3297,5120,0.2703125,0.6439453125,0.0857421875
2016,IDAHO,TETON,2159,650,2167,4976,0.43388263665594856,0.4354903536977492,0.13062700964630225
2016,IDAHO,TWIN FALLS,6233,3813,19828,29874,0.2086429671286068,0.6637209613710919,0.12763607150030126
2016,IDAHO,VALLEY,1913,530,2906,5349,0.3576369414843896,0.5432791175920733,0.0990839409235371
2016,IDAHO,WASHINGTON,776,396,3283,4455,0.17418630751964084,0.7369248035914703,0.08888888888888889
2016,ILLINOIS,ADAMS,7676,1485,22790,31951,0.2402428718975932,0.7132797095552564,0.046477418547150325
2016,ILLINOIS,ALEXANDER,1262,88,1496,2846,0.44342937456078707,0.5256500351370345,0.030920590302178495
2016,ILLINOIS,BOND,2068,574,4888,7530,0.2746347941567065,0.6491367861885791,0.07622841965471447
2016,ILLINOIS,BOONE,8986,1733,12282,23001,0.3906786661449502,0.5339767836181035,0.07534455023694622
2016,ILLINOIS,BROWN,476,107,1796,2379,0.20008406893652794,0.7549390500210172,0.044976881042454814
2016,ILLINOIS,BUREAU,6029,1261,9281,16571,0.36382837487176395,0.5600748295214532,0.07609679560678294
2016,ILLINOIS,CALHOUN,739,111,1721,2571,0.28743679502139247,0.6693893426682225,0.043173862310385065
2016,ILLINOIS,CARROLL,2447,564,4434,7445,0.32867696440564137,0.5955674949630625,0.07575554063129618
2016,ILLINOIS,CASS,1621,287,3216,5124,0.3163544106167057,0.6276346604215457,0.056010928961748634
2016,ILLINOIS,CHAMPAIGN,50137,8123,33368,91628,0.5471799013402017,0.36416815820491555,0.08865194045488278
2016,ILLINOIS,CHRISTIAN,3992,924,10543,15459,0.2582314509347306,0.6819975418849861,0.05977100718028333
2016,ILLINOIS,CLARK,1877,429,5622,7928,0.23675580221997983,0.7091321897073662,0.054112008072653886
2016,ILLINOIS,CLAY,1020,309,5021,6350,0.16062992125984252,0.7907086614173229,0.048661417322834646
2016,ILLINOIS,CLINTON,3945,1062,12412,17419,0.2264768356392445,0.7125552557552098,0.06096790860554567
2016,ILLINOIS,COLES,7309,1551,13003,21863,0.3343091067099666,0.5947491195169922,0.07094177377304121
2016,ILLINOIS,COOK,1611946,93382,453287,2158615,0.7467501152359267,0.20998973879084507,0.043260145973228206
2016,ILLINOIS,CRAWFORD,1992,459,6277,8728,0.22823098075160403,0.719179651695692,0.05258936755270394
2016,ILLINOIS,CUMBERLAND,1031,330,4206,5567,0.18519849110831688,0.7555236213400395,0.059277887551643614
2016,ILLINOIS,DE WITT,1910,556,5077,7543,0.2532149012329312,0.6730743735914092,0.07371072517565955
2016,ILLINOIS,DEKALB,20466,4043,19091,43600,0.46940366972477066,0.43786697247706424,0.09272935779816514
2016,ILLINOIS,DOUGLAS,1949,522,5698,8169,0.2385848941118864,0.6975149957155099,0.06390011017260375
2016,ILLINOIS,DUPAGE,228622,33732,166415,428769,0.5332055255860382,0.3881227420825666,0.07867173233139522
2016,ILLINOIS,EDGAR,1793,435,5645,7873,0.22774037850882764,0.7170074939667217,0.055252127524450655
2016,ILLINOIS,EDWARDS,434,135,2778,3347,0.12966835972512697,0.829997012249776,0.0403346280250971
2016,ILLINOIS,EFFINGHAM,3083,891,13635,17609,0.1750809245272304,0.7743199500255551,0.05059912544721449
2016,ILLINOIS,FAYETTE,1819,394,7372,9585,0.1897756911841419,0.7691184141888368,0.04110589462702139
2016,ILLINOIS,FORD,1414,502,4480,6396,0.2210756722951845,0.7004377736085053,0.0784865540963102
2016,ILLINOIS,FRANKLIN,4727,868,13116,18711,0.2526321415210304,0.7009780343113676,0.04638982416760194
2016,ILLINOIS,FULTON,6133,1172,8492,15797,0.38823827308982717,0.5375704247641957,0.07419130214597708
2016,ILLINOIS,GALLATIN,657,108,1942,2707,0.2427041004802364,0.717399335057259,0.03989656446250462
2016,ILLINOIS,GREENE,1205,235,4145,5585,0.21575649059982094,0.7421665174574754,0.04207699194270367
2016,ILLINOIS,GRUNDY,8065,1718,13454,23237,0.34707578430950636,0.5789904032362181,0.07393381245427551
2016,ILLINOIS,HAMILTON,802,158,3206,4166,0.19251080172827653,0.7695631301008161,0.037926068170907344
2016,ILLINOIS,HANCOCK,2139,552,6430,9121,0.23451375945619998,0.7049665606841355,0.06051967985966451
2016,ILLINOIS,HARDIN,420,75,1653,2148,0.19553072625698323,0.7695530726256983,0.034916201117318434
2016,ILLINOIS,HENDERSON,1155,208,2155,3518,0.32831154064809553,0.6125639567936327,0.059124502558271744
2016,ILLINOIS,HENRY,8871,1787,13985,24643,0.3599805218520472,0.5675039564988029,0.07251552164914986
2016,ILLINOIS,IROQUOIS,2504,810,9750,13064,0.19167176974892836,0.7463257807715861,0.06200244947948561
2016,ILLINOIS,JACKSON,11634,2140,10843,24617,0.4726002356095381,0.44046796928951537,0.08693179510094651
2016,ILLINOIS,JASPER,924,237,3975,5136,0.17990654205607476,0.7739485981308412,0.04614485981308411
2016,ILLINOIS,JEFFERSON,4425,879,11695,16999,0.2603094299664686,0.6879816459791752,0.05170892405435614
2016,ILLINOIS,JERSEY,2679,564,7748,10991,0.2437448821763261,0.7049404057865526,0.051314712037121284
2016,ILLINOIS,JO DAVIESS,4462,751,6121,11334,0.393682724545615,0.5400564672666314,0.06626080818775366
2016,ILLINOIS,JOHNSON,1142,298,4649,6089,0.18755132205616687,0.7635079651831171,0.04894071276071604
2016,ILLINOIS,KANE,103665,12915,82734,199314,0.5201089737800656,0.4150937716367139,0.06479725458322044
2016,ILLINOIS,KANKAKEE,18971,3205,25129,47305,0.4010358313074728,0.531212345418032,0.06775182327449529
2016,ILLINOIS,KENDALL,24884,3602,24961,53447,0.4655827268134788,0.4670234063651842,0.06739386682133702
2016,ILLINOIS,KNOX,10083,1423,10737,22243,0.4533111540709437,0.4827136627253518,0.06397518320370453
2016,ILLINOIS,LAKE,171095,22658,109767,303520,0.5637025566684238,0.36164667896678965,0.0746507643647865
2016,ILLINOIS,LASALLE,19543,3511,26689,49743,0.39287940011659933,0.5365378043141749,0.07058279556922582
2016,ILLINOIS,LAWRENCE,1290,283,4521,6094,0.21168362323596981,0.7418772563176895,0.046439120446340666
2016,ILLINOIS,LEE,5528,1349,8612,15489,0.3568984440570728,0.5560074891858738,0.08709406675705339
2016,ILLINOIS,LIVINGSTON,4023,1038,10208,15269,0.2634750147357391,0.668544108978977,0.0679808762852839
2016,ILLINOIS,LOGAN,3313,907,8181,12401,0.2671558745262479,0.6597048625110878,0.0731392629626643
2016,ILLINOIS,MACON,18343,2851,26866,48060,0.38166874739908446,0.5590095713691219,0.05932168123179359
2016,ILLINOIS,MACOUPIN,6689,1349,14322,22360,0.29915026833631486,0.6405187835420394,0.06033094812164579
2016,ILLINOIS,MADISON,50587,9102,70490,130179,0.3885957028399358,0.5414851857826531,0.06991911137741111
2016,ILLINOIS,MARION,4369,846,11859,17074,0.25588614267307014,0.6945648354222795,0.049549021904650346
2016,ILLINOIS,MARSHALL,1789,410,3785,5984,0.2989639037433155,0.6325200534759359,0.06851604278074866
2016,ILLINOIS,MASON,2014,414,4058,6486,0.3105149552883133,0.6256552574776442,0.06382978723404255
2016,ILLINOIS,MASSAC,1558,279,4846,6683,0.2331288343558282,0.7251234475534939,0.041747718090677836
2016,ILLINOIS,MCDONOUGH,5288,1009,6795,13092,0.4039107852123434,0.519019248395967,0.07706996639168959
2016,ILLINOIS,MCHENRY,60803,9335,71612,141750,0.4289453262786596,0.5051992945326279,0.06585537918871252
2016,ILLINOIS,MCLEAN,36196,6402,37237,79835,0.4533851067827394,0.46642450053234796,0.08019039268491263
2016,ILLINOIS,MENARD,1817,467,4231,6515,0.27889485801995395,0.649424405218726,0.07168073676132003
2016,ILLINOIS,MERCER,3071,647,4807,8525,0.36023460410557184,0.5638709677419355,0.07589442815249267
2016,ILLINOIS,MONROE,5535,1190,12629,19354,0.2859873927870208,0.6525266094864111,0.06148599772656815
2016,ILLINOIS,MONTGOMERY,3504,844,8630,12978,0.26999537679149327,0.6649714902142086,0.06503313299429804
2016,ILLINOIS,MORGAN,4696,1028,9076,14800,0.3172972972972973,0.6132432432432432,0.06945945945945946
2016,ILLINOIS,MOULTRIE,1481,347,4455,6283,0.23571542256883654,0.7090561833519019,0.0552283940792615
2016,ILLINOIS,OGLE,8050,1791,14352,24193,0.33274087545984377,0.5932294465341215,0.0740296780060348
2016,ILLINOIS,PEORIA,38060,4810,35633,78503,0.48482223609288816,0.4539062201444531,0.06127154376265875
2016,ILLINOIS,PERRY,2462,536,6855,9853,0.24987313508576067,0.6957271896884197,0.054399675225819545
2016,ILLINOIS,PIATT,2645,729,5634,9008,0.2936278863232682,0.6254440497335702,0.08092806394316164
2016,ILLINOIS,PIKE,1413,363,5754,7530,0.18764940239043826,0.7641434262948207,0.04820717131474104
2016,ILLINOIS,POPE,375,89,1678,2142,0.17507002801120447,0.7833800186741363,0.041549953314659195
2016,ILLINOIS,PULASKI,962,98,1675,2735,0.3517367458866545,0.6124314442413162,0.035831809872029254
2016,ILLINOIS,PUTNAM,1147,197,1767,3111,0.36869173899067825,0.5679845708775313,0.06332369013179043
2016,ILLINOIS,RANDOLPH,3439,732,10023,14194,0.24228547273495843,0.7061434408905172,0.05157108637452445
2016,ILLINOIS,RICHLAND,1584,361,5739,7684,0.20614263404476835,0.7468766267568975,0.046980739198334204
2016,ILLINOIS,ROCK ISLAND,32298,4698,26998,63994,0.5047035659593087,0.4218833015595212,0.07341313248117011
2016,ILLINOIS,SALINE,2572,536,8276,11384,0.22593113141250878,0.7269852424455376,0.04708362614195362
2016,ILLINOIS,SANGAMON,40907,7522,49944,98373,0.4158356459597654,0.5077002836144064,0.07646407042582823
2016,ILLINOIS,SCHUYLER,1075,229,2524,3828,0.28082549634273773,0.6593521421107628,0.059822361546499475
2016,ILLINOIS,SCOTT,535,107,1966,2608,0.20513803680981596,0.7538343558282209,0.04102760736196319
2016,ILLINOIS,SHELBY,2288,493,8229,11010,0.20781108083560398,0.7474114441416894,0.04477747502270663
2016,ILLINOIS,ST. CLAIR,60756,5967,53857,120580,0.5038646541715044,0.4466495272847902,0.04948581854370542
2016,ILLINOIS,STARK,751,214,1778,2743,0.27378782355085673,0.6481954064892453,0.07801676995989792
2016,ILLINOIS,STEPHENSON,7768,1492,11083,20343,0.38185125104458534,0.5448065673696112,0.07334218158580347
2016,ILLINOIS,TAZEWELL,20685,5008,38707,64400,0.32119565217391305,0.6010403726708075,0.0777639751552795
2016,ILLINOIS,UNION,2402,345,5790,8537,0.28136347663113503,0.6782242005388309,0.04041232283003397
2016,ILLINOIS,VERMILION,10039,1444,19087,30570,0.32839385017991496,0.6243702976774615,0.047235852142623484
2016,ILLINOIS,WABASH,1151,266,4047,5464,0.2106515373352855,0.7406661786237189,0.04868228404099561
2016,ILLINOIS,WARREN,2987,545,4275,7807,0.3826053541693352,0.5475855001921353,0.06980914563852952
2016,ILLINOIS,WASHINGTON,1448,408,5571,7427,0.19496431937525247,0.7501009829002289,0.05493469772451865
2016,ILLINOIS,WAYNE,1048,246,6967,8261,0.1268611548238712,0.8433603679941896,0.029778477181939232
2016,ILLINOIS,WHITE,1412,283,5640,7335,0.19250170415814588,0.7689161554192229,0.03858214042263122
2016,ILLINOIS,WHITESIDE,11035,1932,12615,25582,0.4313579860839653,0.4931201626143382,0.0755218513016965
2016,ILLINOIS,WILL,151927,16257,132720,300904,0.5049018956211948,0.44107090633557544,0.05402719804322974
2016,ILLINOIS,WILLIAMSON,8581,1701,21570,31852,0.26940223533844027,0.6771945246766294,0.0534032399849303
2016,ILLINOIS,WINNEBAGO,55713,7039,55624,118376,0.47064438737581943,0.469892545786308,0.059463066837872544
2016,ILLINOIS,WOODFORD,5092,1565,13207,19864,0.2563431333064841,0.6648711236407572,0.07878574305275876
2016,INDIANA,ADAMS,2805,637,9648,13090,0.21428571428571427,0.7370511841100076,0.04866310160427807
2016,INDIANA,ALLEN,55382,7825,83930,147137,0.3763975070852335,0.5704207643216866,0.053181728593079916
2016,INDIANA,BARTHOLOMEW,9841,2009,20640,32490,0.30289319790704833,0.6352723915050785,0.061834410587873194
2016,INDIANA,BENTON,860,227,2579,3666,0.23458810692853246,0.7034915439170758,0.06192034915439171
2016,INDIANA,BLACKFORD,1243,246,3350,4839,0.2568712543914032,0.6922917958255838,0.05083694978301302
2016,INDIANA,BOONE,10181,2343,19654,32178,0.3163962956056933,0.6107899807321773,0.0728137236621294
2016,INDIANA,BROWN,2518,411,5016,7945,0.3169288860918817,0.6313404657016992,0.05173064820641913
2016,INDIANA,CARROLL,1892,478,6273,8643,0.21890547263681592,0.7257896563693162,0.05530487099386787
2016,INDIANA,CASS,3759,749,9701,14209,0.2645506369202618,0.6827362938982335,0.05271306918150468
2016,INDIANA,CLARK,18808,2304,30035,51147,0.36772440221322855,0.587228967485874,0.045046630300897415
2016,INDIANA,CLAY,2306,445,8531,11282,0.20439638361992554,0.7561602552738876,0.03944336110618685
2016,INDIANA,CLINTON,2819,586,8531,11936,0.23617627345844505,0.7147285522788204,0.04909517426273458
2016,INDIANA,CRAWFORD,1323,255,3015,4593,0.2880470280862182,0.6564337034617896,0.05551926845199216
2016,INDIANA,DAVIESS,1800,423,8545,10768,0.16716196136701336,0.7935549777117384,0.03928306092124814
2016,INDIANA,DEARBORN,4883,991,18113,23987,0.20356859965814816,0.7551173552340851,0.041314045107766706
2016,INDIANA,DECATUR,2121,516,8490,11127,0.1906174170935562,0.763008897276894,0.046373685629549743
2016,INDIANA,DEKALB,3942,906,12054,16902,0.23322683706070288,0.7131700390486333,0.05360312389066383
2016,INDIANA,DELAWARE,18153,2707,24263,45123,0.4023003789641646,0.5377080424617158,0.05999157857411963
2016,INDIANA,DUBOIS,5389,1230,13365,19984,0.26966573258606885,0.6687850280224179,0.06154923939151321
2016,INDIANA,ELKHART,20740,3023,41867,65630,0.3160140179795825,0.6379247295444157,0.046061252476001825
2016,INDIANA,FAYETTE,2252,439,6839,9530,0.23630640083945437,0.7176285414480588,0.04606505771248688
2016,INDIANA,FLOYD,13945,2048,21432,37425,0.37261189044756177,0.5726653306613226,0.05472277889111556
2016,INDIANA,FOUNTAIN,1476,354,5662,7492,0.19701014415376403,0.7557394554191137,0.047250400427122266
2016,INDIANA,FRANKLIN,1969,375,8669,11013,0.17878870425860346,0.7871606283483156,0.03405066739308091
2016,INDIANA,FULTON,1960,404,6010,8374,0.2340577979460234,0.7176976355385718,0.048244566515404826
2016,INDIANA,GIBSON,3721,682,11081,15484,0.24031258072849393,0.7156419529837251,0.044045466287780936
2016,INDIANA,GRANT,7010,1294,17008,25312,0.27694374209860934,0.6719342604298356,0.05112199747155499
2016,INDIANA,GREENE,2929,595,10277,13801,0.21223099775378595,0.7446561843344686,0.043112817911745524
2016,INDIANA,HAMILTON,57263,9589,87404,154256,0.37122056840576706,0.5666165335546105,0.062162898039622445
2016,INDIANA,HANCOCK,8904,2203,25074,36181,0.24609601724662117,0.6930156712086454,0.060888311544733426
2016,INDIANA,HARRISON,4783,832,12943,18558,0.257732514279556,0.6974350684340985,0.04483241728634551
2016,INDIANA,HENDRICKS,22600,4622,48337,75559,0.29910401143477283,0.6397252478195847,0.06117074074564248
2016,INDIANA,HENRY,5124,1136,13895,20155,0.2542297196725378,0.6894070950136443,0.05636318531381791
2016,INDIANA,HOWARD,11215,1953,23675,36843,0.3043997502917786,0.6425915370626714,0.05300871264555004
2016,INDIANA,HUNTINGTON,3506,888,11649,16043,0.2185376799850402,0.7261110764819547,0.05535124353300505
2016,INDIANA,JACKSON,3843,871,12859,17573,0.21868775963125248,0.7317475672907301,0.049564673078017416
2016,INDIANA,JASPER,3329,667,9382,13378,0.24884138137240244,0.7013006428464643,0.049857975781133206
2016,INDIANA,JAY,1889,400,5697,7986,0.2365389431505134,0.713373403456048,0.05008765339343852
2016,INDIANA,JEFFERSON,4326,672,8546,13544,0.3194034258712345,0.6309805079740106,0.049616066154754876
2016,INDIANA,JENNINGS,2364,562,8224,11150,0.21201793721973095,0.7375784753363229,0.050403587443946185
2016,INDIANA,JOHNSON,17318,3726,45456,66500,0.26042105263157894,0.6835488721804511,0.05603007518796992
2016,INDIANA,KNOX,3772,667,11077,15516,0.24310389275586491,0.7139082237690126,0.04298788347512245
2016,INDIANA,KOSCIUSKO,6313,1836,23935,32084,0.19676474255080414,0.7460104725096621,0.05722478493953372
2016,INDIANA,LAGRANGE,2080,461,7025,9566,0.2174367551745766,0.7343717332218272,0.04819151160359607
2016,INDIANA,LAKE,116935,8645,75625,201205,0.5811734300837454,0.3758604408439154,0.042966129072339154
2016,INDIANA,LAPORTE,19798,2718,22687,45203,0.4379797801030905,0.5018914673804836,0.0601287525164259
2016,INDIANA,LAWRENCE,4210,907,14035,19152,0.2198203842940685,0.7328216374269005,0.04735797827903091
2016,INDIANA,MADISON,18595,2938,32376,53909,0.3449331280491198,0.6005676232169026,0.05449924873397763
2016,INDIANA,MARION,212899,19113,130360,362372,0.5875150397933615,0.3597408188270617,0.05274414137957679
2016,INDIANA,MARSHALL,4798,996,12288,18082,0.2653467536776905,0.6795708439331932,0.05508240238911625
2016,INDIANA,MARTIN,881,231,3697,4809,0.18319817009773343,0.76876689540445,0.048034934497816595
2016,INDIANA,MIAMI,2766,741,9975,13482,0.20516243880729862,0.7398753894080997,0.05496217178460169
2016,INDIANA,MONROE,34216,3646,20592,58454,0.58534916344476,0.3522770041400075,0.06237383241523249
2016,INDIANA,MONTGOMERY,3362,735,11059,15156,0.22182633940353655,0.729678015307469,0.04849564528899446
2016,INDIANA,MORGAN,6040,1566,23674,31280,0.19309462915601022,0.756841432225064,0.05006393861892583
2016,INDIANA,NEWTON,1404,314,4077,5795,0.24227782571182052,0.7035375323554789,0.0541846419327006
2016,INDIANA,NOBLE,3904,788,12198,16890,0.2311426879810539,0.722202486678508,0.046654825340438126
2016,INDIANA,OHIO,686,117,2118,2921,0.23485107839780897,0.7250941458404656,0.040054775761725434
2016,INDIANA,ORANGE,2048,341,5803,8192,0.25,0.7083740234375,0.0416259765625
2016,INDIANA,OWEN,1946,458,6153,8557,0.22741615052004208,0.7190604183709244,0.05352343110903354
2016,INDIANA,PARKE,1441,278,4863,6582,0.2189304162868429,0.7388331814038286,0.04223640230932847
2016,INDIANA,PERRY,3062,437,4556,8055,0.3801365611421477,0.5656114214773432,0.054252017380509
2016,INDIANA,PIKE,1297,282,4398,5977,0.2169984942278735,0.7358206458089342,0.04718085996319224
2016,INDIANA,PORTER,33676,4682,38832,77190,0.43627412877315713,0.503070345899728,0.06065552532711491
2016,INDIANA,POSEY,3521,542,8404,12467,0.2824256035934868,0.6740996230047325,0.0434747734017807
2016,INDIANA,PULASKI,1327,278,3854,5459,0.2430848140685107,0.7059901080784027,0.05092507785308665
2016,INDIANA,PUTNAM,3356,722,10637,14715,0.22806659870880056,0.7228678219503908,0.0490655793408087
2016,INDIANA,RANDOLPH,2446,495,7517,10458,0.23388793268311342,0.7187798814304839,0.047332185886402756
2016,INDIANA,RIPLEY,2471,533,9806,12810,0.19289617486338798,0.7654957064793131,0.041608118657298986
2016,INDIANA,RUSH,1525,397,5292,7214,0.21139451067369006,0.7335736068755199,0.05503188245079013
2016,INDIANA,SCOTT,2642,385,6074,9101,0.29029776947588176,0.6673991869025382,0.04230304362158004
2016,INDIANA,SHELBY,4247,1029,12718,17994,0.23602311881738358,0.7067911526064243,0.057185728576192064
2016,INDIANA,SPENCER,2861,546,6572,9979,0.2867020743561479,0.6585830243511374,0.0547149012927147
2016,INDIANA,ST. JOSEPH,52252,5787,52021,110060,0.47475922224241324,0.4726603670725059,0.05258041068508087
2016,INDIANA,STARKE,2489,370,6367,9226,0.26978105354433124,0.6901148926945588,0.040104053761109905
2016,INDIANA,STEUBEN,3744,689,10133,14566,0.257036935328848,0.6956611286557737,0.04730193601537828
2016,INDIANA,SULLIVAN,2113,308,6138,8559,0.2468746348872532,0.7171398527865405,0.03598551232620633
2016,INDIANA,SWITZERLAND,930,211,2558,3699,0.25141930251419303,0.6915382535820492,0.057042443903757775
2016,INDIANA,TIPPECANOE,27282,4465,30768,62515,0.4364072622570583,0.49216987922898503,0.07142285851395665
2016,INDIANA,TIPTON,1587,334,5589,7510,0.21131824234354193,0.7442077230359521,0.04447403462050599
2016,INDIANA,UNION,715,131,2445,3291,0.21725919173503494,0.7429352780309936,0.03980553023397144
2016,INDIANA,VANDERBURGH,28530,3481,40496,72507,0.3934792502792834,0.5585115919842222,0.04800915773649441
2016,INDIANA,VERMILLION,2081,345,4513,6939,0.29989912091079407,0.6503818994091367,0.04971897968006917
2016,INDIANA,VIGO,15931,1950,21937,39818,0.4000954342257271,0.5509317394143353,0.048972826359937716
2016,INDIANA,WABASH,3018,629,9821,13468,0.2240867240867241,0.7292099792099792,0.046703296703296704
2016,INDIANA,WARREN,839,193,2898,3930,0.21348600508905852,0.7374045801526717,0.04910941475826972
2016,INDIANA,WARRICK,9086,1390,19113,29589,0.307073574639224,0.645949508263206,0.04697691709757004
2016,INDIANA,WASHINGTON,2636,537,8209,11382,0.23159374450887366,0.7212264979792655,0.047179757511860834
2016,INDIANA,WAYNE,8322,1229,16028,25579,0.3253450095781696,0.6266077641815552,0.04804722624027523
2016,INDIANA,WELLS,2586,594,10005,13185,0.19613196814562003,0.7588168373151308,0.04505119453924915
2016,INDIANA,WHITE,2590,570,6893,10053,0.25763453695414307,0.6856659703571073,0.056699492688749624
2016,INDIANA,WHITLEY,3379,886,11358,15623,0.2162836843115919,0.7270050566472509,0.056711259041157265
2016,IOWA,ADAIR,1133,217,2461,3811,0.2972972972972973,0.6457622671214904,0.05694043558121228
2016,IOWA,ADAMS,565,146,1395,2106,0.26828110161443497,0.6623931623931624,0.06932573599240266
2016,IOWA,ALLAMAKEE,2421,409,4093,6923,0.3497038855987289,0.5912176801964466,0.0590784342048245
2016,IOWA,APPANOOSE,1814,289,4033,6136,0.29563233376792697,0.6572685788787483,0.04709908735332464
2016,IOWA,AUDUBON,1080,196,2136,3412,0.31652989449003516,0.6260257913247362,0.05744431418522861
2016,IOWA,BENTON,4678,934,8232,13844,0.3379081190407397,0.5946258306847731,0.06746605027448714
2016,IOWA,BLACK HAWK,32233,4696,27476,64405,0.5004735657169475,0.42661284061796445,0.07291359366508811
2016,IOWA,BOONE,5541,1171,7484,14196,0.3903212172442942,0.5271907579599887,0.08248802479571711
2016,IOWA,BREMER,5356,974,7208,13538,0.3956271236519427,0.5324272418377899,0.07194563451026739
2016,IOWA,BUCHANAN,3970,772,5510,10252,0.3872415138509559,0.537456106125634,0.07530238002341007
2016,IOWA,BUENA VISTA,2856,519,4903,8278,0.34501087219135057,0.5922928243537087,0.0626963034549408
2016,IOWA,BUTLER,2157,435,4921,7513,0.28710235591641153,0.6549980034606682,0.05789964062292027
2016,IOWA,CALHOUN,1398,293,3468,5159,0.2709827485946889,0.6722232990889707,0.05679395231634038
2016,IOWA,CARROLL,3309,597,6638,10544,0.31382776934749623,0.6295523520485584,0.05661987860394537
2016,IOWA,CASS,1951,413,4761,7125,0.27382456140350875,0.6682105263157895,0.057964912280701754
2016,IOWA,CEDAR,3599,647,5295,9541,0.377214128498061,0.5549732732417986,0.06781259826014045
2016,IOWA,CERRO GORDO,9862,1482,11621,22965,0.42943609841062486,0.506030916612236,0.06453298497713912
2016,IOWA,CHEROKEE,1679,387,4192,6258,0.2682965803771173,0.6698625759028444,0.06184084372003835
2016,IOWA,CHICKASAW,2266,427,3742,6435,0.35213675213675216,0.5815073815073815,0.06635586635586635
2016,IOWA,CLARKE,1465,276,2713,4454,0.3289178266726538,0.6091154018859453,0.06196677144140099
2016,IOWA,CLAY,2249,491,5877,8617,0.26099570616223744,0.6820239062318673,0.05698038760589532
2016,IOWA,CLAYTON,3237,575,5317,9129,0.35458429181728557,0.5824296198926499,0.06298608829006463
2016,IOWA,CLINTON,10095,1696,11276,23067,0.4376381844193003,0.48883686651926994,0.07352494906142974
2016,IOWA,CRAWFORD,1991,327,4617,6935,0.28709444844989185,0.6657534246575343,0.0471521268925739
2016,IOWA,DALLAS,15701,3212,19339,38252,0.41046219805500367,0.5055683362961414,0.08396946564885496
2016,IOWA,DAVIS,977,182,2723,3882,0.25167439464193714,0.7014425553838227,0.04688304997424008
2016,IOWA,DECATUR,1201,237,2296,3734,0.3216389930369577,0.6148901981788967,0.06347080878414568
2016,IOWA,DELAWARE,2957,590,5694,9241,0.31998701439238175,0.6161670814846878,0.06384590412293042
2016,IOWA,DES MOINES,8212,1362,9529,19103,0.4298801235408051,0.4988221745275611,0.07129770193163378
2016,IOWA,DICKINSON,3056,545,6753,10354,0.2951516322194321,0.652211705621016,0.052636662159551866
2016,IOWA,DUBUQUE,22850,3411,23460,49721,0.4595643691800245,0.47183282717564007,0.0686028036443354
2016,IOWA,EMMET,1357,272,3124,4753,0.28550389227856093,0.657269093204292,0.05722701451714707
2016,IOWA,FAYETTE,3689,666,5620,9975,0.3698245614035088,0.5634085213032581,0.06676691729323309
2016,IOWA,FLOYD,3179,506,4375,8060,0.3944168734491315,0.542803970223325,0.06277915632754343
2016,IOWA,FRANKLIN,1493,312,3163,4968,0.3005233494363929,0.6366747181964574,0.06280193236714976
2016,IOWA,FREMONT,963,225,2407,3595,0.2678720445062587,0.6695410292072322,0.06258692628650904
2016,IOWA,GREENE,1691,310,2820,4821,0.3507571043352002,0.5849408836341008,0.06430201203069902
2016,IOWA,GRUNDY,1856,489,4527,6872,0.270081490104773,0.6587601862630966,0.07115832363213039
2016,IOWA,GUTHRIE,1732,390,3628,5750,0.3012173913043478,0.6309565217391304,0.06782608695652174
2016,IOWA,HAMILTON,2726,505,4463,7694,0.35430205354821936,0.5800623862750195,0.06563556017676112
2016,IOWA,HANCOCK,1587,307,3977,5871,0.2703117015840572,0.6773973769374894,0.05229092147845341
2016,IOWA,HARDIN,2787,492,5254,8533,0.32661432087190906,0.6157271768428454,0.057658502285245515
2016,IOWA,HARRISON,2131,432,4902,7465,0.2854655056932351,0.6566644340254522,0.05787006028131279
2016,IOWA,HENRY,2904,721,5779,9404,0.3088047639302425,0.6145257337303275,0.07666950233943003
2016,IOWA,HOWARD,1677,271,2611,4559,0.3678438254003071,0.5727133143233165,0.0594428602763764
2016,IOWA,HUMBOLDT,1252,267,3568,5087,0.2461175545508158,0.7013957145665421,0.05248673088264203
2016,IOWA,IDA,792,165,2655,3612,0.21926910299003322,0.7350498338870431,0.04568106312292359
2016,IOWA,IOWA,3084,615,5205,8904,0.3463611859838275,0.5845687331536388,0.06907008086253369
2016,IOWA,JACKSON,3837,649,5824,10310,0.37216294859359844,0.5648884578079535,0.06294859359844811
2016,IOWA,JASPER,7109,1365,10560,19034,0.37348954502469267,0.5547966796259325,0.0717137753493748
2016,IOWA,JEFFERSON,3710,698,3748,8156,0.4548798430603237,0.45953898970083373,0.08558116723884257
2016,IOWA,JOHNSON,50200,5696,21044,76940,0.6524564595788926,0.2735118273979725,0.07403171302313491
2016,IOWA,JONES,3787,626,5720,10133,0.3737293989933879,0.5644922530346393,0.061778347971972764
2016,IOWA,KEOKUK,1342,253,3390,4985,0.26920762286860583,0.6800401203610833,0.050752256770310936
2016,IOWA,KOSSUTH,2543,411,5653,8607,0.2954571860113861,0.6567909840827234,0.04775182990589055
2016,IOWA,LEE,6215,1133,8803,16151,0.3848058943718655,0.5450436505479537,0.07015045508018079
2016,IOWA,LINN,58935,9773,48390,117098,0.5032963842251789,0.413243607918154,0.08346000785666706
2016,IOWA,LOUISA,1648,291,3069,5008,0.329073482428115,0.6128194888178914,0.05810702875399361
2016,IOWA,LUCAS,1239,238,2877,4354,0.2845659163987138,0.6607717041800643,0.05466237942122187
2016,IOWA,LYON,920,265,5192,6377,0.14426846479535832,0.8141759448016309,0.04155559040301082
2016,IOWA,MADISON,2678,598,5360,8636,0.310097267253358,0.6206577119036591,0.06924502084298287
2016,IOWA,MAHASKA,2619,581,7432,10632,0.24633182844243792,0.6990218209179835,0.05464635063957863
2016,IOWA,MARION,5482,1372,10962,17816,0.3077009429726089,0.6152896273013022,0.07700942972608892
2016,IOWA,MARSHALL,7652,1182,9146,17980,0.42558398220244714,0.5086763070077864,0.06573971078976641
2016,IOWA,MILLS,2090,541,5067,7698,0.27149909067290207,0.6582229150428682,0.07027799428422966
2016,IOWA,MITCHELL,1888,339,3190,5417,0.34853239800627656,0.5888868377330626,0.06258076426066088
2016,IOWA,MONONA,1247,205,3120,4572,0.2727471566054243,0.6824146981627297,0.04483814523184602
2016,IOWA,MONROE,1056,171,2638,3865,0.27322121604139715,0.682535575679172,0.04424320827943079
2016,IOWA,MONTGOMERY,1314,294,3436,5044,0.26050753370341,0.6812053925455988,0.05828707375099128
2016,IOWA,MUSCATINE,8368,1482,9584,19434,0.4305855716785016,0.493156323968303,0.07625810435319542
2016,IOWA,O'BRIEN,1315,339,5752,7406,0.17755873615987036,0.7766675668376991,0.04577369700243046
2016,IOWA,OSCEOLA,552,130,2531,3213,0.17180205415499533,0.7877373171490819,0.04046062869592281
2016,IOWA,PAGE,1807,344,4893,7044,0.2565303804656445,0.694633730834753,0.0488358886996025
2016,IOWA,PALO ALTO,1398,224,3081,4703,0.2972570699553477,0.6551137571762705,0.047629172868381885
2016,IOWA,PLYMOUTH,2885,625,9680,13190,0.21872630780894617,0.7338893100833965,0.047384382107657316
2016,IOWA,POCAHONTAS,963,200,2702,3865,0.24915912031047865,0.6990944372574386,0.0517464424320828
2016,IOWA,POLK,119804,18259,93492,231555,0.5173889572671719,0.40375720671114856,0.07885383602167952
2016,IOWA,POTTAWATTAMIE,15355,2878,24447,42680,0.35977038425492036,0.5727975632614808,0.06743205248359888
2016,IOWA,POWESHIEK,4304,583,4946,9833,0.43770975287297875,0.5030001016983626,0.0592901454286586
2016,IOWA,RINGGOLD,753,130,1824,2707,0.2781677133357961,0.6738086442556336,0.04802364240857037
2016,IOWA,SAC,1270,239,3703,5212,0.2436684574059862,0.7104758250191865,0.04585571757482732
2016,IOWA,SCOTT,40440,6631,39149,86220,0.46903270702853167,0.454059382973788,0.07690790999768035
2016,IOWA,SHELBY,1662,346,4362,6370,0.2609105180533752,0.6847723704866562,0.054317111459968606
2016,IOWA,SIOUX,2300,1109,14785,18194,0.12641530174782895,0.8126305375398483,0.06095416071232274
2016,IOWA,STORY,25709,5500,19458,50667,0.5074111354530563,0.38403694712534786,0.10855191742159591
2016,IOWA,TAMA,3196,585,4971,8752,0.36517367458866545,0.5679844606946983,0.0668418647166362
2016,IOWA,TAYLOR,758,160,2111,3029,0.2502476064707824,0.6969296797622978,0.05282271376691978
2016,IOWA,UNION,1922,385,3525,5832,0.3295610425240055,0.6044238683127572,0.06601508916323731
2016,IOWA,VAN BUREN,845,189,2527,3561,0.2372928952541421,0.7096321258073575,0.05307497893850042
2016,IOWA,WAPELLO,5594,840,8715,15149,0.36926529803947455,0.5752854973925672,0.05544920456795828
2016,IOWA,WARREN,10411,2075,14814,27300,0.38135531135531137,0.5426373626373626,0.076007326007326
2016,IOWA,WASHINGTON,3943,813,6173,10929,0.3607832372586696,0.5648275231036691,0.07438923963766127
2016,IOWA,WAYNE,719,152,2069,2940,0.2445578231292517,0.7037414965986395,0.05170068027210884
2016,IOWA,WEBSTER,6305,1069,10056,17430,0.361732644865175,0.5769363166953528,0.06133103843947217
2016,IOWA,WINNEBAGO,1931,409,3447,5787,0.3336789355451875,0.5956454121306376,0.07067565232417487
2016,IOWA,WINNESHIEK,5254,764,5344,11362,0.46241858827671184,0.4703397289209646,0.06724168280232354
2016,IOWA,WOODBURY,16210,2781,24727,43718,0.3707854888146759,0.5656022690882474,0.06361224209707672
2016,IOWA,WORTH,1530,274,2453,4257,0.3594080338266385,0.5762273901808785,0.06436457599248296
2016,IOWA,WRIGHT,1896,330,3800,6026,0.3146365748423498,0.6306007301692665,0.054762694988383674
2016,KANSAS,ALLEN,1433,370,3651,5454,0.2627429409607627,0.6694169416941694,0.06784011734506784
2016,KANSAS,ANDERSON,672,243,2435,3350,0.20059701492537313,0.7268656716417911,0.07253731343283581
2016,KANSAS,ATCHISON,1989,537,4049,6575,0.30250950570342205,0.6158174904942966,0.08167300380228137
2016,KANSAS,BARBER,286,116,1850,2252,0.1269982238010657,0.8214920071047958,0.05150976909413854
2016,KANSAS,BARTON,1839,542,7888,10269,0.17908267601519134,0.7681371116953939,0.05278021228941474
2016,KANSAS,BOURBON,1336,333,4424,6093,0.21926801247333005,0.7260791071721647,0.05465288035450517
2016,KANSAS,BROWN,863,267,2906,4036,0.21382556987115955,0.72001982160555,0.06615460852329039
2016,KANSAS,BUTLER,6573,2011,19073,27657,0.23766135155656795,0.6896264960046281,0.07271215243880393
2016,KANSAS,CHASE,316,84,969,1369,0.2308254200146092,0.7078159240321402,0.061358655953250546
2016,KANSAS,CHAUTAUQUA,197,48,1236,1481,0.13301823092505063,0.8345712356515868,0.03241053342336259
2016,KANSAS,CHEROKEE,2005,433,6182,8620,0.2325986078886311,0.717169373549884,0.05023201856148492
2016,KANSAS,CHEYENNE,181,53,1173,1407,0.12864250177683015,0.8336886993603412,0.037668798862828715
2016,KANSAS,CLARK,120,60,825,1005,0.11940298507462686,0.8208955223880597,0.05970149253731343
2016,KANSAS,CLAY,677,252,2891,3820,0.17722513089005235,0.756806282722513,0.06596858638743455
2016,KANSAS,CLOUD,761,250,2919,3930,0.19363867684478372,0.7427480916030534,0.06361323155216285
2016,KANSAS,COFFEY,727,291,3050,4068,0.17871189773844642,0.7497541789577188,0.0715339233038348
2016,KANSAS,COMANCHE,102,50,715,867,0.11764705882352941,0.8246828143021915,0.05767012687427912
2016,KANSAS,COWLEY,3551,800,8270,12621,0.2813564693764361,0.6552571111639331,0.06338641945963078
2016,KANSAS,CRAWFORD,5199,1068,8624,14891,0.34913706265529515,0.5791417634812974,0.07172117386340743
2016,KANSAS,DECATUR,178,64,1210,1452,0.12258953168044077,0.8333333333333334,0.0440771349862259
2016,KANSAS,DICKINSON,1609,572,6029,8210,0.19598051157125457,0.7343483556638246,0.06967113276492083
2016,KANSAS,DONIPHAN,587,185,2606,3378,0.1737714624037892,0.7714624037892244,0.05476613380698638
2016,KANSAS,DOUGLAS,31195,4204,14688,50087,0.6228162996386288,0.2932497454429293,0.08393395491844191
2016,KANSAS,EDWARDS,212,70,1037,1319,0.1607278241091736,0.7862016679302501,0.05307050796057619
2016,KANSAS,ELK,160,51,1048,1259,0.12708498808578236,0.8324066719618745,0.04050833995234313
2016,KANSAS,ELLIS,2742,739,8466,11947,0.22951368544404452,0.7086297815351135,0.061856533020842056
2016,KANSAS,ELLSWORTH,521,189,1969,2679,0.1944755505785741,0.7349757372153789,0.07054871220604703
2016,KANSAS,FINNEY,3195,614,6350,10159,0.3144994586081307,0.6250615218033271,0.06043901958854218
2016,KANSAS,FORD,2149,455,5114,7718,0.27844001036537963,0.6626068929774553,0.05895309665716507
2016,KANSAS,FRANKLIN,2892,888,7185,10965,0.2637482900136799,0.655266757865937,0.08098495212038304
2016,KANSAS,GEARY,2722,508,4274,7504,0.3627398720682303,0.5695628997867804,0.06769722814498934
2016,KANSAS,GOVE,149,54,1140,1343,0.11094564408041697,0.8488458674609084,0.040208488458674606
2016,KANSAS,GRAHAM,188,71,1025,1284,0.14641744548286603,0.7982866043613707,0.05529595015576324
2016,KANSAS,GRANT,441,144,1804,2389,0.1845960652992884,0.7551276684805358,0.0602762662201758
2016,KANSAS,GRAY,263,105,1698,2066,0.12729912875121008,0.8218780251694094,0.050822846079380445
2016,KANSAS,GREELEY,83,33,534,650,0.1276923076923077,0.8215384615384616,0.05076923076923077
2016,KANSAS,GREENWOOD,485,195,2160,2840,0.17077464788732394,0.7605633802816901,0.06866197183098592
2016,KANSAS,HAMILTON,121,50,705,876,0.13812785388127855,0.8047945205479452,0.05707762557077625
2016,KANSAS,HARPER,393,189,1996,2578,0.15244375484871994,0.7742435996896819,0.07331264546159814
2016,KANSAS,HARVEY,5068,1180,8668,14916,0.33976937516760525,0.5811209439528023,0.07910968087959239
2016,KANSAS,HASKELL,245,69,1040,1354,0.1809453471196455,0.7680945347119645,0.05096011816838995
2016,KANSAS,HODGEMAN,124,38,855,1017,0.12192723697148476,0.8407079646017699,0.03736479842674533
2016,KANSAS,JACKSON,1512,367,3939,5818,0.2598831213475421,0.67703678239945,0.06308009625300791
2016,KANSAS,JEFFERSON,2518,606,5213,8337,0.30202710807244815,0.6252848746551517,0.07268801727240014
2016,KANSAS,JEWELL,180,91,1223,1494,0.12048192771084337,0.8186077643908969,0.06091030789825971
2016,KANSAS,JOHNSON,129852,22748,137490,290090,0.4476265986418008,0.4739563583715399,0.07841704298665932
2016,KANSAS,KEARNY,174,67,1075,1316,0.13221884498480244,0.8168693009118541,0.050911854103343465
2016,KANSAS,KINGMAN,599,205,2530,3334,0.1796640671865627,0.7588482303539292,0.061487702459508096
2016,KANSAS,KIOWA,114,65,900,1079,0.1056533827618165,0.8341056533827618,0.060240963855421686
2016,KANSAS,LABETTE,2291,481,5335,8107,0.28259528802269646,0.6580732700135685,0.05933144196373504
2016,KANSAS,LANE,106,47,718,871,0.12169919632606199,0.8243398392652124,0.0539609644087256
2016,KANSAS,LEAVENWORTH,10209,2454,17638,30301,0.336919573611432,0.5820930002310155,0.08098742615755256
2016,KANSAS,LINCOLN,215,70,1179,1464,0.14685792349726776,0.805327868852459,0.04781420765027322
2016,KANSAS,LINN,736,207,3484,4427,0.1662525412243054,0.7869889315563587,0.04675852721933589
2016,KANSAS,LOGAN,149,76,1132,1357,0.10980103168754606,0.8341930729550479,0.05600589535740604
2016,KANSAS,LYON,4649,1087,6552,12288,0.3783365885416667,0.533203125,0.08846028645833333
2016,KANSAS,MARION,1204,417,4003,5624,0.21408250355618777,0.7117709815078236,0.07414651493598862
2016,KANSAS,MARSHALL,1072,294,3307,4673,0.22940295313503103,0.7076824309865183,0.06291461587845068
2016,KANSAS,MCPHERSON,3226,967,8549,12742,0.25317846491916496,0.670930780097316,0.07589075498351908
2016,KANSAS,MEADE,210,95,1415,1720,0.12209302325581395,0.8226744186046512,0.055232558139534885
2016,KANSAS,MIAMI,3991,1028,10003,15022,0.2656770070563174,0.6658900279589934,0.06843296498468912
2016,KANSAS,MITCHELL,477,157,2308,2942,0.16213460231135282,0.7845003399048266,0.05336505778382053
2016,KANSAS,MONTGOMERY,2637,688,8679,12004,0.21967677440853048,0.7230089970009996,0.05731422859046984
2016,KANSAS,MORRIS,601,203,1820,2624,0.22903963414634146,0.6935975609756098,0.07736280487804878
2016,KANSAS,MORTON,147,50,995,1192,0.12332214765100671,0.834731543624161,0.04194630872483222
2016,KANSAS,NEMAHA,725,273,4124,5122,0.14154627098789535,0.8051542366263178,0.0532994923857868
2016,KANSAS,NEOSHO,1501,382,4431,6314,0.23772568894520113,0.7017738359201774,0.06050047513462148
2016,KANSAS,NESS,162,64,1228,1454,0.11141678129298486,0.844566712517194,0.04401650618982118
2016,KANSAS,NORTON,281,113,1840,2234,0.12578334825425247,0.8236347358997315,0.050581915846016116
2016,KANSAS,OSAGE,1753,467,4826,7046,0.24879364178257168,0.6849276185069543,0.06627873971047403
2016,KANSAS,OSBORNE,233,95,1460,1788,0.1303131991051454,0.8165548098434005,0.053131991051454136
2016,KANSAS,OTTAWA,424,196,2283,2903,0.14605580434033757,0.7864278332759215,0.06751636238374095
2016,KANSAS,PAWNEE,579,178,1904,2661,0.21758737316798196,0.7155204810221721,0.06689214580984593
2016,KANSAS,PHILLIPS,300,131,2233,2664,0.11261261261261261,0.8382132132132132,0.049174174174174176
2016,KANSAS,POTTAWATOMIE,2225,856,7612,10693,0.2080800523707098,0.71186757691948,0.08005237070981015
2016,KANSAS,PRATT,771,233,2838,3842,0.20067673086933888,0.7386777719937533,0.06064549713690786
2016,KANSAS,RAWLINS,163,89,1220,1472,0.11073369565217392,0.8288043478260869,0.06046195652173913
2016,KANSAS,RENO,6837,1860,15513,24210,0.2824039653035936,0.6407682775712515,0.0768277571251549
2016,KANSAS,REPUBLIC,375,130,2024,2529,0.14827995255041518,0.8003163305654409,0.051403716884143934
2016,KANSAS,RICE,695,272,2837,3804,0.1827024185068349,0.7457939011566772,0.07150368033648791
2016,KANSAS,RILEY,9341,2084,10107,21532,0.43381943154374886,0.4693943897454951,0.09678617871075608
2016,KANSAS,ROOKS,275,113,2031,2419,0.11368334022323275,0.8396031417941298,0.046713517982637454
2016,KANSAS,RUSH,233,73,1197,1503,0.1550232867598137,0.7964071856287425,0.04856952761144378
2016,KANSAS,RUSSELL,461,158,2574,3193,0.14437832759160665,0.8061384278108362,0.04948324459755716
2016,KANSAS,SALINE,6317,1919,13828,22064,0.2863034807831762,0.6267222625090645,0.08697425670775924
2016,KANSAS,SCOTT,236,101,1865,2202,0.10717529518619437,0.8469573115349682,0.04586739327883742
2016,KANSAS,SEDGWICK,69627,14803,104353,188783,0.3688202857248799,0.5527669334632885,0.07841278081183158
2016,KANSAS,SEWARD,1628,251,3159,5038,0.3231441048034934,0.6270345375148869,0.04982135768161969
2016,KANSAS,SHAWNEE,33926,5546,35934,75406,0.44991114765403284,0.47654032835583376,0.07354852399013341
2016,KANSAS,SHERIDAN,127,50,1197,1374,0.09243085880640466,0.87117903930131,0.036390101892285295
2016,KANSAS,SHERMAN,347,176,2089,2612,0.13284839203675344,0.7997702909647779,0.06738131699846861
2016,KANSAS,SMITH,297,84,1661,2042,0.1454456415279138,0.8134182174338883,0.04113614103819784
2016,KANSAS,STAFFORD,304,102,1490,1896,0.16033755274261605,0.7858649789029536,0.05379746835443038
2016,KANSAS,STANTON,115,30,492,637,0.18053375196232338,0.7723704866562009,0.04709576138147567
2016,KANSAS,STEVENS,220,72,1599,1891,0.11634056054997356,0.8455843469063987,0.03807509254362771
2016,KANSAS,SUMNER,2076,662,6984,9722,0.21353630940135773,0.7183707056161284,0.06809298498251388
2016,KANSAS,THOMAS,473,195,2908,3576,0.13227069351230425,0.8131991051454138,0.05453020134228188
2016,KANSAS,TREGO,198,57,1227,1482,0.13360323886639677,0.8279352226720648,0.038461538461538464
2016,KANSAS,WABAUNSEE,776,232,2372,3380,0.22958579881656804,0.7017751479289941,0.06863905325443787
2016,KANSAS,WALLACE,46,31,721,798,0.05764411027568922,0.9035087719298246,0.03884711779448621
2016,KANSAS,WASHINGTON,387,184,2194,2765,0.1399638336347197,0.7934900542495479,0.06654611211573237
2016,KANSAS,WICHITA,140,47,769,956,0.14644351464435146,0.8043933054393305,0.049163179916317995
2016,KANSAS,WILSON,594,209,2788,3591,0.16541353383458646,0.7763854079643553,0.0582010582010582
2016,KANSAS,WOODSON,273,88,1082,1443,0.1891891891891892,0.7498267498267498,0.060984060984060985
2016,KANSAS,WYANDOTTE,30146,2829,15806,48781,0.617986511141633,0.3240195977942232,0.05799389106414383
2016,KENTUCKY,ADAIR,1323,273,6637,8233,0.1606947649702417,0.8061459978136767,0.033159237216081626
2016,KENTUCKY,ALLEN,1349,281,6466,8096,0.16662549407114624,0.7986660079051383,0.034708498023715416
2016,KENTUCKY,ANDERSON,2634,546,8242,11422,0.23060759936963754,0.7215899142006654,0.047802486429697075
2016,KENTUCKY,BALLARD,816,124,3161,4101,0.19897585954645208,0.7707876127773714,0.03023652767617654
2016,KENTUCKY,BARREN,4275,730,13483,18488,0.2312310688013847,0.729283859800952,0.03948507139766335
2016,KENTUCKY,BATH,1361,144,3082,4587,0.29670808807499455,0.671898844560715,0.031393067364290386
2016,KENTUCKY,BELL,1720,234,7764,9718,0.17699115044247787,0.7989298209508129,0.0240790286067092
2016,KENTUCKY,BOONE,15026,3510,39082,57618,0.2607865597556319,0.6782949772640494,0.06091846298031865
2016,KENTUCKY,BOURBON,2791,443,5569,8803,0.3170510053390889,0.632625241394979,0.05032375326593207
2016,KENTUCKY,BOYD,6021,842,13591,20454,0.29436784980932823,0.6644666079984355,0.04116554219223624
2016,KENTUCKY,BOYLE,4281,625,8040,12946,0.3306812915186158,0.6210412482620115,0.04827746021937278
2016,KENTUCKY,BRACKEN,705,111,2711,3527,0.19988658916926566,0.7686419053019563,0.031471505528778
2016,KENTUCKY,BREATHITT,1537,210,3991,5738,0.2678633670268386,0.6955385151620774,0.036598117811084
2016,KENTUCKY,BRECKINRIDGE,1960,330,6484,8774,0.22338728060177798,0.7390015956234328,0.03761112377478915
2016,KENTUCKY,BULLITT,8255,1604,26210,36069,0.22886689400870552,0.7266627852172225,0.04447032077407192
2016,KENTUCKY,BUTLER,947,201,4428,5576,0.16983500717360114,0.7941176470588235,0.036047345767575324
2016,KENTUCKY,CALDWELL,1260,208,4507,5975,0.2108786610878661,0.7543096234309623,0.03481171548117155
2016,KENTUCKY,CALLOWAY,4749,933,10367,16049,0.2959062869960745,0.6459592497974952,0.05813446320643031
2016,KENTUCKY,CAMPBELL,14658,2802,25050,42510,0.3448129851799577,0.589273112208892,0.06591390261115032
2016,KENTUCKY,CARLISLE,432,75,2094,2601,0.16608996539792387,0.8050749711649365,0.02883506343713956
2016,KENTUCKY,CARROLL,1106,161,2588,3855,0.2869001297016861,0.6713359273670557,0.041763942931258104
2016,KENTUCKY,CARTER,2276,415,7587,10278,0.22144386067328273,0.7381786339754816,0.040377505351235646
2016,KENTUCKY,CASEY,767,190,5482,6439,0.1191178754464979,0.8513744370243826,0.02950768752911943
2016,KENTUCKY,CHRISTIAN,7188,787,14108,22083,0.32549925281891046,0.6388624733958248,0.035638273785264685
2016,KENTUCKY,CLARK,4706,789,10710,16205,0.2904041962357297,0.6609071274298056,0.04868867633446467
2016,KENTUCKY,CLAY,752,154,5861,6767,0.1111275306635141,0.8661149697059258,0.02275749963056007
2016,KENTUCKY,CLINTON,547,106,3809,4462,0.12259076647243389,0.8536530703720305,0.023756163155535633
2016,KENTUCKY,CRITTENDEN,617,130,3290,4037,0.15283626455288582,0.8149616051523408,0.03220213029477335
2016,KENTUCKY,CUMBERLAND,459,105,2502,3066,0.149706457925636,0.8160469667318982,0.03424657534246575
2016,KENTUCKY,DAVIESS,14163,2737,28907,45807,0.3091885519680398,0.6310607549064553,0.059750693125504836
2016,KENTUCKY,EDMONSON,979,130,4135,5244,0.18668954996186118,0.7885202135774219,0.02479023646071701
2016,KENTUCKY,ELLIOTT,740,115,2000,2855,0.2591943957968476,0.7005253940455342,0.040280210157618214
2016,KENTUCKY,ESTILL,1108,201,4236,5545,0.19981965734896304,0.763931469792606,0.03624887285843102
2016,KENTUCKY,FAYETTE,69778,9643,56894,136315,0.5118879066867182,0.41737152917874043,0.07074056413454131
2016,KENTUCKY,FLEMING,1348,190,4722,6260,0.21533546325878594,0.7543130990415335,0.03035143769968051
2016,KENTUCKY,FLOYD,4015,532,11993,16540,0.24274486094316808,0.7250906892382104,0.03216444981862152
2016,KENTUCKY,FRANKLIN,10717,1329,11819,23865,0.44906767232348627,0.49524408129059294,0.055688246385920806
2016,KENTUCKY,FULTON,774,59,1549,2382,0.3249370277078086,0.6502938706968934,0.02476910159529807
2016,KENTUCKY,GALLATIN,749,146,2443,3338,0.2243858597962852,0.7318753744757339,0.04373876572798083
2016,KENTUCKY,GARRARD,1453,266,5904,7623,0.19060737242555426,0.7744982290436836,0.03489439853076217
2016,KENTUCKY,GRANT,1910,381,7268,9559,0.19981169578407784,0.7603305785123967,0.03985772570352547
2016,KENTUCKY,GRAVES,3308,627,12671,16606,0.19920510658798024,0.7630374563410816,0.03775743707093822
2016,KENTUCKY,GRAYSON,1959,398,8219,10576,0.18523071104387293,0.7771369137670197,0.03763237518910741
2016,KENTUCKY,GREEN,832,129,4372,5333,0.15600975060941308,0.8198012375773486,0.024189011813238327
2016,KENTUCKY,GREENUP,4146,585,11546,16277,0.2547152423665295,0.7093444737973829,0.03594028383608773
2016,KENTUCKY,HANCOCK,1244,263,2788,4295,0.289639115250291,0.649126891734575,0.061233993015133874
2016,KENTUCKY,HARDIN,13944,2241,26971,43156,0.32310686810640465,0.6249652423764945,0.05192788951710075
2016,KENTUCKY,HARLAN,1372,256,9129,10757,0.12754485451334016,0.8486566886678442,0.023798456818815653
2016,KENTUCKY,HARRISON,2031,315,5435,7781,0.2610204343914664,0.6984963372317183,0.04048322837681532
2016,KENTUCKY,HART,1730,214,5320,7264,0.23816079295154186,0.7323788546255506,0.02946035242290749
2016,KENTUCKY,HENDERSON,6707,844,12159,19710,0.3402841197361745,0.6168949771689498,0.0428209030948757
2016,KENTUCKY,HENRY,1828,377,4944,7149,0.2557000979157924,0.6915652538816618,0.05273464820254581
2016,KENTUCKY,HICKMAN,449,51,1657,2157,0.20815948076031526,0.7681965693092258,0.02364394993045897
2016,KENTUCKY,HOPKINS,4310,758,15277,20345,0.21184566232489555,0.7508970262963873,0.03725731137871713
2016,KENTUCKY,JACKSON,482,130,4889,5501,0.08762043264860934,0.8887475004544628,0.02363206689692783
2016,KENTUCKY,JEFFERSON,190836,18495,143768,353099,0.5404603241583805,0.4071605980192524,0.0523790778223671
2016,KENTUCKY,JESSAMINE,6144,1708,15474,23326,0.2633970676498328,0.663379919403241,0.07322301294692618
2016,KENTUCKY,JOHNSON,1250,279,8043,9572,0.13058921855411618,0.8402632678646051,0.02914751358127873
2016,KENTUCKY,KENTON,24214,4826,42958,71998,0.33631489763604544,0.5966554626517403,0.06702963971221423
2016,KENTUCKY,KNOTT,1245,161,4357,5763,0.21603331598125977,0.7560298455665452,0.027936838452195037
2016,KENTUCKY,KNOX,1761,366,9885,12012,0.1466033966033966,0.8229270729270729,0.030469530469530468
2016,KENTUCKY,LARUE,1278,290,4799,6367,0.20072247526307524,0.7537301711952253,0.045547353541699385
2016,KENTUCKY,LAUREL,3440,801,20592,24833,0.1385253493335481,0.8292191841501229,0.03225546651632908
2016,KENTUCKY,LAWRENCE,1045,181,4816,6042,0.17295597484276728,0.797087057265806,0.02995696789142668
2016,KENTUCKY,LEE,444,72,2151,2667,0.16647919010123735,0.8065241844769404,0.02699662542182227
2016,KENTUCKY,LESLIE,400,77,4015,4492,0.08904719501335707,0.8938112199465716,0.01714158504007124
2016,KENTUCKY,LETCHER,1542,299,7293,9134,0.1688197941756076,0.7984453689511715,0.03273483687322093
2016,KENTUCKY,LEWIS,785,150,4363,5298,0.14816912042280106,0.823518308795772,0.028312570781426953
2016,KENTUCKY,LINCOLN,1865,358,7338,9561,0.19506327789980127,0.7674929400690305,0.037443782031168285
2016,KENTUCKY,LIVINGSTON,887,188,3570,4645,0.19095801937567278,0.7685683530678149,0.040473627556512376
2016,KENTUCKY,LOGAN,2755,366,7778,10899,0.25277548398935684,0.7136434535278466,0.03358106248279659
2016,KENTUCKY,LYON,1045,128,2789,3962,0.2637556789500252,0.7039374053508329,0.03230691569914185
2016,KENTUCKY,MADISON,11793,2147,23431,37371,0.31556554547643895,0.6269834898718257,0.057450964651735305
2016,KENTUCKY,MAGOFFIN,1172,120,3824,5116,0.2290852228303362,0.7474589523064894,0.023455824863174355
2016,KENTUCKY,MARION,2679,310,5122,8111,0.3302921957835039,0.6314881025767476,0.03821970163974849
2016,KENTUCKY,MARSHALL,3672,704,12322,16698,0.21990657563780094,0.7379326865492873,0.04216073781291173
2016,KENTUCKY,MARTIN,363,87,3503,3953,0.09182899064002024,0.8861624082974956,0.02200860106248419
2016,KENTUCKY,MASON,1970,305,4944,7219,0.272890982130489,0.6848593988086993,0.04224961906081175
2016,KENTUCKY,MCCRACKEN,9134,1399,20774,31307,0.29175583735266875,0.6635576708084454,0.04468649183888587
2016,KENTUCKY,MCCREARY,664,100,5012,5776,0.1149584487534626,0.8677285318559557,0.01731301939058172
2016,KENTUCKY,MCLEAN,988,197,3381,4566,0.21638195356986423,0.740473061760841,0.04314498466929479
2016,KENTUCKY,MEADE,3026,545,8660,12231,0.2474041370288611,0.7080369552775734,0.04455890769356553
2016,KENTUCKY,MENIFEE,700,69,2010,2779,0.2518891687657431,0.723281756027348,0.02482907520690896
2016,KENTUCKY,MERCER,2395,450,7740,10585,0.22626358053849788,0.7312234293811998,0.042512990080302314
2016,KENTUCKY,METCALFE,976,153,3491,4620,0.21125541125541125,0.7556277056277056,0.033116883116883114
2016,KENTUCKY,MONROE,601,112,4278,4991,0.1204167501502705,0.8571428571428571,0.02244039270687237
2016,KENTUCKY,MONTGOMERY,3158,438,7856,11452,0.2757596926301083,0.6859937128885785,0.03824659448131331
2016,KENTUCKY,MORGAN,1006,141,3628,4775,0.2106806282722513,0.7597905759162303,0.029528795811518325
2016,KENTUCKY,MUHLENBERG,3272,395,9393,13060,0.25053598774885144,0.719218989280245,0.03024502297090352
2016,KENTUCKY,NELSON,6434,937,13431,20802,0.3092971829631766,0.6456590712431497,0.045043745793673685
2016,KENTUCKY,NICHOLAS,787,97,1957,2841,0.2770151355156635,0.6888419570573742,0.03414290742696234
2016,KENTUCKY,OHIO,2080,376,7942,10398,0.20003846893633392,0.7638007309097904,0.036160800153875745
2016,KENTUCKY,OLDHAM,10268,2116,20469,32853,0.312543755517,0.6230481234590448,0.0644081210239552
2016,KENTUCKY,OWEN,1062,194,3745,5001,0.21235752849430115,0.7488502299540092,0.038792241551689664
2016,KENTUCKY,OWSLEY,256,29,1474,1759,0.14553723706651506,0.8379761227970438,0.01648664013644116
2016,KENTUCKY,PENDLETON,1164,239,4604,6007,0.1937739304145164,0.76643915431996,0.039786915265523554
2016,KENTUCKY,PERRY,2136,278,8158,10572,0.20204313280363223,0.7716609912977677,0.026295875898600076
2016,KENTUCKY,PIKE,4280,638,19747,24665,0.1735252381917697,0.8006081491992703,0.025866612608960064
2016,KENTUCKY,POWELL,1272,172,3513,4957,0.25660681864030666,0.7086947750655639,0.034698406294129513
2016,KENTUCKY,PULASKI,4208,931,22902,28041,0.15006597482258122,0.8167326414892478,0.03320138368817089
2016,KENTUCKY,ROBERTSON,222,32,759,1013,0.21915103652517276,0.7492596248766041,0.0315893385982231
2016,KENTUCKY,ROCKCASTLE,915,167,5609,6691,0.13675085936332387,0.8382902406217306,0.02495890001494545
2016,KENTUCKY,ROWAN,3295,379,5174,8848,0.3724005424954792,0.5847649186256781,0.04283453887884268
2016,KENTUCKY,RUSSELL,1093,218,6863,8174,0.13371666258869586,0.8396134083679961,0.02666992904330805
2016,KENTUCKY,SCOTT,7715,1433,15052,24200,0.31880165289256196,0.6219834710743801,0.059214876033057855
2016,KENTUCKY,SHELBY,6276,1108,13196,20580,0.30495626822157434,0.6412050534499514,0.05383867832847425
2016,KENTUCKY,SIMPSON,2144,310,5077,7531,0.2846899482140486,0.6741468596467932,0.041163192139158145
2016,KENTUCKY,SPENCER,1921,398,7196,9515,0.20189174986862848,0.7562795585916973,0.041828691539674195
2016,KENTUCKY,TAYLOR,2553,433,8320,11306,0.22580930479391473,0.7358924464885901,0.03829824871749513
2016,KENTUCKY,TODD,1042,125,3612,4779,0.21803724628583385,0.7558066541117389,0.026156099602427287
2016,KENTUCKY,TRIGG,1587,233,4931,6751,0.2350762849948156,0.7304103095837654,0.03451340542141905
2016,KENTUCKY,TRIMBLE,879,148,2771,3798,0.23143759873617695,0.729594523433386,0.03896787783043707
2016,KENTUCKY,UNION,1331,179,4701,6211,0.21429721461922396,0.7568829496055386,0.02881983577523748
2016,KENTUCKY,WARREN,16966,2815,28673,48454,0.3501465307301771,0.5917571304742643,0.05809633879555867
2016,KENTUCKY,WASHINGTON,1420,203,4013,5636,0.25195173882185945,0.7120298083747338,0.036018452803406674
2016,KENTUCKY,WAYNE,1431,190,6371,7992,0.17905405405405406,0.7971721721721722,0.023773773773773772
2016,KENTUCKY,WEBSTER,1240,168,4397,5805,0.2136089577950043,0.7574504737295435,0.028940568475452195
2016,KENTUCKY,WHITLEY,2067,395,11312,13774,0.15006534049658776,0.8212574415565558,0.028677217946856397
2016,KENTUCKY,WOLFE,753,78,1804,2635,0.2857685009487666,0.6846299810246679,0.029601518026565465
2016,KENTUCKY,WOODFORD,4958,908,7697,13563,0.36555334365553344,0.5674998156749982,0.0669468406694684
2016,LOUISIANA,ACADIA,5638,589,21162,27389,0.20584906349264304,0.7726459527547556,0.02150498375260141
2016,LOUISIANA,ALLEN,2106,272,6867,9245,0.22779881016765818,0.7427798810167658,0.029421308815575985
2016,LOUISIANA,ASCENSION,16476,2059,36143,54678,0.3013277735103698,0.6610153992464977,0.03765682724313252
2016,LOUISIANA,ASSUMPTION,3931,259,6714,10904,0.360509904622157,0.6157373440939105,0.0237527512839325
2016,LOUISIANA,AVOYELLES,5035,386,11165,16586,0.3035692752924153,0.6731580851320391,0.02327263957554564
2016,LOUISIANA,BEAUREGARD,2393,447,12238,15078,0.15870805146571162,0.8116461069107309,0.0296458416235575
2016,LOUISIANA,BIENVILLE,3129,120,3756,7005,0.44668094218415416,0.5361884368308352,0.017130620985010708
2016,LOUISIANA,BOSSIER,12641,1733,35474,49848,0.2535909163858129,0.7116433959236078,0.03476568769057936
2016,LOUISIANA,CADDO,53483,3315,49006,105804,0.5054912857736947,0.46317719556916565,0.031331518657139616
2016,LOUISIANA,CALCASIEU,26296,3298,54191,83785,0.31385092797040043,0.6467864176165184,0.0393626544130811
2016,LOUISIANA,CALDWELL,788,82,3822,4692,0.1679454390451833,0.8145780051150895,0.017476555839727195
2016,LOUISIANA,CAMERON,323,113,3256,3692,0.08748645720476707,0.8819068255687974,0.030606717226435536
2016,LOUISIANA,CATAHOULA,1322,55,3479,4856,0.27224052718286657,0.7164332784184514,0.011326194398682043
2016,LOUISIANA,CLAIBORNE,2717,119,3585,6421,0.4231428126460053,0.5583242485594144,0.018532938794580282
2016,LOUISIANA,CONCORDIA,3272,123,5477,8872,0.36880072137060416,0.6173354373309288,0.013863841298467088
2016,LOUISIANA,DE SOTO,5165,267,8068,13500,0.3825925925925926,0.5976296296296296,0.019777777777777776
2016,LOUISIANA,EAST BATON ROUGE,102828,9003,84660,196491,0.5233216788555201,0.4308594286761226,0.04581889246835733
2016,LOUISIANA,EAST CARROLL,1838,42,1059,2939,0.6253827832596122,0.360326641714869,0.014290575025518884
2016,LOUISIANA,EAST FELICIANA,4235,238,5569,10042,0.4217287392949612,0.5545708026289584,0.023700458076080462
2016,LOUISIANA,EVANGELINE,4208,314,10360,14882,0.28275769385835237,0.6961429915333961,0.02109931460825158
2016,LOUISIANA,FRANKLIN,2506,142,6514,9162,0.2735210652695918,0.7109801353416285,0.015498799388779742
2016,LOUISIANA,GRANT,1181,232,7408,8821,0.13388504704682008,0.8398140800362771,0.026300872916902845
2016,LOUISIANA,IBERIA,10698,853,20903,32454,0.3296357921981882,0.6440808528994885,0.026283354902323287
2016,LOUISIANA,IBERVILLE,8324,399,7320,16043,0.5188555756404662,0.45627376425855515,0.02487066010097862
2016,LOUISIANA,JACKSON,2139,156,5169,7464,0.2865755627009646,0.692524115755627,0.02090032154340836
2016,LOUISIANA,JEFFERSON,73670,7571,100398,181639,0.4055847037255215,0.5527337190801535,0.041681577194325005
2016,LOUISIANA,JEFFERSON DAVIS,3080,422,10775,14277,0.21573159627372698,0.7547103733277299,0.02955803039854311
2016,LOUISIANA,LA SALLE,605,128,5836,6569,0.0920992540721571,0.8884152839092708,0.01948546201857208
2016,LOUISIANA,LAFAYETTE,32726,4682,68195,105603,0.3098964991524862,0.6457676391769174,0.04433586167059648
2016,LOUISIANA,LAFOURCHE,8423,1263,31959,41645,0.20225717373033977,0.7674150558290311,0.030327770440629127
2016,LOUISIANA,LINCOLN,7107,801,10761,18669,0.3806845572874819,0.5764100915956933,0.04290535111682468
2016,LOUISIANA,LIVINGSTON,6950,1956,48824,57730,0.12038801316473237,0.8457301229863156,0.03388186384895202
2016,LOUISIANA,MADISON,2744,61,1927,4732,0.5798816568047337,0.4072273879966188,0.012890955198647506
2016,LOUISIANA,MOREHOUSE,5155,195,6502,11852,0.43494768815389806,0.5485993925075937,0.01645291933850827
2016,LOUISIANA,NATCHITOCHES,7144,509,8968,16621,0.4298177004993683,0.5395583899885686,0.030623909512063053
2016,LOUISIANA,ORLEANS,133996,7524,24292,165812,0.8081200395628785,0.14650326876221262,0.04537669167490893
2016,LOUISIANA,OUACHITA,24428,1855,41734,68017,0.35914550774071186,0.6135818986429863,0.027272593616301806
2016,LOUISIANA,PLAQUEMINES,3347,326,6900,10573,0.3165610517355528,0.6526056937482266,0.03083325451622056
2016,LOUISIANA,POINTE COUPEE,4764,208,6789,11761,0.40506759629283223,0.577246832752317,0.01768557095485078
2016,LOUISIANA,RAPIDES,18322,1706,36816,56844,0.3223207374568996,0.6476672999788896,0.030011962564210824
2016,LOUISIANA,RED RIVER,1938,93,2391,4422,0.43826322930800543,0.5407055630936228,0.02103120759837178
2016,LOUISIANA,RICHLAND,3157,153,6287,9597,0.3289569657184537,0.6551005522559133,0.01594248202563301
2016,LOUISIANA,SABINE,1703,205,7879,9787,0.17400633493409626,0.8050475120057219,0.020946153060181875
2016,LOUISIANA,ST. BERNARD,4960,618,10237,15815,0.31362630414163767,0.6472968700600695,0.03907682579829276
2016,LOUISIANA,ST. CHARLES,8559,1012,16621,26192,0.32677916921197314,0.6345830788026878,0.03863775198533904
2016,LOUISIANA,ST. HELENA,3353,114,2497,5964,0.562206572769953,0.4186787391012743,0.019114688128772636
2016,LOUISIANA,ST. JAMES,6418,211,5456,12085,0.5310715763342987,0.45146876292925114,0.017459660736450146
2016,LOUISIANA,ST. JOHN THE BAPTIST,12661,513,7569,20743,0.6103745841970786,0.3648941811695512,0.024731234633370295
2016,LOUISIANA,ST. LANDRY,17209,797,21971,39977,0.43047252169997746,0.5495910148335292,0.019936463466493234
2016,LOUISIANA,ST. MARTIN,8266,611,16873,25750,0.32100970873786405,0.6552621359223301,0.023728155339805827
2016,LOUISIANA,ST. MARY,8050,468,14359,22877,0.35188180268391833,0.6276609695327184,0.020457227783363202
2016,LOUISIANA,ST. TAMMANY,27717,5760,90915,124392,0.2228197954852402,0.7308749758826935,0.04630522863206637
2016,LOUISIANA,TANGIPAHOA,16878,1579,33959,52416,0.3220009157509158,0.6478746947496947,0.0301243894993895
2016,LOUISIANA,TENSAS,1332,34,1182,2548,0.5227629513343799,0.4638932496075353,0.013343799058084773
2016,LOUISIANA,TERREBONNE,10665,1329,31902,43896,0.2429606342263532,0.726763258611263,0.030276107162383815
2016,LOUISIANA,UNION,2691,231,7972,10894,0.24701670644391407,0.731778960895906,0.021204332660179917
2016,LOUISIANA,VERMILION,4857,712,20063,25632,0.18948970037453183,0.7827325218476904,0.027777777777777776
2016,LOUISIANA,VERNON,2665,497,13471,16633,0.1602236517765887,0.8098959898995972,0.029880358323814103
2016,LOUISIANA,WASHINGTON,5692,380,12556,18628,0.3055615202920335,0.6740390809534035,0.020399398754563022
2016,LOUISIANA,WEBSTER,6260,343,11542,18145,0.3449986222099752,0.6360980986497657,0.018903279140259025
2016,LOUISIANA,WEST BATON ROUGE,5383,402,6927,12712,0.42345814977973567,0.544918187539333,0.031623662680931405
2016,LOUISIANA,WEST CARROLL,715,74,3970,4759,0.150241647404917,0.8342088674091196,0.015549485185963437
2016,LOUISIANA,WEST FELICIANA,2248,161,3390,5799,0.38765304362821174,0.5845835488877392,0.027763407484048975
2016,LOUISIANA,WINN,1644,120,4608,6372,0.2580037664783427,0.7231638418079096,0.018832391713747645
2016,MAINE,ANDROSCOGGIN,23009,4365,28227,55601,0.4138234923832305,0.5076707253466665,0.07850578227010306
2016,MAINE,AROOSTOOK,13386,2292,19419,35097,0.38140011966834775,0.5532951534319173,0.06530472689973502
2016,MAINE,CUMBERLAND,102981,11128,57709,171818,0.5993609517047108,0.3358728421934838,0.0647662061018054
2016,MAINE,FRANKLIN,7016,1554,7918,16488,0.4255215914604561,0.480228044638525,0.09425036390101892
2016,MAINE,HANCOCK,16117,2308,13705,32130,0.5016184251478369,0.42654839713663245,0.07183317771553066
2016,MAINE,KENNEBEC,29302,5231,31675,66208,0.44257491541807636,0.4784165055582407,0.07900857902368294
2016,MAINE,KNOX,12443,1556,9148,23147,0.5375642631874541,0.3952132025748477,0.0672225342376982
2016,MAINE,LINCOLN,10241,1535,9727,21503,0.476259126633493,0.45235548528112357,0.07138538808538343
2016,MAINE,MAINE UOCAVA,3017,321,648,3986,0.756899147014551,0.1625689914701455,0.08053186151530356
2016,MAINE,OXFORD,12172,2819,16210,31201,0.39011570141982627,0.5195346303003109,0.09034966827986282
2016,MAINE,PENOBSCOT,32838,6080,41622,80540,0.40772287062329277,0.516786689843556,0.07549043953315122
2016,MAINE,PISCATAQUIS,3098,678,5406,9182,0.33739925942060556,0.5887606186016119,0.07384012197778261
2016,MAINE,SAGADAHOC,10664,1648,9304,21616,0.4933382679496669,0.4304219096965211,0.07623982235381199
2016,MAINE,SOMERSET,9092,1971,15001,26064,0.3488336402701044,0.5755448127685697,0.07562154696132596
2016,MAINE,WALDO,10440,1889,10378,22707,0.45977011494252873,0.45703967939401946,0.0831902056634518
2016,MAINE,WASHINGTON,6075,1197,9093,16365,0.3712190650779102,0.5556370302474793,0.07314390467461045
2016,MAINE,YORK,55844,8027,50403,114274,0.4886850902217477,0.44107145982463203,0.07024344995362025
2016,MARYLAND,ALLEGANY,7875,1509,21270,30654,0.2568995889606577,0.6938735564689763,0.04922685457036602
2016,MARYLAND,ANNE ARUNDEL,128419,19259,122403,270081,0.47548328094164344,0.4532084818998745,0.07130823715848209
2016,MARYLAND,BALTIMORE,218412,22793,149477,390682,0.5590531429653784,0.3826052902360488,0.058341566798572754
2016,MARYLAND,BALTIMORE CITY,202673,11524,25205,239402,0.846580229070768,0.10528316388334266,0.04813660704588934
2016,MARYLAND,CALVERT,18225,3007,26176,47408,0.3844287883901451,0.5521430982112724,0.06342811339858252
2016,MARYLAND,CAROLINE,4009,736,9368,14113,0.2840643378445405,0.6637851626160278,0.05215049953943173
2016,MARYLAND,CARROLL,26567,7066,58215,91848,0.28924962982318614,0.6338189182126992,0.07693145196411462
2016,MARYLAND,CECIL,13650,2751,28868,45269,0.3015308489253131,0.637699087675893,0.06077006339879388
2016,MARYLAND,CHARLES,49341,3348,25614,78303,0.6301291138270564,0.3271139036818513,0.0427569824910923
2016,MARYLAND,DORCHESTER,6245,567,8413,15225,0.4101806239737274,0.5525779967159278,0.037241379310344824
2016,MARYLAND,FREDERICK,56522,9633,59522,125677,0.4497402070386785,0.4736109232397336,0.07664886972158788
2016,MARYLAND,GARRETT,2567,668,10776,14011,0.183213189636714,0.7691099850117764,0.04767682535150953
2016,MARYLAND,HARFORD,47077,8735,77860,133672,0.35218295529355437,0.5824705248668383,0.0653465198396074
2016,MARYLAND,HOWARD,102597,12112,47484,162193,0.6325612079436227,0.29276232636426974,0.07467646569210755
2016,MARYLAND,KENT,4575,570,4876,10021,0.45654126334697137,0.48657818580979945,0.05688055084322922
2016,MARYLAND,MONTGOMERY,357837,28332,92704,478873,0.7472482265652898,0.1935878614998131,0.059163911934897145
2016,MARYLAND,PRINCE GEORGE'S,344049,13525,32811,390385,0.8813069149685567,0.08404779896768574,0.03464528606375757
2016,MARYLAND,QUEEN ANNE'S,7973,1557,16993,26523,0.3006070203219847,0.640689213135769,0.05870376654224635
2016,MARYLAND,SOMERSET,4196,363,5341,9900,0.42383838383838385,0.5394949494949495,0.03666666666666667
2016,MARYLAND,ST. MARY'S,17534,3645,28663,49842,0.3517916616508166,0.5750772440913285,0.07313109425785481
2016,MARYLAND,TALBOT,8653,1176,10724,20553,0.42100909842845324,0.5217729771809468,0.05721792439059991
2016,MARYLAND,WASHINGTON,21129,3864,40998,65991,0.3201800245488021,0.6212665363458654,0.05855343910533255
2016,MARYLAND,WICOMICO,18050,2299,22198,42547,0.42423672644369753,0.5217289115566315,0.05403436199967095
2016,MARYLAND,WORCESTER,9753,1310,17210,28273,0.3449580872210236,0.6087079545856471,0.046333958193329326
2016,MASSACHUSETTS,BARNSTABLE,72430,7333,54099,133862,0.541079619309438,0.40414008456470096,0.05478029612586096
2016,MASSACHUSETTS,BERKSHIRE,43714,4250,16839,64803,0.6745675354536056,0.25984908106106197,0.06558338348533246
2016,MASSACHUSETTS,BRISTOL,129540,13976,105443,248959,0.5203266401294993,0.42353560224775966,0.05613775762274109
2016,MASSACHUSETTS,DUKES,8400,625,2477,11502,0.7303077725612936,0.21535385150408626,0.05433837593462006
2016,MASSACHUSETTS,ESSEX,222310,21242,136316,379868,0.5852296060736888,0.3588509692840671,0.05591942464224415
2016,MASSACHUSETTS,FRANKLIN,24478,3335,10364,38177,0.6411713859129843,0.27147235246352514,0.08735626162349058
2016,MASSACHUSETTS,HAMPDEN,112590,11842,78685,203117,0.5543110620972149,0.3873875648025522,0.058301373100232874
2016,MASSACHUSETTS,HAMPSHIRE,55367,5799,21790,82956,0.6674261054052751,0.26266936689329284,0.06990452770143209
2016,MASSACHUSETTS,MIDDLESEX,520360,43881,219793,784034,0.6636957070739279,0.2803360568546772,0.05596823607139486
2016,MASSACHUSETTS,NANTUCKET,4146,368,1892,6406,0.6472057446144239,0.2953481111458008,0.05744614423977521
2016,MASSACHUSETTS,NORFOLK,221819,20020,119723,361562,0.6135019719992698,0.33112716491224187,0.05537086308848828
2016,MASSACHUSETTS,PLYMOUTH,135513,15981,115369,266863,0.5077998823366296,0.4323154577442358,0.05988465991913454
2016,MASSACHUSETTS,SUFFOLK,245751,12569,50421,308741,0.7959778584638905,0.16331164309243024,0.04071049844367933
2016,MASSACHUSETTS,WORCESTER,198778,27245,157682,383705,0.5180490220351572,0.4109459089665238,0.07100506899831902
2016,MICHIGAN,ALCONA,1732,265,4201,6198,0.2794449822523395,0.6777992900935785,0.04275572765408196
2016,MICHIGAN,ALGER,1663,270,2585,4518,0.36808322266489596,0.5721558211598052,0.05976095617529881
2016,MICHIGAN,ALLEGAN,18050,3553,34183,55786,0.3235578819058545,0.6127523034453088,0.06368981464883662
2016,MICHIGAN,ALPENA,4877,731,9090,14698,0.3318138522247925,0.6184514899986393,0.04973465777656824
2016,MICHIGAN,ANTRIM,4448,665,8469,13582,0.3274922691797968,0.6235458695332057,0.0489618612869975
2016,MICHIGAN,ARENAC,2384,362,4950,7696,0.3097713097713098,0.6431912681912682,0.04703742203742204
2016,MICHIGAN,BARAGA,1156,176,2158,3490,0.3312320916905444,0.6183381088825215,0.0504297994269341
2016,MICHIGAN,BARRY,9114,2013,19202,30329,0.30050446767120575,0.6331234132348578,0.06637211909393649
2016,MICHIGAN,BAY,21642,3007,28328,52977,0.4085169035619231,0.53472261547464,0.056760480963436964
2016,MICHIGAN,BENZIE,4108,581,5539,10228,0.40164254986312087,0.54155260070395,0.05680484943292921
2016,MICHIGAN,BERRIEN,29495,3889,38647,72031,0.40947647540642224,0.536532881675945,0.053990642917632684
2016,MICHIGAN,BRANCH,5061,816,11786,17663,0.28653116684594915,0.6672705655890845,0.04619826756496631
2016,MICHIGAN,CALHOUN,24157,3251,31494,58902,0.4101218973888832,0.5346847305694203,0.05519337204169638
2016,MICHIGAN,CASS,7270,1082,14243,22595,0.32175260013277274,0.6303606992697499,0.047886700597477315
2016,MICHIGAN,CHARLEVOIX,5137,778,8674,14589,0.35211460689560625,0.5945575433545822,0.0533278497498115
2016,MICHIGAN,CHEBOYGAN,4302,687,8683,13672,0.3146576945582212,0.6350936220011703,0.050248683440608545
2016,MICHIGAN,CHIPPEWA,5379,955,9122,15456,0.3480201863354037,0.5901915113871635,0.06178830227743271
2016,MICHIGAN,CLARE,4249,635,8505,13389,0.3173500634849503,0.6352229442079319,0.047426992307117784
2016,MICHIGAN,CLINTON,16492,2527,21636,40655,0.4056573607182388,0.5321854630426762,0.06215717623908498
2016,MICHIGAN,CRAWFORD,2110,380,4354,6844,0.3082992402104033,0.636177673874927,0.055523085914669784
2016,MICHIGAN,DELTA,6436,935,11121,18492,0.3480423967120917,0.6013951979234263,0.050562405364481935
2016,MICHIGAN,DICKINSON,3923,662,8580,13165,0.29798708697303455,0.6517280668439043,0.050284846183061144
2016,MICHIGAN,EATON,24938,3674,27609,56221,0.44357090766795326,0.4910798456092919,0.06534924672275484
2016,MICHIGAN,EMMET,6972,1214,10616,18802,0.3708116157855547,0.5646207850228699,0.06456759919157537
2016,MICHIGAN,GENESEE,102751,9370,84175,196296,0.5234492806781595,0.428816685006317,0.0477340343155235
2016,MICHIGAN,GLADWIN,3794,554,8124,12472,0.30420141116100063,0.6513790891597178,0.04441949967928159
2016,MICHIGAN,GOGEBIC,2925,386,4018,7329,0.39909946786737616,0.5482330468003821,0.05266748533224178
2016,MICHIGAN,GRAND TRAVERSE,20965,3211,27413,51589,0.40638508209114343,0.5313729671053907,0.062241950803465854
2016,MICHIGAN,GRATIOT,5666,919,9880,16465,0.34412389918007896,0.6000607348921956,0.05581536592772548
2016,MICHIGAN,HILLSDALE,4799,1046,14095,19940,0.24067201604814442,0.7068706118355065,0.05245737211634905
2016,MICHIGAN,HOUGHTON,6018,1131,8475,15624,0.38517665130568357,0.5424347158218126,0.07238863287250384
2016,MICHIGAN,HURON,4579,646,10692,15917,0.2876798391656719,0.6717346233586731,0.04058553747565496
2016,MICHIGAN,INGHAM,79110,8160,43868,131138,0.6032576369930912,0.3345178361725816,0.0622245268343272
2016,MICHIGAN,IONIA,8352,1867,16635,26854,0.31101511879049676,0.6194607879645491,0.06952409324495419
2016,MICHIGAN,IOSCO,4345,671,8345,13361,0.32520020956515233,0.6245789985779507,0.050220791856896936
2016,MICHIGAN,IRON,2004,231,3675,5910,0.33908629441624366,0.6218274111675127,0.03908629441624366
2016,MICHIGAN,ISABELLA,11404,1650,12338,25392,0.4491178323881537,0.48590107120352866,0.06498109640831758
2016,MICHIGAN,JACKSON,25795,4089,39793,69677,0.37020824662370655,0.5711066779568581,0.05868507541943539
2016,MICHIGAN,KALAMAZOO,67148,8117,51034,126299,0.5316589996753736,0.4040728746862604,0.0642681256383661
2016,MICHIGAN,KALKASKA,2280,437,6116,8833,0.25812294803577496,0.6924034869240349,0.049473565040190196
2016,MICHIGAN,KENT,138683,21321,148180,308184,0.4500006489629572,0.48081665498533344,0.06918269605170937
2016,MICHIGAN,KEWEENAW,527,93,814,1434,0.36750348675034866,0.5676429567642957,0.06485355648535565
2016,MICHIGAN,LAKE,1939,230,3159,5328,0.3639264264264264,0.5929054054054054,0.04316816816816817
2016,MICHIGAN,LAPEER,12734,2412,30037,45183,0.2818316623508842,0.6647854281477547,0.05338290950136113
2016,MICHIGAN,LEELANAU,6774,744,7239,14757,0.45903638951006304,0.49054685911770685,0.05041675137223013
2016,MICHIGAN,LENAWEE,16750,2759,26430,45939,0.3646139445786804,0.5753281525501208,0.06005790287119876
2016,MICHIGAN,LIVINGSTON,34384,5802,65680,105866,0.3247879394706516,0.6204069295146695,0.05480513101467893
2016,MICHIGAN,LUCE,681,142,1756,2579,0.2640558355951919,0.680884063590539,0.0550601008142691
2016,MICHIGAN,MACKINAC,2085,268,3744,6097,0.34197146137444645,0.6140724946695096,0.04395604395604396
2016,MICHIGAN,MACOMB,176317,18330,224665,419312,0.42049118556110965,0.5357943488380967,0.04371446560079368
2016,MICHIGAN,MANISTEE,4979,705,6915,12599,0.39519009445194064,0.5488530835780617,0.05595682196999762
2016,MICHIGAN,MARQUETTE,16042,2288,14646,32976,0.48647501213003397,0.44414119359534204,0.06938379427462397
2016,MICHIGAN,MASON,5281,899,8505,14685,0.35961865849506297,0.5791624106230848,0.06121893088185223
2016,MICHIGAN,MECOSTA,5827,1036,10305,17168,0.33941053122087605,0.6002446411929171,0.0603448275862069
2016,MICHIGAN,MENOMINEE,3539,527,6702,10768,0.3286589895988113,0.6223997028231798,0.048941307578008915
2016,MICHIGAN,MIDLAND,15635,3025,23846,42506,0.36783042394014964,0.5610031524961182,0.07116642356373218
2016,MICHIGAN,MISSAUKEE,1565,366,5386,7317,0.2138854721880552,0.7360940276069428,0.05002050020500205
2016,MICHIGAN,MONROE,26863,4094,43261,74218,0.3619472365194427,0.5828909428979493,0.05516182058260799
2016,MICHIGAN,MONTCALM,7874,1828,16907,26609,0.29591491600586267,0.6353865233567589,0.06869856063737834
2016,MICHIGAN,MONTMORENCY,1287,224,3498,5009,0.25693751247754043,0.6983429826312637,0.044719504891195846
2016,MICHIGAN,MUSKEGON,37304,4657,36127,78088,0.4777174469828911,0.46264470853396167,0.05963784448314722
2016,MICHIGAN,NEWAYGO,6212,1255,15173,22640,0.2743816254416961,0.6701855123674911,0.05543286219081272
2016,MICHIGAN,OAKLAND,343070,32341,289203,664614,0.5161943624419588,0.4351443093284222,0.048661328229618994
2016,MICHIGAN,OCEANA,3973,729,7228,11930,0.3330259849119866,0.6058675607711651,0.06110645431684828
2016,MICHIGAN,OGEMAW,3030,530,6827,10387,0.29171079233657454,0.6572638875517474,0.05102532011167806
2016,MICHIGAN,ONTONAGON,1176,184,2066,3426,0.3432574430823117,0.603035610040864,0.053706946876824285
2016,MICHIGAN,OSCEOLA,2705,568,7336,10609,0.25497219342068056,0.6914883589405222,0.05353944763879725
2016,MICHIGAN,OSCODA,1044,186,2843,4073,0.256322121286521,0.6980112938865701,0.04566658482690891
2016,MICHIGAN,OTSEGO,3556,716,8266,12538,0.28361780188227786,0.6592758015632477,0.0571063965544744
2016,MICHIGAN,OTTAWA,44973,9294,88467,142734,0.3150826012022363,0.6198032704191012,0.0651141283786624
2016,MICHIGAN,PRESQUE ISLE,2400,330,4488,7218,0.3325020781379884,0.6217788861180382,0.0457190357439734
2016,MICHIGAN,ROSCOMMON,4287,613,8141,13041,0.32873245916724175,0.6242619431025228,0.04700559773023541
2016,MICHIGAN,SAGINAW,44396,4455,45469,94320,0.4706955046649703,0.48207167090754877,0.04723282442748092
2016,MICHIGAN,SANILAC,4873,930,13446,19249,0.2531560081043171,0.6985297937555197,0.04831419814016313
2016,MICHIGAN,SCHOOLCRAFT,1369,229,2556,4154,0.32956186807896004,0.6153105440539239,0.05512758786711603
2016,MICHIGAN,SHIAWASSEE,12546,2335,19230,34111,0.3677992436457448,0.5637477646506992,0.06845299170355604
2016,MICHIGAN,ST. CLAIR,24553,4399,49051,78003,0.3147699447457149,0.6288347884055742,0.05639526684871095
2016,MICHIGAN,ST. JOSEPH,7526,1347,14884,23757,0.31679084059435114,0.6265100812392137,0.05669907816643516
2016,MICHIGAN,TUSCOLA,7429,1265,17102,25796,0.28799038610637306,0.6629710032563189,0.04903861063730811
2016,MICHIGAN,VAN BUREN,13258,2126,17890,33274,0.3984492396465709,0.5376570295125324,0.06389373084089679
2016,MICHIGAN,WASHTENAW,128483,9464,50631,188578,0.6813254992629044,0.26848837085980337,0.05018612987729215
2016,MICHIGAN,WAYNE,519444,29401,228993,777838,0.6678048642519393,0.2943967767067179,0.0377983590413428
2016,MICHIGAN,WEXFORD,4436,862,10000,15298,0.2899725454307753,0.6536802196365538,0.056347234932670937
2016,MINNESOTA,AITKIN,3134,581,5516,9231,0.3395081789621926,0.5975517278734699,0.06294009316433756
2016,MINNESOTA,ANOKA,75500,16919,93339,185758,0.4064427911583889,0.5024763401845411,0.09108086865706995
2016,MINNESOTA,BECKER,5208,1134,10880,17222,0.30240390198583206,0.631750087097898,0.06584601091626989
2016,MINNESOTA,BELTRAMI,8688,2093,10783,21564,0.4028937117417919,0.5000463735856057,0.09705991467260248
2016,MINNESOTA,BENTON,5640,1546,12872,20058,0.28118456476218967,0.6417389570246286,0.07707647821318177
2016,MINNESOTA,BIG STONE,921,226,1608,2755,0.33430127041742286,0.5836660617059891,0.08203266787658803
2016,MINNESOTA,BLUE EARTH,14428,3498,15667,33593,0.4294942398714018,0.4663769237638794,0.10412883636471884
2016,MINNESOTA,BROWN,3763,1308,8708,13779,0.27309674141810003,0.6319761956600625,0.09492706292183758
2016,MINNESOTA,CARLTON,8460,1591,8160,18211,0.464554390203723,0.4480808302674208,0.08736477952885618
2016,MINNESOTA,CARVER,21508,5132,29056,55696,0.3861677678827923,0.5216891697787992,0.09214306233840851
2016,MINNESOTA,CASS,4949,1068,9982,15999,0.30933183323957747,0.623913994624664,0.06675417213575849
2016,MINNESOTA,CHIPPEWA,1978,480,3764,6222,0.31790421086467374,0.6049501767920283,0.07714561234329798
2016,MINNESOTA,CHISAGO,9278,2509,18441,30228,0.3069339685060209,0.6100635172687574,0.08300251422522165
2016,MINNESOTA,CLAY,12971,2884,13543,29398,0.4412204911898769,0.46067759711545003,0.09810191169467311
2016,MINNESOTA,CLEARWATER,1100,220,2925,4245,0.2591283863368669,0.6890459363957597,0.05182567726737338
2016,MINNESOTA,COOK,1912,327,1156,3395,0.563181148748159,0.34050073637702505,0.09631811487481591
2016,MINNESOTA,COTTONWOOD,1678,364,3679,5721,0.2933053661947212,0.6430693934626813,0.06362524034259745
2016,MINNESOTA,CROW WING,10982,2573,22287,35842,0.30640031248256233,0.6218123988616706,0.07178728865576697
2016,MINNESOTA,DAKOTA,110483,21374,99583,231440,0.47737210508123057,0.43027566539923956,0.0923522295195299
2016,MINNESOTA,DODGE,3102,1025,6527,10654,0.2911582504223766,0.6126337525811901,0.09620799699643326
2016,MINNESOTA,DOUGLAS,6227,1592,13966,21785,0.2858388799632775,0.6410833142070231,0.07307780582969933
2016,MINNESOTA,FARIBAULT,2153,600,4659,7412,0.2904749055585537,0.6285752833243389,0.08094981111710739
2016,MINNESOTA,FILLMORE,3872,912,6271,11055,0.3502487562189055,0.5672546359113523,0.0824966078697422
2016,MINNESOTA,FREEBORN,6041,1202,8808,16051,0.376362843436546,0.5487508566444458,0.07488629991900816
2016,MINNESOTA,GOODHUE,9446,2230,14041,25717,0.3673056732900416,0.545981257533927,0.08671306917603142
2016,MINNESOTA,GRANT,1105,305,2063,3473,0.3181687302044342,0.594010941549093,0.08782032824647279
2016,MINNESOTA,HENNEPIN,429288,58919,191770,679977,0.6313272360682788,0.2820242449376964,0.0866485189940248
2016,MINNESOTA,HOUSTON,4145,843,5616,10604,0.39089023010184837,0.5296114673708034,0.07949830252734817
2016,MINNESOTA,HUBBARD,3423,821,7261,11505,0.297522816166884,0.6311169056931769,0.07136027813993916
2016,MINNESOTA,ISANTI,5657,1724,13635,21016,0.26917586600685195,0.6487913970308337,0.08203273696231443
2016,MINNESOTA,ITASCA,9015,1945,12920,23880,0.37751256281407036,0.541038525963149,0.08144891122278057
2016,MINNESOTA,JACKSON,1492,383,3609,5484,0.27206418672501825,0.6580962800875274,0.06983953318745441
2016,MINNESOTA,KANABEC,2327,620,5230,8177,0.2845786963434022,0.6395988748929925,0.07582242876360523
2016,MINNESOTA,KANDIYOHI,7266,1721,12785,21772,0.3337313981260334,0.5872221201543266,0.0790464817196399
2016,MINNESOTA,KITTSON,823,213,1349,2385,0.3450733752620545,0.5656184486373166,0.08930817610062892
2016,MINNESOTA,KOOCHICHING,2306,488,3569,6363,0.3624076693383624,0.5608989470375609,0.0766933836240767
2016,MINNESOTA,LAC QUI PARLE,1305,262,2293,3860,0.3380829015544041,0.594041450777202,0.06787564766839378
2016,MINNESOTA,LAKE,3077,512,2932,6521,0.4718601441496703,0.449624290752952,0.0785155650973777
2016,MINNESOTA,LAKE OF THE WOODS,553,149,1540,2242,0.24665477252453166,0.6868867082961642,0.06645851917930419
2016,MINNESOTA,LE SUEUR,4623,1166,9182,14971,0.308797007547926,0.6133190835615523,0.07788390889052167
2016,MINNESOTA,LINCOLN,860,228,1931,3019,0.2848625372639947,0.639615766810202,0.07552169592580324
2016,MINNESOTA,LYON,3825,1134,7256,12215,0.3131395824805567,0.5940237413016782,0.09283667621776505
2016,MINNESOTA,MAHNOMEN,930,167,991,2088,0.4454022988505747,0.4746168582375479,0.07998084291187739
2016,MINNESOTA,MARSHALL,1225,384,3208,4817,0.2543076603695246,0.6659746730330081,0.0797176665974673
2016,MINNESOTA,MARTIN,2733,736,7062,10531,0.25951951381635174,0.670591586743899,0.06988889943974931
2016,MINNESOTA,MCLEOD,4978,1674,12155,18807,0.26468867974690274,0.646301908863721,0.08900941138937629
2016,MINNESOTA,MEEKER,3191,987,8104,12282,0.2598111056831135,0.6598273896759486,0.08036150464093796
2016,MINNESOTA,MILLE LACS,3710,967,8340,13017,0.28501190750556965,0.6407006222631942,0.07428747023123608
2016,MINNESOTA,MORRISON,3637,1052,12925,17614,0.2064834790507551,0.7337913023731123,0.059725218576132624
2016,MINNESOTA,MOWER,7437,1455,8823,17715,0.41981371718882304,0.49805249788314987,0.0821337849280271
2016,MINNESOTA,MURRAY,1295,399,2974,4668,0.27742073693230507,0.6371036846615252,0.08547557840616966
2016,MINNESOTA,NICOLLET,7886,1774,8437,18097,0.43576283361883184,0.46620986903906725,0.0980272973421009
2016,MINNESOTA,NOBLES,2733,600,5299,8632,0.3166126042632067,0.6138785912882299,0.06950880444856349
2016,MINNESOTA,NORMAN,1264,298,1699,3261,0.3876111622201779,0.5210058264336094,0.09138301134621282
2016,MINNESOTA,OLMSTED,36268,8193,35668,80129,0.4526201500081119,0.44513222428833504,0.10224762570355302
2016,MINNESOTA,OTTER TAIL,9340,2221,20939,32500,0.2873846153846154,0.6442769230769231,0.06833846153846154
2016,MINNESOTA,PENNINGTON,2147,568,4000,6715,0.3197319434102755,0.5956813104988831,0.0845867460908414
2016,MINNESOTA,PINE,4580,1040,8191,13811,0.33161972340887697,0.5930779813192383,0.07530229527188473
2016,MINNESOTA,PIPESTONE,1127,343,3338,4808,0.2344009983361065,0.6942595673876872,0.07133943427620633
2016,MINNESOTA,POLK,4712,1105,8979,14796,0.31846444985131117,0.606853203568532,0.0746823465801568
2016,MINNESOTA,POPE,2106,420,3793,6319,0.33328058237062824,0.6002532046209843,0.0664662130083874
2016,MINNESOTA,RAMSEY,177738,24511,70894,273143,0.6507140948148039,0.259549027432517,0.089736877752679
2016,MINNESOTA,RED LAKE,540,200,1141,1881,0.28708133971291866,0.6065922381711856,0.1063264221158958
2016,MINNESOTA,REDWOOD,1887,587,5137,7611,0.24793062672447774,0.6749441597687558,0.07712521350676652
2016,MINNESOTA,RENVILLE,2117,599,4890,7606,0.2783328950828293,0.6429134893505127,0.0787536155666579
2016,MINNESOTA,RICE,14437,2577,15429,32443,0.4449958388558395,0.47557254261319853,0.07943161853096199
2016,MINNESOTA,ROCK,1373,375,3091,4839,0.28373630915478404,0.6387683405662327,0.07749535027898326
2016,MINNESOTA,ROSEAU,1856,497,5451,7804,0.23782675550999488,0.6984879548949257,0.06368528959507945
2016,MINNESOTA,SAINT LOUIS,57771,10021,44630,112422,0.5138762875593745,0.39698635498389995,0.08913735745672555
2016,MINNESOTA,SCOTT,28502,6579,39948,75029,0.3798797798184702,0.5324341254714844,0.08768609471004545
2016,MINNESOTA,SHERBURNE,13293,3937,31053,48283,0.2753142928152766,0.6431456206118096,0.08154008657291387
2016,MINNESOTA,SIBLEY,1954,627,5193,7774,0.2513506560329303,0.6679958837149472,0.08065346025212246
2016,MINNESOTA,STEARNS,25576,6399,47617,79592,0.32133882802291686,0.5982636445873957,0.0803975273896874
2016,MINNESOTA,STEELE,6241,1740,11198,19179,0.3254079983315084,0.583867772042338,0.0907242296261536
2016,MINNESOTA,STEVENS,2116,483,2799,5398,0.39199703593923674,0.5185253797702853,0.08947758429047796
2016,MINNESOTA,SWIFT,1686,345,2963,4994,0.33760512615138166,0.5933119743692431,0.06908289947937525
2016,MINNESOTA,TODD,2783,725,8485,11993,0.2320520303510381,0.7074960393562911,0.06045193029267072
2016,MINNESOTA,TRAVERSE,630,119,1049,1798,0.3503893214682981,0.5834260289210234,0.06618464961067853
2016,MINNESOTA,WABASHA,3866,977,6989,11832,0.3267410412440838,0.5906862745098039,0.08257268424611224
2016,MINNESOTA,WADENA,1684,413,4837,6934,0.24286126334006344,0.6975771560426882,0.05956158061724834
2016,MINNESOTA,WASECA,2838,848,5967,9653,0.29400186470527295,0.618149797990262,0.08784833730446494
2016,MINNESOTA,WASHINGTON,67086,12721,64428,144235,0.46511595659860644,0.4466876971608833,0.08819634624051027
2016,MINNESOTA,WATONWAN,1814,416,2768,4998,0.3629451780712285,0.5538215286114446,0.08323329331732693
2016,MINNESOTA,WILKIN,893,280,2129,3302,0.2704421562689279,0.6447607510599637,0.08479709267110842
2016,MINNESOTA,WINONA,11366,2586,12122,26074,0.4359131702078699,0.4649075707601442,0.09917925903198589
2016,MINNESOTA,WRIGHT,20334,6010,43274,69618,0.2920796345772645,0.6215921169812405,0.08632824844149502
2016,MINNESOTA,YELLOW MEDICINE,1524,370,3382,5276,0.288855193328279,0.6410159211523881,0.07012888551933283
2016,MISSISSIPPI,ADAMS,7757,205,5874,13836,0.5606389129806303,0.42454466608846486,0.014816420930904886
2016,MISSISSIPPI,ALCORN,2684,280,11819,14783,0.18155989988500304,0.7994994250152202,0.01894067509977677
2016,MISSISSIPPI,AMITE,2697,64,4289,7050,0.3825531914893617,0.6083687943262411,0.009078014184397163
2016,MISSISSIPPI,ATTALA,3242,117,4897,8256,0.39268410852713176,0.5931443798449613,0.014171511627906976
2016,MISSISSIPPI,BENTON,1719,43,2251,4013,0.42835783702965363,0.5609269872913033,0.01071517567904311
2016,MISSISSIPPI,BOLIVAR,9046,188,4590,13824,0.6543692129629629,0.33203125,0.013599537037037037
2016,MISSISSIPPI,CALHOUN,1910,96,4390,6396,0.2986241400875547,0.6863664790494058,0.0150093808630394
2016,MISSISSIPPI,CARROLL,1680,49,3799,5528,0.30390738060781475,0.6872286541244573,0.00886396526772793
2016,MISSISSIPPI,CHICKASAW,3649,114,4127,7890,0.46248415716096325,0.5230671736375159,0.014448669201520912
2016,MISSISSIPPI,CHOCTAW,1218,59,2788,4065,0.2996309963099631,0.6858548585485855,0.014514145141451414
2016,MISSISSIPPI,CLAIBORNE,3708,24,540,4272,0.8679775280898876,0.12640449438202248,0.0056179775280898875
2016,MISSISSIPPI,CLARKE,2585,69,5137,7791,0.3317930945963291,0.6593505326658965,0.008856372737774355
2016,MISSISSIPPI,CLAY,5722,131,4150,10003,0.5720283914825552,0.41487553733879834,0.013096071178646406
2016,MISSISSIPPI,COAHOMA,6378,108,2426,8912,0.7156642728904847,0.2722172351885099,0.012118491921005385
2016,MISSISSIPPI,COPIAH,6741,138,6103,12982,0.5192574333692805,0.4701124634108766,0.01063010321984286
2016,MISSISSIPPI,COVINGTON,3276,100,5435,8811,0.3718079673135853,0.616842583134718,0.011349449551696743
2016,MISSISSIPPI,DESOTO,20591,2015,43089,65695,0.313433290204734,0.6558946647385646,0.030672045056701423
2016,MISSISSIPPI,FORREST,11716,887,15461,28064,0.41747434435575825,0.5509193272519954,0.031606328392246294
2016,MISSISSIPPI,FRANKLIN,1502,67,2721,4290,0.35011655011655013,0.6342657342657343,0.015617715617715617
2016,MISSISSIPPI,GEORGE,1027,168,8696,9891,0.10383176625214842,0.8791830957436053,0.016985138004246284
2016,MISSISSIPPI,GREENE,974,60,4335,5369,0.1814118085304526,0.8074129260569939,0.011175265412553549
2016,MISSISSIPPI,GRENADA,4424,119,5970,10513,0.4208123275944069,0.5678683534671359,0.011319318938457149
2016,MISSISSIPPI,HANCOCK,3344,482,13811,17637,0.18960140613483017,0.7830696830526733,0.027328910812496457
2016,MISSISSIPPI,HARRISON,21169,1790,40354,63313,0.3343547138818252,0.6373730513480643,0.028272234770110403
2016,MISSISSIPPI,HINDS,67594,1812,25275,94681,0.7139130342941034,0.26694901828244316,0.01913794742345349
2016,MISSISSIPPI,HOLMES,6689,78,1309,8076,0.8282565626547796,0.16208519068845964,0.009658246656760773
2016,MISSISSIPPI,HUMPHREYS,3071,31,1151,4253,0.7220785328003763,0.27063249470961676,0.0072889724900070535
2016,MISSISSIPPI,ISSAQUENA,395,6,298,699,0.5650929899856938,0.4263233190271817,0.008583690987124463
2016,MISSISSIPPI,ITAWAMBA,1117,150,8470,9737,0.11471705864229229,0.8698777857656362,0.01540515559207148
2016,MISSISSIPPI,JACKSON,14657,1281,33629,49567,0.29570076865656586,0.678455423971594,0.025843807371840135
2016,MISSISSIPPI,JASPER,4368,69,4038,8475,0.5153982300884956,0.47646017699115045,0.008141592920353982
2016,MISSISSIPPI,JEFFERSON,3337,33,490,3860,0.8645077720207254,0.12694300518134716,0.00854922279792746
2016,MISSISSIPPI,JEFFERSON DAVIS,3720,51,2466,6237,0.5964405964405964,0.3953823953823954,0.008177008177008177
2016,MISSISSIPPI,JONES,7791,428,20133,28352,0.2747954288939052,0.7101086343115124,0.015095936794582392
2016,MISSISSIPPI,KEMPER,2827,34,1778,4639,0.6093985772795861,0.3832722569519293,0.007329165768484587
2016,MISSISSIPPI,LAFAYETTE,7969,802,10872,19643,0.4056915949702184,0.5534796110573741,0.040828793972407476
2016,MISSISSIPPI,LAMAR,5190,651,18751,24592,0.21104424202992844,0.7624837345478205,0.026472023422251138
2016,MISSISSIPPI,LAUDERDALE,11269,496,17741,29506,0.381922320883888,0.6012675388056666,0.016810140310445334
2016,MISSISSIPPI,LAWRENCE,2195,78,4091,6364,0.3449088623507228,0.6428346951602766,0.01225644248900063
2016,MISSISSIPPI,LEAKE,3584,83,4782,8449,0.424192212096106,0.5659841401349273,0.009823647768966742
2016,MISSISSIPPI,LEE,10029,664,22220,32913,0.30471242366238266,0.6751131771640385,0.020174399173578828
2016,MISSISSIPPI,LEFLORE,7787,141,3212,11140,0.6990125673249551,0.2883303411131059,0.01265709156193896
2016,MISSISSIPPI,LINCOLN,4458,185,10550,15193,0.2934246034357928,0.6943987362601198,0.012176660304087409
2016,MISSISSIPPI,LOWNDES,11819,485,13271,25575,0.46213098729227764,0.5189051808406647,0.018963831867057673
2016,MISSISSIPPI,MADISON,20343,1194,28265,49802,0.4084775711818803,0.5675474880526886,0.023974940765431108
2016,MISSISSIPPI,MARION,3677,180,7836,11693,0.314461643718464,0.6701445309159326,0.015393825365603353
2016,MISSISSIPPI,MARSHALL,8023,229,6587,14839,0.5406698564593302,0.4438978367814543,0.01543230675921558
2016,MISSISSIPPI,MONROE,5524,193,10167,15884,0.347771342231176,0.6400780659783429,0.012150591790480987
2016,MISSISSIPPI,MONTGOMERY,2115,63,2818,4996,0.4233386709367494,0.5640512409927942,0.012610088070456365
2016,MISSISSIPPI,NESHOBA,2715,159,7679,10553,0.2572728134179854,0.7276603809343315,0.015066805647683123
2016,MISSISSIPPI,NEWTON,2756,134,6548,9438,0.29201101928374656,0.6937910574274211,0.01419792328883238
2016,MISSISSIPPI,NOXUBEE,4347,27,1200,5574,0.7798708288482239,0.21528525296017223,0.004843918191603875
2016,MISSISSIPPI,OKTIBBEHA,8859,689,8576,18124,0.4887993820348709,0.4731847274332377,0.038015890531891416
2016,MISSISSIPPI,PANOLA,7431,184,7449,15064,0.49329527349973445,0.494490175252257,0.012214551248008496
2016,MISSISSIPPI,PEARL RIVER,3604,497,17782,21883,0.164694054745693,0.8125942512452589,0.02271169400904812
2016,MISSISSIPPI,PERRY,1220,77,4135,5432,0.22459499263622976,0.7612297496318114,0.014175257731958763
2016,MISSISSIPPI,PIKE,8043,258,8009,16310,0.49313304721030043,0.49104843654199876,0.0158185162477008
2016,MISSISSIPPI,PONTOTOC,2386,262,10336,12984,0.18376463339494764,0.7960566851509551,0.02017868145409735
2016,MISSISSIPPI,PRENTISS,2067,157,7648,9872,0.20938006482982172,0.7747163695299838,0.01590356564019449
2016,MISSISSIPPI,QUITMAN,2312,52,1001,3365,0.687072808320951,0.2974739970282318,0.015453194650817237
2016,MISSISSIPPI,RANKIN,14110,1480,47178,62768,0.224796074432832,0.7516250318633698,0.023578893703798114
2016,MISSISSIPPI,SCOTT,4268,132,6122,10522,0.40562630678578215,0.5818285497053792,0.012545143508838624
2016,MISSISSIPPI,SHARKEY,1479,19,692,2190,0.6753424657534246,0.31598173515981737,0.008675799086757991
2016,MISSISSIPPI,SIMPSON,3874,152,7393,11419,0.3392591295209738,0.6474297223925037,0.013311148086522463
2016,MISSISSIPPI,SMITH,1617,82,5928,7627,0.21200996459944932,0.7772387570473318,0.010751278353218829
2016,MISSISSIPPI,STONE,1573,166,5306,7045,0.22327892122072393,0.7531582682753726,0.023562810503903478
2016,MISSISSIPPI,SUNFLOWER,6725,79,2794,9598,0.7006668055844968,0.2911023129818712,0.008230881433632006
2016,MISSISSIPPI,TALLAHATCHIE,3337,71,2462,5870,0.5684838160136286,0.4194207836456559,0.012095400340715502
2016,MISSISSIPPI,TATE,3926,206,7495,11627,0.33766233766233766,0.6446202803818698,0.017717381955792554
2016,MISSISSIPPI,TIPPAH,1842,153,7240,9235,0.19945858148348675,0.7839740119112074,0.016567406605305902
2016,MISSISSIPPI,TISHOMINGO,999,206,7166,8371,0.1193405805757974,0.8560506510572213,0.024608768366981244
2016,MISSISSIPPI,TUNICA,2667,47,853,3567,0.7476871320437343,0.23913652929632745,0.013176338659938324
2016,MISSISSIPPI,UNION,2012,249,9235,11496,0.17501739735560196,0.8033228949199722,0.021659707724425888
2016,MISSISSIPPI,WALTHALL,2790,73,4056,6919,0.4032374620609915,0.5862118803295274,0.010550657609481139
2016,MISSISSIPPI,WARREN,9284,365,9767,19416,0.4781623403378657,0.5030387309435517,0.018798928718582613
2016,MISSISSIPPI,WASHINGTON,11380,201,5244,16825,0.6763744427934621,0.3116790490341753,0.011946508172362556
2016,MISSISSIPPI,WAYNE,3524,85,5990,9599,0.3671215751640796,0.6240233357641422,0.00885508907177831
2016,MISSISSIPPI,WEBSTER,1019,74,3976,5069,0.20102584336160978,0.7843756164924048,0.014598540145985401
2016,MISSISSIPPI,WILKINSON,2857,43,1318,4218,0.677335229966809,0.31247036510194404,0.010194404931247037
2016,MISSISSIPPI,WINSTON,3850,121,4910,8881,0.4335097398941561,0.552865668280599,0.013624591825244906
2016,MISSISSIPPI,YALOBUSHA,2582,119,3376,6077,0.42488069771268716,0.5555372716801054,0.019582030607207503
2016,MISSISSIPPI,YAZOO,5369,103,4598,10070,0.533167825223436,0.45660377358490567,0.010228401191658392
2016,MISSOURI,ADAIR,3500,696,6030,10226,0.3422648151769998,0.589673381576374,0.06806180324662625
2016,MISSOURI,ANDREW,2045,430,6665,9140,0.2237417943107221,0.7292122538293216,0.047045951859956234
2016,MISSOURI,ATCHISON,541,123,2060,2724,0.19860499265785608,0.7562408223201175,0.04515418502202643
2016,MISSOURI,AUDRAIN,2570,510,6981,10061,0.25544180498956365,0.6938674088062817,0.05069078620415466
2016,MISSOURI,BARRY,2710,467,11428,14605,0.18555289284491613,0.7824717562478604,0.03197535090722355
2016,MISSOURI,BARTON,795,185,4959,5939,0.13386091934669136,0.8349890553965315,0.031150025256777236
2016,MISSOURI,BATES,1618,404,6001,8023,0.20167019818023182,0.7479745731023308,0.05035522871743737
2016,MISSOURI,BENTON,2025,74,7213,9312,0.21746134020618557,0.7745919243986255,0.007946735395189003
2016,MISSOURI,BOLLINGER,705,144,4827,5676,0.12420718816067654,0.8504228329809725,0.02536997885835095
2016,MISSOURI,BOONE,41125,6543,36200,83868,0.4903538894453188,0.43163065770019554,0.07801545285448562
2016,MISSOURI,BUCHANAN,12013,2326,21320,35659,0.3368854987520682,0.5978855267954793,0.06522897445245239
2016,MISSOURI,BUTLER,3036,573,13650,17259,0.17590822179732313,0.7908917086737355,0.033200069528941424
2016,MISSOURI,CALDWELL,838,242,3232,4312,0.19434137291280149,0.7495361781076066,0.05612244897959184
2016,MISSOURI,CALLAWAY,4989,1147,13057,19193,0.25993851925181055,0.6803001094148908,0.0597613713332986
2016,MISSOURI,CAMDEN,4768,802,16944,22514,0.2117793373012348,0.7525983832282136,0.03562227947055166
2016,MISSOURI,CAPE GIRARDEAU,8492,1529,27017,37038,0.22927803877099195,0.7294400345591014,0.041281926669906585
2016,MISSOURI,CARROLL,745,136,3480,4361,0.1708323778949782,0.7979821141939922,0.03118550791102958
2016,MISSOURI,CARTER,436,84,2324,2844,0.15330520393811534,0.8171589310829818,0.029535864978902954
2016,MISSOURI,CASS,14846,3046,33098,50990,0.2911551284565601,0.6491076681702295,0.05973720337321043
2016,MISSOURI,CEDAR,1011,256,5021,6288,0.16078244274809161,0.7985050890585241,0.04071246819338423
2016,MISSOURI,CHARITON,888,131,2950,3969,0.2237339380196523,0.7432602670697909,0.033005794910556815
2016,MISSOURI,CHRISTIAN,8508,2077,30946,41531,0.20485902097228575,0.7451301437480436,0.05001083527967061
2016,MISSOURI,CLARK,724,33,2458,3215,0.22519440124416795,0.7645412130637637,0.01026438569206843
2016,MISSOURI,CLAY,45304,7396,57476,110176,0.41119663084519315,0.5216744118501307,0.06712895730467615
2016,MISSOURI,CLINTON,2572,569,7067,10208,0.2519592476489028,0.6923001567398119,0.05574059561128527
2016,MISSOURI,COLE,10913,1845,24616,37374,0.29199443463370256,0.6586396960453791,0.049365869320918285
2016,MISSOURI,COOPER,1932,430,5624,7986,0.24192336589030805,0.7042324067117456,0.053844227397946406
2016,MISSOURI,CRAWFORD,1824,148,7724,9696,0.18811881188118812,0.7966171617161716,0.015264026402640265
2016,MISSOURI,DADE,637,130,3184,3951,0.16122500632751202,0.8058719311566692,0.03290306251581878
2016,MISSOURI,DALLAS,1272,286,5895,7453,0.17066952904870522,0.7909566617469476,0.03837380920434724
2016,MISSOURI,DAVIESS,730,96,2767,3593,0.20317283607013636,0.770108544391873,0.026718619537990537
2016,MISSOURI,DEKALB,824,230,3540,4594,0.17936438833260776,0.7705703090988245,0.0500653025685677
2016,MISSOURI,DENT,978,213,5600,6791,0.14401413635694302,0.8246208216757474,0.03136504196730967
2016,MISSOURI,DOUGLAS,984,196,5486,6666,0.1476147614761476,0.8229822982298229,0.029402940294029404
2016,MISSOURI,DUNKLIN,2360,192,8026,10578,0.22310455662696163,0.7587445641898279,0.018150879183210438
2016,MISSOURI,FRANKLIN,12341,2342,35430,50113,0.24626344461516972,0.7070021750843095,0.04673438030052082
2016,MISSOURI,GASCONADE,1520,255,5670,7445,0.20416386836803224,0.7615849563465413,0.03425117528542646
2016,MISSOURI,GENTRY,605,134,2304,3043,0.1988169569503779,0.7571475517581334,0.04403549129148866
2016,MISSOURI,GREENE,42728,8468,78035,129231,0.330632742917721,0.6038411836169341,0.065526073465345
2016,MISSOURI,GRUNDY,780,68,3462,4310,0.18097447795823665,0.8032482598607888,0.01577726218097448
2016,MISSOURI,HARRISON,574,150,2965,3689,0.1555977229601518,0.8037408511791814,0.040661425860666844
2016,MISSOURI,HENRY,2357,434,7075,9866,0.23890127711331846,0.7171092641394688,0.04398945874721265
2016,MISSOURI,HICKORY,1016,166,3542,4724,0.21507197290431837,0.7497883149872989,0.03513971210838273
2016,MISSOURI,HOLT,347,82,1926,2355,0.1473460721868365,0.8178343949044586,0.03481953290870488
2016,MISSOURI,HOWARD,1283,308,3277,4868,0.2635579293344289,0.6731717337715695,0.06327033689400165
2016,MISSOURI,HOWELL,2881,681,13893,17455,0.1650529934116299,0.7959323975938126,0.039014608994557436
2016,MISSOURI,IRON,933,163,3173,4269,0.21855235418130708,0.743265401733427,0.03818224408526587
2016,MISSOURI,JACKSON,71237,10481,91557,173275,0.41112105035348434,0.5283912855287837,0.06048766411773193
2016,MISSOURI,JASPER,10572,2684,35070,48326,0.2187642262964036,0.7256963125439722,0.05553946115962422
2016,MISSOURI,JEFFERSON,31568,5634,69036,106238,0.29714414804495565,0.6498239801201077,0.05303187183493665
2016,MISSOURI,JOHNSON,5930,1483,13719,21132,0.28061707363240584,0.6492049971607041,0.07017792920689002
2016,MISSOURI,KANSAS CITY,97735,6212,24654,128601,0.7599863142588316,0.19170924020808547,0.04830444553308295
2016,MISSOURI,KNOX,379,75,1416,1870,0.20267379679144384,0.7572192513368984,0.040106951871657755
2016,MISSOURI,LACLEDE,2553,617,12881,16051,0.1590555105600897,0.8025045168525325,0.03843997258737773
2016,MISSOURI,LAFAYETTE,4053,835,10988,15876,0.2552910052910053,0.6921138825900731,0.05259511211892164
2016,MISSOURI,LAWRENCE,2901,725,13089,16715,0.173556685611726,0.7830690996111277,0.04337421477714628
2016,MISSOURI,LEWIS,934,178,3344,4456,0.20960502692998204,0.7504488330341114,0.039946140035906644
2016,MISSOURI,LINCOLN,5575,1228,18159,24962,0.22333947600352536,0.727465747936864,0.04919477605961061
2016,MISSOURI,LINN,1240,259,4088,5587,0.2219437981027385,0.7316985860032218,0.046357615894039736
2016,MISSOURI,LIVINGSTON,1265,277,4879,6421,0.19700981155583241,0.7598504905777916,0.043139697866375955
2016,MISSOURI,MACON,1548,275,5798,7621,0.20312294974412806,0.7607925469098543,0.03608450334601758
2016,MISSOURI,MADISON,1005,214,4102,5321,0.1888742717534298,0.770907724112009,0.04021800413456117
2016,MISSOURI,MARIES,794,145,3561,4500,0.17644444444444443,0.7913333333333333,0.03222222222222222
2016,MISSOURI,MARION,2994,525,9419,12938,0.23141134642139435,0.7280105116710466,0.04057814190755913
2016,MISSOURI,MCDONALD,1329,314,6599,8242,0.16124727008007766,0.8006551807813638,0.038097549138558603
2016,MISSOURI,MERCER,216,43,1486,1745,0.12378223495702005,0.8515759312320917,0.02464183381088825
2016,MISSOURI,MILLER,1750,381,9285,11416,0.15329362298528382,0.8133321653819201,0.03337421163279607
2016,MISSOURI,MISSISSIPPI,1458,111,3600,5169,0.2820661636680209,0.6964596633778294,0.021474172954149738
2016,MISSOURI,MONITEAU,1237,246,5347,6830,0.18111273792093704,0.7828696925329429,0.03601756954612006
2016,MISSOURI,MONROE,853,144,3159,4156,0.20524542829643888,0.7601058710298364,0.03464870067372473
2016,MISSOURI,MONTGOMERY,1119,183,4127,5429,0.20611530668631423,0.7601768281451464,0.033707865168539325
2016,MISSOURI,MORGAN,1768,293,6760,8821,0.20043079015984583,0.7663530211994105,0.03321618864074368
2016,MISSOURI,NEW MADRID,1933,154,5270,7357,0.2627429658828327,0.7163245888269675,0.02093244529019981
2016,MISSOURI,NEWTON,4990,1063,20553,26606,0.18755168007216416,0.7724949259565511,0.039953393971284674
2016,MISSOURI,NODAWAY,2529,549,6380,9458,0.26739268344258826,0.6745612180164939,0.05804609854091774
2016,MISSOURI,OREGON,865,132,3671,4668,0.18530419880034277,0.7864181662382177,0.028277634961439587
2016,MISSOURI,OSAGE,998,236,5856,7090,0.14076163610719322,0.8259520451339916,0.033286318758815235
2016,MISSOURI,OZARK,724,142,3639,4505,0.16071032186459488,0.8077691453940067,0.031520532741398447
2016,MISSOURI,PEMISCOT,1947,116,3964,6027,0.3230462916874067,0.6577069852331177,0.019246723079475694
2016,MISSOURI,PERRY,1520,312,6908,8740,0.17391304347826086,0.7903890160183067,0.035697940503432495
2016,MISSOURI,PETTIS,4324,977,12810,18111,0.23874993098117167,0.7073049527911214,0.05394511622770692
2016,MISSOURI,PHELPS,4766,1078,12709,18553,0.2568856788659516,0.6850105104295802,0.05810381070446828
2016,MISSOURI,PIKE,1806,302,5274,7382,0.2446491465727445,0.7144405310214034,0.04091032240585207
2016,MISSOURI,PLATTE,20057,2895,25933,48885,0.4102894548429989,0.5304899253349699,0.0592206198220313
2016,MISSOURI,POLK,2631,694,10438,13763,0.19116471699484125,0.7584102303276902,0.05042505267746857
2016,MISSOURI,PULASKI,2922,690,9876,13488,0.2166370106761566,0.7322064056939501,0.05115658362989324
2016,MISSOURI,PUTNAM,353,57,1936,2346,0.1504688832054561,0.8252344416027281,0.024296675191815855
2016,MISSOURI,RALLS,1138,159,3969,5266,0.21610330421572352,0.7537030003797949,0.03019369540448158
2016,MISSOURI,RANDOLPH,2283,497,7529,10309,0.22145697933844213,0.7303327189834126,0.04821030167814531
2016,MISSOURI,RAY,3090,675,7104,10869,0.2842947833287331,0.6536019873033397,0.06210322936792713
2016,MISSOURI,REYNOLDS,540,92,2406,3038,0.17774851876234365,0.7919684002633312,0.030283080974325215
2016,MISSOURI,RIPLEY,830,172,4522,5524,0.1502534395365677,0.8186097031136857,0.031136857349746562
2016,MISSOURI,SALINE,2789,508,5977,9274,0.30073323269355184,0.6444899719646323,0.05477679534181583
2016,MISSOURI,SCHUYLER,354,77,1505,1936,0.1828512396694215,0.7773760330578512,0.03977272727272727
2016,MISSOURI,SCOTLAND,365,78,1525,1968,0.18546747967479674,0.7748983739837398,0.039634146341463415
2016,MISSOURI,SCOTT,3575,513,13168,17256,0.20717431617987947,0.7630968938340288,0.029728789986091794
2016,MISSOURI,SHANNON,776,162,2966,3904,0.1987704918032787,0.7597336065573771,0.04149590163934426
2016,MISSOURI,SHELBY,606,125,2524,3255,0.18617511520737326,0.7754224270353303,0.03840245775729647
2016,MISSOURI,ST. CHARLES,68626,10729,121650,201005,0.34141439267679907,0.6052088256511032,0.05337678167209771
2016,MISSOURI,ST. CLAIR,936,193,3501,4630,0.2021598272138229,0.7561555075593952,0.04168466522678186
2016,MISSOURI,ST. FRANCOIS,6250,1010,17468,24728,0.25274991912002587,0.7064056939501779,0.04084438692979618
2016,MISSOURI,ST. LOUIS CITY,104235,6124,20832,131191,0.794528588089122,0.15879138050628472,0.0466800314045933
2016,MISSOURI,ST. LOUIS COUNTY,286704,25720,202434,514858,0.556860338190336,0.3931841400929965,0.049955521716667506
2016,MISSOURI,STE. GENEVIEVE,2542,431,5496,8469,0.3001535010036604,0.648955012398158,0.0508914865981816
2016,MISSOURI,STODDARD,1876,336,11079,13291,0.14114814536152284,0.8335715897976074,0.025280264840869763
2016,MISSOURI,STONE,2887,522,13158,16567,0.17426208728194603,0.7942294923643387,0.03150842035371522
2016,MISSOURI,SULLIVAN,526,76,1884,2486,0.21158487530168946,0.7578439259855189,0.030571198712791632
2016,MISSOURI,TANEY,4373,866,18276,23515,0.1859664044227089,0.777206038698703,0.03682755687858814
2016,MISSOURI,TEXAS,1728,353,8875,10956,0.15772179627601315,0.8100584154801023,0.03221978824388463
2016,MISSOURI,VERNON,1707,359,6533,8599,0.19851145482032795,0.7597395045935574,0.041749040586114665
2016,MISSOURI,WARREN,3915,758,11111,15784,0.24803598580841357,0.7039406994424734,0.048023314749113026
2016,MISSOURI,WASHINGTON,1926,308,7048,9282,0.20749838396897222,0.7593191122602887,0.033182503770739065
2016,MISSOURI,WAYNE,948,49,4658,5655,0.16763925729442972,0.8236958443854996,0.008664898320070735
2016,MISSOURI,WEBSTER,3177,726,12840,16743,0.1897509406916323,0.7668876545421968,0.04336140476617094
2016,MISSOURI,WORTH,195,43,808,1046,0.1864244741873805,0.7724665391969407,0.04110898661567878
2016,MISSOURI,WRIGHT,1170,242,6707,8119,0.1441064170464343,0.8260869565217391,0.02980662643182658
2016,MONTANA,BEAVERHEAD,1143,353,3353,4849,0.23571870488760568,0.6914827799546298,0.07279851515776449
2016,MONTANA,BIG HORN,2094,290,1853,4237,0.49421760679726223,0.4373377389662497,0.06844465423648809
2016,MONTANA,BLAINE,1202,214,1268,2684,0.44783904619970194,0.47242921013412814,0.07973174366616989
2016,MONTANA,BROADWATER,573,212,2348,3133,0.1828917969996808,0.7494414299393553,0.06766677306096393
2016,MONTANA,CARBON,1828,415,3748,5991,0.30512435319646136,0.6256050742780838,0.06927057252545485
2016,MONTANA,CARTER,70,38,678,786,0.089058524173028,0.8625954198473282,0.04834605597964377
2016,MONTANA,CASCADE,12175,2764,19632,34571,0.3521737872783547,0.567874808365393,0.07995140435625235
2016,MONTANA,CHOUTEAU,732,192,1679,2603,0.2812139838647714,0.6450249711870918,0.07376104494813676
2016,MONTANA,CUSTER,1176,352,3657,5185,0.22680810028929604,0.7053037608486017,0.06788813886210222
2016,MONTANA,DANIELS,168,64,730,962,0.17463617463617465,0.7588357588357588,0.06652806652806653
2016,MONTANA,DAWSON,787,267,3320,4374,0.1799268404206676,0.7590306355738454,0.061042524005486966
2016,MONTANA,DEER LODGE,2058,385,1763,4206,0.4893009985734665,0.4191631003328578,0.0915359010936757
2016,MONTANA,FALLON,154,51,1279,1484,0.10377358490566038,0.8618598382749326,0.03436657681940701
2016,MONTANA,FERGUS,1202,369,4269,5840,0.20582191780821918,0.7309931506849315,0.06318493150684931
2016,MONTANA,FLATHEAD,13293,3038,30240,46571,0.2854351420411844,0.6493311288140688,0.06523372914474673
2016,MONTANA,GALLATIN,24246,5771,23802,53819,0.45051004292164476,0.44226016834203535,0.10722978873631989
2016,MONTANA,GARFIELD,34,31,653,718,0.04735376044568245,0.9094707520891365,0.04317548746518106
2016,MONTANA,GLACIER,3121,334,1620,5075,0.614975369458128,0.3192118226600985,0.0658128078817734
2016,MONTANA,GOLDEN VALLEY,71,38,365,474,0.14978902953586498,0.770042194092827,0.08016877637130802
2016,MONTANA,GRANITE,472,113,1192,1777,0.26561620709060213,0.670793472144063,0.06359032076533483
2016,MONTANA,HILL,2371,596,3478,6445,0.3678820791311094,0.5396431342125679,0.09247478665632274
2016,MONTANA,JEFFERSON,1998,539,4177,6714,0.2975871313672922,0.6221328567173071,0.08028001191540066
2016,MONTANA,JUDITH BASIN,235,101,872,1208,0.1945364238410596,0.7218543046357616,0.0836092715231788
2016,MONTANA,LAKE,4776,875,7530,13181,0.3623397314316061,0.5712768378726956,0.06638343069569835
2016,MONTANA,LEWIS AND CLARK,14478,3105,16895,34478,0.41991994895295554,0.49002262312199085,0.09005742792505365
2016,MONTANA,LIBERTY,206,57,698,961,0.21436004162330904,0.7263267429760666,0.05931321540062435
2016,MONTANA,LINCOLN,2041,560,6729,9330,0.2187566988210075,0.7212218649517685,0.06002143622722401
2016,MONTANA,MADISON,1180,301,3297,4778,0.24696525742988698,0.6900376726663876,0.0629970699037254
2016,MONTANA,MCCONE,154,44,862,1060,0.14528301886792452,0.8132075471698114,0.04150943396226415
2016,MONTANA,MEAGHER,193,55,729,977,0.19754350051177072,0.7461617195496417,0.05629477993858751
2016,MONTANA,MINERAL,519,163,1330,2012,0.25795228628230615,0.6610337972166997,0.08101391650099403
2016,MONTANA,MISSOULA,31543,5410,22250,59203,0.5327939462527237,0.37582554938094354,0.09138050436633278
2016,MONTANA,MUSSELSHELL,332,142,1967,2441,0.1360098320360508,0.8058172879967227,0.058172879967226546
2016,MONTANA,PARK,3595,784,4980,9359,0.38412223528154715,0.5321081312105994,0.08376963350785341
2016,MONTANA,PETROLEUM,30,14,278,322,0.09316770186335403,0.8633540372670807,0.043478260869565216
2016,MONTANA,PHILLIPS,318,130,1723,2171,0.14647627821280515,0.7936434822662367,0.059880239520958084
2016,MONTANA,PONDERA,738,186,1799,2723,0.27102460521483657,0.6606683804627249,0.06830701432243849
2016,MONTANA,POWDER RIVER,127,42,884,1053,0.12060778727445394,0.8395061728395061,0.039886039886039885
2016,MONTANA,POWELL,551,214,2029,2794,0.19720830350751611,0.7261989978525412,0.07659269863994274
2016,MONTANA,PRAIRIE,100,33,556,689,0.14513788098693758,0.806966618287373,0.047895500725689405
2016,MONTANA,RAVALLI,6223,1523,14810,22556,0.2758911154460011,0.6565880475261571,0.06752083702784181
2016,MONTANA,RICHLAND,671,292,3908,4871,0.13775405460890988,0.8022993225210429,0.05994662287004722
2016,MONTANA,ROOSEVELT,1560,295,1797,3652,0.42716319824753557,0.4920591456736035,0.0807776560788609
2016,MONTANA,ROSEBUD,987,213,2253,3453,0.2858384013900956,0.6524761077324066,0.06168549087749783
2016,MONTANA,SANDERS,1218,449,4286,5953,0.20460272131698304,0.7199731227952293,0.07542415588778767
2016,MONTANA,SHERIDAN,477,117,1241,1835,0.25994550408719347,0.6762942779291553,0.06376021798365122
2016,MONTANA,SILVER BOW,8619,1457,6376,16452,0.5238876732312181,0.387551665451009,0.08856066131777292
2016,MONTANA,STILLWATER,908,304,3661,4873,0.18633285450441206,0.751282577467679,0.062384568027908885
2016,MONTANA,SWEET GRASS,402,110,1595,2107,0.19079259610821073,0.757000474608448,0.052206929283341245
2016,MONTANA,TETON,808,210,2170,3188,0.2534504391468005,0.6806775407779172,0.06587202007528231
2016,MONTANA,TOOLE,402,138,1497,2037,0.19734904270986744,0.7349042709867453,0.06774668630338733
2016,MONTANA,TREASURE,59,33,351,443,0.13318284424379231,0.7923250564334086,0.0744920993227991
2016,MONTANA,VALLEY,886,310,2698,3894,0.22752953261427838,0.6928608115048793,0.07960965588084232
2016,MONTANA,WHEATLAND,179,65,702,946,0.18921775898520085,0.7420718816067653,0.06871035940803383
2016,MONTANA,WIBAUX,55,23,463,541,0.10166358595194085,0.8558225508317929,0.04251386321626617
2016,MONTANA,YELLOWSTONE,22171,6017,40920,69108,0.32081669271285523,0.5921166869248133,0.08706662036233143
2016,NEBRASKA,ADAMS,3302,924,9287,13513,0.2443572855768519,0.6872641160364094,0.0683785983867387
2016,NEBRASKA,ANTELOPE,383,166,2732,3281,0.11673270344407193,0.8326729655592807,0.05059433099664736
2016,NEBRASKA,ARTHUR,17,12,244,273,0.06227106227106227,0.8937728937728938,0.04395604395604396
2016,NEBRASKA,BANNER,19,26,357,402,0.0472636815920398,0.8880597014925373,0.06467661691542288
2016,NEBRASKA,BLAINE,30,11,276,317,0.0946372239747634,0.8706624605678234,0.03470031545741325
2016,NEBRASKA,BOONE,414,192,2299,2905,0.14251290877796902,0.791394148020654,0.06609294320137693
2016,NEBRASKA,BOX BUTTE,965,342,3617,4924,0.19597887896019497,0.7345653939886271,0.0694557270511779
2016,NEBRASKA,BOYD,128,45,983,1156,0.11072664359861592,0.8503460207612457,0.03892733564013841
2016,NEBRASKA,BROWN,153,59,1385,1597,0.09580463368816532,0.8672510958046337,0.036944270507201005
2016,NEBRASKA,BUFFALO,4763,1797,14569,21129,0.22542477164087274,0.6895262435515169,0.08504898480761039
2016,NEBRASKA,BURT,930,261,2367,3558,0.26138279932546377,0.6652613827993255,0.0733558178752108
2016,NEBRASKA,BUTLER,691,211,3079,3981,0.17357447877417734,0.7734237628736499,0.05300175835217282
2016,NEBRASKA,CASS,3484,997,8452,12933,0.26938838629861594,0.653521997989639,0.07708961571174515
2016,NEBRASKA,CEDAR,571,317,3532,4420,0.12918552036199096,0.7990950226244344,0.07171945701357466
2016,NEBRASKA,CHASE,171,79,1648,1898,0.09009483667017913,0.8682824025289779,0.04162276080084299
2016,NEBRASKA,CHERRY,317,178,2623,3118,0.10166773572803078,0.8412443874278384,0.05708787684413085
2016,NEBRASKA,CHEYENNE,711,335,3665,4711,0.15092337083421778,0.777966461473148,0.07111016769263426
2016,NEBRASKA,CLAY,477,166,2422,3065,0.15562805872756932,0.7902120717781403,0.05415986949429037
2016,NEBRASKA,COLFAX,859,184,2171,3214,0.2672682016179216,0.6754822650902302,0.05724953329184816
2016,NEBRASKA,CUMING,719,233,3122,4074,0.17648502700049093,0.7663230240549829,0.05719194894452626
2016,NEBRASKA,CUSTER,641,316,4695,5652,0.11341118188251946,0.8306794055201698,0.055909412597310686
2016,NEBRASKA,DAKOTA,2314,349,3616,6279,0.36853002070393376,0.5758878802357064,0.05558209906035993
2016,NEBRASKA,DAWES,801,243,2632,3676,0.2178998911860718,0.7159956474428727,0.0661044613710555
2016,NEBRASKA,DAWSON,2136,515,5984,8635,0.24736537348002316,0.6929936305732484,0.059640995946728434
2016,NEBRASKA,DEUEL,120,55,809,984,0.12195121951219512,0.8221544715447154,0.05589430894308943
2016,NEBRASKA,DIXON,556,185,2041,2782,0.19985621854780733,0.7336448598130841,0.06649892163910856
2016,NEBRASKA,DODGE,4544,1052,9933,15529,0.2926138193058149,0.6396419602034903,0.06774422049069483
2016,NEBRASKA,DOUGLAS,113798,18558,108077,240433,0.47330441328769346,0.4495098426588696,0.07718574405343692
2016,NEBRASKA,DUNDY,89,41,823,953,0.09338929695697797,0.863588667366212,0.04302203567681007
2016,NEBRASKA,FILLMORE,613,198,2130,2941,0.20843250595035703,0.7242434546072765,0.06732403944236655
2016,NEBRASKA,FRANKLIN,250,76,1347,1673,0.14943215780035865,0.8051404662283324,0.045427375971309025
2016,NEBRASKA,FRONTIER,161,57,1110,1328,0.12123493975903614,0.8358433734939759,0.04292168674698795
2016,NEBRASKA,FURNAS,304,115,1921,2340,0.12991452991452992,0.8209401709401709,0.049145299145299144
2016,NEBRASKA,GAGE,2935,733,6380,10048,0.29209792993630573,0.634952229299363,0.07294984076433121
2016,NEBRASKA,GARDEN,153,53,869,1075,0.14232558139534884,0.8083720930232559,0.04930232558139535
2016,NEBRASKA,GARFIELD,121,38,821,980,0.12346938775510204,0.8377551020408164,0.03877551020408163
2016,NEBRASKA,GOSPER,166,50,794,1010,0.16435643564356436,0.7861386138613862,0.04950495049504951
2016,NEBRASKA,GRANT,20,18,367,405,0.04938271604938271,0.9061728395061729,0.044444444444444446
2016,NEBRASKA,GREELEY,210,53,912,1175,0.17872340425531916,0.7761702127659574,0.0451063829787234
2016,NEBRASKA,HALL,6282,1370,14408,22060,0.28476881233000906,0.6531278331822303,0.06210335448776065
2016,NEBRASKA,HAMILTON,878,343,3783,5004,0.17545963229416467,0.7559952038369304,0.06854516386890487
2016,NEBRASKA,HARLAN,254,82,1496,1832,0.13864628820960698,0.8165938864628821,0.04475982532751092
2016,NEBRASKA,HAYES,30,12,472,514,0.058365758754863814,0.9182879377431906,0.023346303501945526
2016,NEBRASKA,HITCHCOCK,161,75,1232,1468,0.10967302452316076,0.8392370572207084,0.05108991825613079
2016,NEBRASKA,HOLT,531,233,4354,5118,0.10375146541617819,0.8507229386479094,0.04552559593591247
2016,NEBRASKA,HOOKER,40,22,355,417,0.09592326139088729,0.8513189448441247,0.05275779376498801
2016,NEBRASKA,HOWARD,544,166,2284,2994,0.18169672678690715,0.7628590514362057,0.055444221776887105
2016,NEBRASKA,JEFFERSON,837,258,2399,3494,0.23955352032054952,0.6866056096164854,0.07384087006296508
2016,NEBRASKA,JOHNSON,563,171,1355,2089,0.26950694112015317,0.6486357108664432,0.08185734801340354
2016,NEBRASKA,KEARNEY,550,215,2531,3296,0.16686893203883496,0.7679004854368932,0.06523058252427184
2016,NEBRASKA,KEITH,571,228,3235,4034,0.14154685176003967,0.8019335647000496,0.05651958353991076
2016,NEBRASKA,KEYA PAHA,40,19,460,519,0.07707129094412331,0.8863198458574181,0.036608863198458574
2016,NEBRASKA,KIMBALL,230,117,1330,1677,0.13714967203339296,0.793082886106142,0.06976744186046512
2016,NEBRASKA,KNOX,720,207,3188,4115,0.17496962332928312,0.774726609963548,0.05030376670716889
2016,NEBRASKA,LANCASTER,61898,12737,61588,136223,0.4543872914265579,0.4521116111082563,0.09350109746518576
2016,NEBRASKA,LINCOLN,2913,1054,12164,16131,0.18058396875581179,0.7540760027276672,0.06534002851652099
2016,NEBRASKA,LOGAN,32,21,400,453,0.0706401766004415,0.8830022075055187,0.046357615894039736
2016,NEBRASKA,LOUP,48,14,323,385,0.12467532467532468,0.8389610389610389,0.03636363636363636
2016,NEBRASKA,MADISON,2711,1004,10628,14343,0.18901206163285225,0.7409886355713589,0.06999930279578889
2016,NEBRASKA,MCPHERSON,14,16,257,287,0.04878048780487805,0.8954703832752613,0.05574912891986063
2016,NEBRASKA,MERRICK,602,260,2926,3788,0.15892291446673706,0.7724392819429778,0.06863780359028511
2016,NEBRASKA,MORRILL,284,123,1802,2209,0.12856496152105024,0.8157537347215935,0.05568130375735627
2016,NEBRASKA,NANCE,281,79,1261,1621,0.17334978408389884,0.7779148673658236,0.048735348550277606
2016,NEBRASKA,NEMAHA,785,260,2116,3161,0.24833913318570072,0.6694084150585258,0.08225245175577349
2016,NEBRASKA,NUCKOLLS,353,126,1726,2205,0.1600907029478458,0.7827664399092971,0.05714285714285714
2016,NEBRASKA,OTOE,2025,572,4860,7457,0.27155692637789997,0.6517366233069599,0.07670645031514013
2016,NEBRASKA,PAWNEE,279,74,974,1327,0.21024868123587037,0.7339864355689525,0.05576488319517709
2016,NEBRASKA,PERKINS,161,77,1217,1455,0.11065292096219931,0.836426116838488,0.052920962199312714
2016,NEBRASKA,PHELPS,572,274,3849,4695,0.12183173588924387,0.8198083067092652,0.05835995740149095
2016,NEBRASKA,PIERCE,382,196,3052,3630,0.10523415977961433,0.840771349862259,0.05399449035812672
2016,NEBRASKA,PLATTE,2646,822,10965,14433,0.18332986905009355,0.7597173144876325,0.05695281646227396
2016,NEBRASKA,POLK,413,141,2028,2582,0.15995352439969016,0.7854376452362509,0.05460883036405887
2016,NEBRASKA,RED WILLOW,645,267,4258,5170,0.12475822050290135,0.8235976789168279,0.051644100580270795
2016,NEBRASKA,RICHARDSON,818,218,2769,3805,0.2149802890932983,0.7277266754270696,0.05729303547963206
2016,NEBRASKA,ROCK,70,41,687,798,0.08771929824561403,0.8609022556390977,0.05137844611528822
2016,NEBRASKA,SALINE,1733,399,3004,5136,0.3374221183800623,0.5848909657320872,0.07768691588785047
2016,NEBRASKA,SARPY,28033,7404,45143,80580,0.3478902953586498,0.5602258624968975,0.09188384214445272
2016,NEBRASKA,SAUNDERS,2523,782,7555,10860,0.23232044198895027,0.6956721915285451,0.07200736648250461
2016,NEBRASKA,SCOTTS BLUFF,3207,1034,10076,14317,0.22399944122372006,0.7037787245931411,0.07222183418313892
2016,NEBRASKA,SEWARD,1875,593,5454,7922,0.23668265589497603,0.6884625094673062,0.07485483463771775
2016,NEBRASKA,SHERIDAN,287,110,2211,2608,0.11004601226993865,0.8477760736196319,0.04217791411042945
2016,NEBRASKA,SHERMAN,340,83,1150,1573,0.2161474888747616,0.7310870947234583,0.052765416401780035
2016,NEBRASKA,SIOUX,81,39,616,736,0.11005434782608696,0.8369565217391305,0.05298913043478261
2016,NEBRASKA,STANTON,417,197,2187,2801,0.14887540164227062,0.7807925740806855,0.07033202427704391
2016,NEBRASKA,THAYER,499,140,2051,2690,0.18550185873605948,0.762453531598513,0.05204460966542751
2016,NEBRASKA,THOMAS,30,19,344,393,0.07633587786259542,0.8753180661577609,0.04834605597964377
2016,NEBRASKA,THURSTON,919,126,1043,2088,0.44013409961685823,0.49952107279693486,0.0603448275862069
2016,NEBRASKA,VALLEY,339,86,1780,2205,0.15374149659863945,0.8072562358276644,0.039002267573696146
2016,NEBRASKA,WASHINGTON,2623,785,7424,10832,0.24215288035450516,0.6853766617429837,0.07247045790251108
2016,NEBRASKA,WAYNE,835,248,2693,3776,0.2211334745762712,0.7131885593220338,0.06567796610169492
2016,NEBRASKA,WEBSTER,306,72,1330,1708,0.1791569086651054,0.7786885245901639,0.04215456674473068
2016,NEBRASKA,WHEELER,62,26,377,465,0.13333333333333333,0.810752688172043,0.05591397849462366
2016,NEBRASKA,YORK,1186,495,4700,6381,0.18586428459489107,0.7365616674502429,0.07757404795486601
2016,NEVADA,CARSON CITY,9610,2281,13125,25016,0.3841541413495363,0.5246642149024624,0.09118164374800128
2016,NEVADA,CHURCHILL,2210,898,7830,10938,0.20204790638142256,0.7158529895776193,0.08209910404095813
2016,NEVADA,CLARK,402227,44872,320057,767156,0.5243092669548306,0.4171993701411447,0.058491362904024735
2016,NEVADA,DOUGLAS,8454,2016,17415,27885,0.3031737493275955,0.6245293168370092,0.07229693383539537
2016,NEVADA,ELKO,3401,1607,13551,18559,0.1832534080500027,0.7301578748855003,0.08658871706449701
2016,NEVADA,ESMERALDA,65,29,329,423,0.1536643026004728,0.7777777777777778,0.06855791962174941
2016,NEVADA,EUREKA,74,57,723,854,0.08665105386416862,0.8466042154566745,0.06674473067915691
2016,NEVADA,HUMBOLDT,1386,526,4521,6433,0.21545157780195864,0.7027825275921032,0.08176589460593812
2016,NEVADA,LANDER,403,182,1828,2413,0.1670120182345628,0.757563199336925,0.07542478242851222
2016,NEVADA,LINCOLN,285,176,1671,2132,0.13367729831144465,0.7837711069418386,0.0825515947467167
2016,NEVADA,LYON,6146,1611,16005,23762,0.2586482619308139,0.6735544146115647,0.0677973234576214
2016,NEVADA,MINERAL,637,181,1179,1997,0.3189784677015523,0.5903855783675513,0.09063595393089635
2016,NEVADA,NYE,5094,1177,13324,19595,0.25996427660117377,0.6799693799438632,0.060066343454963
2016,NEVADA,PERSHING,430,149,1403,1982,0.21695257315842584,0.7078708375378405,0.0751765893037336
2016,NEVADA,STOREY,752,190,1616,2558,0.2939796716184519,0.6317435496481626,0.07427677873338545
2016,NEVADA,WASHOE,97379,17772,94758,209909,0.46391055171526707,0.45142418857695477,0.08466525970777813
2016,NEVADA,WHITE PINE,707,343,2723,3773,0.18738404452690166,0.7217068645640075,0.09090909090909091
2016,NEW HAMPSHIRE,BELKNAP,13517,2213,19315,35045,0.3857040947353403,0.5511485233271508,0.06314738193750892
2016,NEW HAMPSHIRE,CARROLL,12987,1994,14635,29616,0.4385129659643436,0.49415856293895194,0.06732847109670448
2016,NEW HAMPSHIRE,CHESHIRE,22064,2955,16876,41895,0.5266499582289056,0.40281656522258025,0.07053347654851415
2016,NEW HAMPSHIRE,COOS,6563,1112,7952,15627,0.4199782427849235,0.5088628655532091,0.07115889166186729
2016,NEW HAMPSHIRE,GRAFTON,28510,3671,19010,51191,0.5569338360258639,0.3713543396300131,0.07171182434412299
2016,NEW HAMPSHIRE,HILLSBOROUGH,99589,14555,100013,214157,0.4650279934814178,0.4670078493815285,0.06796415713705366
2016,NEW HAMPSHIRE,MERRIMACK,40198,5776,37674,83648,0.4805614001530222,0.450387337413925,0.06905126243305279
2016,NEW HAMPSHIRE,ROCKINGHAM,79994,10993,90447,181434,0.4408986187814853,0.4985118555507788,0.06058952566773593
2016,NEW HAMPSHIRE,STRAFFORD,34894,5034,29072,69000,0.5057101449275362,0.42133333333333334,0.07295652173913043
2016,NEW HAMPSHIRE,SULLIVAN,10210,1677,10796,22683,0.4501168275801261,0.4759511528457435,0.07393201957413041
2016,NEW JERSEY,ATLANTIC,60924,3677,52690,117291,0.519426042918894,0.4492245781858796,0.031349378895226404
2016,NEW JERSEY,BERGEN,231211,12556,175529,419296,0.551426677096848,0.41862789055941385,0.029945432343738074
2016,NEW JERSEY,BURLINGTON,121725,7946,89272,218943,0.5559666214494183,0.40774082752131835,0.03629255102926333
2016,NEW JERSEY,CAMDEN,146717,7244,72631,226592,0.647494174551617,0.32053647083745235,0.03196935461093066
2016,NEW JERSEY,CAPE MAY,18750,1526,28446,48722,0.3848364188662206,0.5838430277903206,0.031320553343458804
2016,NEW JERSEY,CUMBERLAND,27771,1780,24453,54004,0.5142396859491889,0.45279979260795494,0.032960521442856085
2016,NEW JERSEY,ESSEX,240837,6921,63176,310934,0.7745598744428078,0.20318138254420554,0.02225874301298668
2016,NEW JERSEY,GLOUCESTER,66870,5128,67544,139542,0.47921056026142667,0.48404064726032303,0.036748792478250275
2016,NEW JERSEY,HUDSON,163917,6415,49043,219375,0.7472,0.22355783475783475,0.029242165242165243
2016,NEW JERSEY,HUNTERDON,28898,3226,38712,70836,0.40795640634705516,0.5465017787565645,0.04554181489638037
2016,NEW JERSEY,MERCER,104775,5561,46193,156529,0.6693647822448237,0.29510825470040697,0.035526963054769406
2016,NEW JERSEY,MIDDLESEX,193044,10105,122953,326102,0.591974290252743,0.3770384726251296,0.030987237122127434
2016,NEW JERSEY,MONMOUTH,137181,10473,166723,314377,0.4363582577605868,0.5303282364804041,0.033313505759009085
2016,NEW JERSEY,MORRIS,115249,9096,126071,250416,0.4602301769854961,0.5034462654143506,0.03632355760015334
2016,NEW JERSEY,OCEAN,87150,8133,179079,274362,0.3176460296979903,0.6527106523498152,0.029643317952194544
2016,NEW JERSEY,PASSAIC,116759,5141,72902,194802,0.5993726963788872,0.37423640414369463,0.026390899477418097
2016,NEW JERSEY,SALEM,11904,1209,16381,29494,0.4036075133925544,0.5554010985285143,0.04099138807893131
2016,NEW JERSEY,SOMERSET,85689,5898,65505,157092,0.5454701703460393,0.41698495149339243,0.037544878160568326
2016,NEW JERSEY,SUSSEX,24212,3256,46658,74126,0.3266330302457977,0.6294417613253109,0.043925208428891346
2016,NEW JERSEY,UNION,147414,6447,68114,221975,0.6641018132672598,0.30685437549273564,0.029043811240004505
2016,NEW JERSEY,WARREN,17281,2097,29858,49236,0.3509830205540661,0.6064261922170769,0.04259078722885693
2016,NEW MEXICO,BERNALILLO,143417,36547,94698,274662,0.5221581434636026,0.3447801297594862,0.13306172677691125
2016,NEW MEXICO,CATRON,427,158,1464,2049,0.20839433870180576,0.7144948755490483,0.07711078574914593
2016,NEW MEXICO,CHAVES,5534,1865,12872,20271,0.27300083863647573,0.6349958068176212,0.09200335454590301
2016,NEW MEXICO,CIBOLA,3741,1127,3195,8063,0.46397122659059903,0.3962544958452189,0.13977427756418206
2016,NEW MEXICO,COLFAX,2129,618,2585,5332,0.3992873218304576,0.4848087021755439,0.1159039759939985
2016,NEW MEXICO,CURRY,3121,1214,9035,13370,0.23343305908750936,0.6757666417352282,0.09080029917726253
2016,NEW MEXICO,DE BACA,193,97,620,910,0.21208791208791208,0.6813186813186813,0.10659340659340659
2016,NEW MEXICO,DONA ANA,37947,7327,25374,70648,0.5371277318536972,0.35916091042917,0.10371135771713283
2016,NEW MEXICO,EDDY,5033,1487,13147,19667,0.25591091676412264,0.6684801952509279,0.07560888798494941
2016,NEW MEXICO,GRANT,6276,1247,5288,12811,0.4898914994926235,0.412770275544454,0.09733822496292249
2016,NEW MEXICO,GUADALUPE,970,262,595,1827,0.5309250136836344,0.32567049808429116,0.14340448823207444
2016,NEW MEXICO,HARDING,156,60,311,527,0.29601518026565465,0.5901328273244781,0.11385199240986717
2016,NEW MEXICO,HIDALGO,784,178,910,1872,0.4188034188034188,0.4861111111111111,0.09508547008547008
2016,NEW MEXICO,LEA,3930,1287,12495,17712,0.22188346883468835,0.7054539295392954,0.07266260162601626
2016,NEW MEXICO,LINCOLN,2331,675,5896,8902,0.26185126937766795,0.6623230734666367,0.07582565715569535
2016,NEW MEXICO,LOS ALAMOS,5562,1964,3359,10885,0.5109784106568672,0.30858980248047774,0.18043178686265504
2016,NEW MEXICO,LUNA,3195,622,3478,7295,0.43797121315969845,0.47676490747087047,0.08526387936943111
2016,NEW MEXICO,MCKINLEY,13576,3023,5104,21703,0.625535640234069,0.2351748606183477,0.1392894991475833
2016,NEW MEXICO,MORA,1536,240,665,2441,0.6292503072511266,0.2724293322408849,0.09832036050798854
2016,NEW MEXICO,OTERO,6124,2049,11887,20060,0.305284147557328,0.5925722831505483,0.10214356929212363
2016,NEW MEXICO,QUAY,1017,343,2212,3572,0.2847144456886898,0.6192609182530795,0.09602463605823068
2016,NEW MEXICO,RIO ARRIBA,9592,1687,3599,14878,0.6447103105256082,0.2419007931173545,0.11338889635703724
2016,NEW MEXICO,ROOSEVELT,1454,612,3884,5950,0.24436974789915966,0.6527731092436975,0.10285714285714286
2016,NEW MEXICO,SAN JUAN,12865,5299,27946,46110,0.27900672305356755,0.606072435480373,0.11492084146605942
2016,NEW MEXICO,SAN MIGUEL,7285,1153,2313,10751,0.677611384987443,0.2151427774160543,0.10724583759650265
2016,NEW MEXICO,SANDOVAL,27707,8078,25905,61690,0.44913276057707896,0.4199221916031772,0.1309450478197439
2016,NEW MEXICO,SANTA FE,50793,6309,14332,71434,0.711047960355013,0.20063275191085478,0.08831928773413221
2016,NEW MEXICO,SIERRA,1612,559,3010,5181,0.3111368461686933,0.5809689249179695,0.10789422891333719
2016,NEW MEXICO,SOCORRO,3313,939,2616,6868,0.48238206173558534,0.3808969132207338,0.13672102504368083
2016,NEW MEXICO,TAOS,10668,1865,2727,15260,0.6990825688073394,0.1787024901703801,0.12221494102228048
2016,NEW MEXICO,TORRANCE,1785,825,3714,6324,0.28225806451612906,0.5872865275142315,0.13045540796963948
2016,NEW MEXICO,UNION,320,166,1216,1702,0.18801410105757932,0.7144535840188014,0.09753231492361927
2016,NEW MEXICO,VALENCIA,10841,3536,13215,27592,0.39290374021455493,0.4789431719338939,0.12815308785155116
2016,NEW YORK,ALBANY,83077,8943,47810,139830,0.594128584710005,0.34191518272187654,0.06395623256811843
2016,NEW YORK,ALLEGANY,4882,1285,12525,18692,0.2611812540124117,0.6700727583993152,0.06874598758827306
2016,NEW YORK,BRONX,353646,8079,37797,399522,0.8851727814738612,0.09460555363659573,0.020221664889543006
2016,NEW YORK,BROOME,39212,5917,40943,86072,0.45557207918951576,0.47568314899154196,0.06874477181894229
2016,NEW YORK,CATTARAUGUS,9497,1972,19692,31161,0.30477199062931226,0.6319437758736882,0.06328423349699945
2016,NEW YORK,CAYUGA,13522,2266,17384,33172,0.40763294344628,0.5240564331363801,0.06831062341733993
2016,NEW YORK,CHAUTAUQUA,19091,3549,31594,54234,0.35201165320647565,0.582549692075082,0.0654386547184423
2016,NEW YORK,CHEMUNG,13757,2265,20097,36119,0.38087986932085605,0.5564107533431158,0.06270937733602813
2016,NEW YORK,CHENANGO,6775,1464,11921,20160,0.33606150793650796,0.5913194444444444,0.07261904761904762
2016,NEW YORK,CLINTON,15059,2597,14449,32105,0.46905466438249493,0.4500545086435135,0.0808908269739916
2016,NEW YORK,COLUMBIA,15284,1862,13756,30902,0.49459581904083877,0.44514918128276487,0.06025499967639635
2016,NEW YORK,CORTLAND,8771,1573,9900,20244,0.43326417704011067,0.4890337877889745,0.07770203517091484
2016,NEW YORK,DELAWARE,6627,1223,11942,19792,0.3348322554567502,0.6033751010509296,0.06179264349232013
2016,NEW YORK,DUTCHESS,62261,6876,61797,130934,0.4755143812913376,0.4719706111476011,0.0525150075610613
2016,NEW YORK,ERIE,215456,19866,188303,423625,0.5086007671879611,0.4445039834759516,0.04689524933608734
2016,NEW YORK,ESSEX,7762,1498,7958,17218,0.4508072946916018,0.4621907306307353,0.08700197467766291
2016,NEW YORK,FRANKLIN,7297,1434,8221,16952,0.43045068428504013,0.48495752713544127,0.08459178857951864
2016,NEW YORK,FULTON,6496,1256,13462,21214,0.3062128782879231,0.6345809371169983,0.059206184595078724
2016,NEW YORK,GENESEE,7650,1867,16915,26432,0.2894219128329298,0.6399440072639225,0.0706340799031477
2016,NEW YORK,GREENE,7405,1572,13073,22050,0.33582766439909295,0.5928798185941043,0.07129251700680272
2016,NEW YORK,HAMILTON,949,212,2064,3225,0.29426356589147284,0.64,0.06573643410852713
2016,NEW YORK,HERKIMER,8083,1473,16699,26255,0.30786516853932583,0.6360312321462579,0.0561035993144163
2016,NEW YORK,JEFFERSON,13809,2664,21763,38236,0.3611517941207239,0.569175645988074,0.06967255989120201
2016,NEW YORK,KINGS,640553,24008,141044,805605,0.7951204374352195,0.17507835725945098,0.029801205305329533
2016,NEW YORK,LEWIS,3146,779,7400,11325,0.2777924944812362,0.6534216335540839,0.06878587196467992
2016,NEW YORK,LIVINGSTON,10697,2044,17290,30031,0.35619859478538846,0.5757384036495621,0.06806300156504945
2016,NEW YORK,MADISON,11667,2461,15936,30064,0.38807211282597126,0.5300691857370942,0.08185870143693454
2016,NEW YORK,MONROE,188592,22616,136582,347790,0.5422582592944017,0.39271399407688545,0.06502774662871273
2016,NEW YORK,MONTGOMERY,6595,1158,11301,19054,0.34612154928099087,0.5931038102235751,0.06077464049543403
2016,NEW YORK,NASSAU,326088,22566,288313,636967,0.5119386090645198,0.45263412390280816,0.03542726703267202
2016,NEW YORK,NEW YORK,579013,24997,64929,668939,0.8655692073567246,0.09706266191685639,0.037368130726419
2016,NEW YORK,NIAGARA,35559,4882,51961,92402,0.38482933269842645,0.5623363130668168,0.052834354234756825
2016,NEW YORK,ONEIDA,33743,5829,51437,91009,0.37076552868397633,0.5651858607390478,0.0640486105769759
2016,NEW YORK,ONONDAGA,112337,12454,83649,208440,0.538941661869123,0.4013097294185377,0.05974860871233928
2016,NEW YORK,ONTARIO,22233,3996,26029,52258,0.42544682153928587,0.49808641739063875,0.0764667610700754
2016,NEW YORK,ORANGE,68278,7098,76645,152021,0.44913531683122726,0.5041737654666132,0.04669091770215957
2016,NEW YORK,ORLEANS,4470,974,10936,16380,0.27289377289377287,0.6676434676434676,0.05946275946275946
2016,NEW YORK,OSWEGO,17095,3397,27688,48180,0.3548152760481528,0.5746782897467829,0.07050643420506435
2016,NEW YORK,OTSEGO,10451,1909,13308,25668,0.4071606669783388,0.5184665731650304,0.07437275985663082
2016,NEW YORK,PUTNAM,19366,2173,27024,48563,0.39878096493215,0.5564730350266663,0.04474600004118362
2016,NEW YORK,QUEENS,517220,19832,149341,686393,0.7535333256603725,0.21757360579143437,0.028893068548193235
2016,NEW YORK,RENSSELAER,32717,5119,33726,71562,0.4571839803247534,0.47128364215645174,0.07153237751879489
2016,NEW YORK,RICHMOND,74143,5380,101437,180960,0.4097203801945181,0.5605492926613617,0.029730327144120248
2016,NEW YORK,ROCKLAND,69342,4834,60911,135087,0.5133136423193941,0.45090201129642377,0.03578434638418205
2016,NEW YORK,SARATOGA,50913,8606,54575,114094,0.44623731309271303,0.47833365470576894,0.07542903220151805
2016,NEW YORK,SCHENECTADY,33747,4580,28953,67280,0.501590368608799,0.4303359096313912,0.06807372175980975
2016,NEW YORK,SCHOHARIE,4240,979,8831,14050,0.30177935943060497,0.6285409252669039,0.0696797153024911
2016,NEW YORK,SCHUYLER,3091,631,5050,8772,0.35237118103055176,0.5756953944368445,0.07193342453260373
2016,NEW YORK,SENECA,5697,1047,7236,13980,0.4075107296137339,0.5175965665236052,0.07489270386266095
2016,NEW YORK,ST. LAWRENCE,16488,2728,19942,39158,0.42106338423821443,0.5092701363706011,0.06966647939118444
2016,NEW YORK,STEUBEN,12526,2645,26831,42002,0.29822389410028094,0.6388029141469453,0.06297319175277367
2016,NEW YORK,SUFFOLK,303951,26733,350570,681254,0.44616398582613825,0.5145951436615418,0.03924087051231993
2016,NEW YORK,SULLIVAN,12568,1456,15931,29955,0.41956267734935737,0.5318310799532632,0.048606242697379405
2016,NEW YORK,TIOGA,7526,1513,13260,22299,0.33750392394277773,0.5946454997981973,0.06785057625902507
2016,NEW YORK,TOMPKINS,28890,3417,10371,42678,0.6769295655841417,0.24300576409391256,0.08006467032194574
2016,NEW YORK,ULSTER,42101,5248,34006,81355,0.5174973879909041,0.41799520619507097,0.06450740581402495
2016,NEW YORK,WARREN,13091,2566,15751,31408,0.4168046357615894,0.5014964340295466,0.08169893020886398
2016,NEW YORK,WASHINGTON,9098,1820,13610,24528,0.37092302674494454,0.5548760600130463,0.07420091324200913
2016,NEW YORK,WAYNE,13473,2834,23380,39687,0.33948144228588706,0.5891097840602716,0.07140877365384131
2016,NEW YORK,WESTCHESTER,272926,16491,131238,420655,0.6488119718058741,0.3119848807217316,0.03920314747239424
2016,NEW YORK,WYOMING,3904,952,12442,17298,0.22569083130997802,0.7192739044976297,0.055035264192392186
2016,NEW YORK,YATES,3659,747,5660,10066,0.3635008940989469,0.5622888933041923,0.07421021259686073
2016,NORTH CAROLINA,ALAMANCE,29833,2509,38815,71157,0.4192560113551724,0.5454839299014854,0.03526005874334219
2016,NORTH CAROLINA,ALEXANDER,3767,611,13893,18271,0.20617371791363362,0.7603853100541842,0.033440972032182145
2016,NORTH CAROLINA,ALLEGHANY,1306,195,3814,5315,0.24571966133584194,0.7175917215428034,0.036688617121354655
2016,NORTH CAROLINA,ANSON,5859,180,4506,10545,0.5556187766714082,0.42731152204836415,0.017069701280227598
2016,NORTH CAROLINA,ASHE,3500,512,9412,13424,0.2607270560190703,0.7011323003575686,0.03814064362336114
2016,NORTH CAROLINA,AVERY,1689,262,6298,8249,0.20475209116256515,0.763486483210086,0.03176142562734877
2016,NORTH CAROLINA,BEAUFORT,8764,631,14543,23938,0.36611245718105107,0.607527780098588,0.026359762720360932
2016,NORTH CAROLINA,BERTIE,5778,113,3456,9347,0.6181662565529047,0.36974430298491495,0.012089440462180379
2016,NORTH CAROLINA,BLADEN,7058,289,8550,15897,0.4439831414732339,0.5378373277976977,0.018179530729068378
2016,NORTH CAROLINA,BRUNSWICK,23282,2349,42720,68351,0.340624131322146,0.6250091439774107,0.0343667247004433
2016,NORTH CAROLINA,BUNCOMBE,75452,7779,55716,138947,0.5430271974205992,0.4009874268606015,0.05598537571879925
2016,NORTH CAROLINA,BURKE,11251,1431,26238,38920,0.28908016443987666,0.6741521068859199,0.03676772867420349
2016,NORTH CAROLINA,CABARRUS,35521,3949,53819,93289,0.38076300528465307,0.5769061732894554,0.042330821425891584
2016,NORTH CAROLINA,CALDWELL,8425,1274,26621,36320,0.231965859030837,0.7329570484581498,0.035077092511013215
2016,NORTH CAROLINA,CAMDEN,1274,186,3546,5006,0.2544946064722333,0.7083499800239712,0.03715541350379545
2016,NORTH CAROLINA,CARTERET,9939,1273,26569,37781,0.2630687382546783,0.7032370768375639,0.03369418490775787
2016,NORTH CAROLINA,CASWELL,4792,252,6026,11070,0.4328816621499548,0.5443541102077687,0.022764227642276424
2016,NORTH CAROLINA,CATAWBA,21216,2811,48324,72351,0.29323713563046816,0.6679106024795787,0.038852261889953145
2016,NORTH CAROLINA,CHATHAM,21065,1679,17105,39849,0.5286205425481192,0.4292454013902482,0.04213405606163266
2016,NORTH CAROLINA,CHEROKEE,2860,477,10844,14181,0.20167830195331782,0.7646851420915309,0.03363655595515126
2016,NORTH CAROLINA,CHOWAN,2992,222,4014,7228,0.4139457664637521,0.5553403431101273,0.030713890426120643
2016,NORTH CAROLINA,CLAY,1367,206,4437,6010,0.22745424292845257,0.7382695507487521,0.03427620632279534
2016,NORTH CAROLINA,CLEVELAND,14964,1230,28479,44673,0.3349674299912699,0.6374991605667854,0.0275334094419448
2016,NORTH CAROLINA,COLUMBUS,9063,397,14272,23732,0.38188943199056125,0.6013821001179842,0.016728467891454577
2016,NORTH CAROLINA,CRAVEN,17630,1640,27731,47001,0.37509840216165613,0.5900087232186549,0.03489287461968894
2016,NORTH CAROLINA,CUMBERLAND,71605,4636,51265,127506,0.5615814157765124,0.4020595109249761,0.03635907329851144
2016,NORTH CAROLINA,CURRITUCK,2913,593,9163,12669,0.22993132843949798,0.7232615044597048,0.04680716710079722
2016,NORTH CAROLINA,DARE,7222,927,11460,19609,0.36830027028405327,0.5844255188943852,0.04727421082156153
2016,NORTH CAROLINA,DAVIDSON,18109,2430,54317,74856,0.24191781553916852,0.7256198567917067,0.03246232766912472
2016,NORTH CAROLINA,DAVIE,5270,884,15602,21756,0.24223202794631365,0.7171355028497886,0.04063246920389778
2016,NORTH CAROLINA,DUPLIN,8283,356,12217,20856,0.3971518987341772,0.5857786728039892,0.017069428461833524
2016,NORTH CAROLINA,DURHAM,121250,6534,28350,156134,0.776576530416181,0.18157480113236066,0.04184866845145836
2016,NORTH CAROLINA,EDGECOMBE,16224,401,8261,24886,0.6519328136301535,0.33195370891264164,0.016113477457204855
2016,NORTH CAROLINA,FORSYTH,94464,7873,75975,178312,0.5297680470187088,0.42607900758221545,0.04415294539907578
2016,NORTH CAROLINA,FRANKLIN,12874,1126,16368,30368,0.42393308746048475,0.5389884088514225,0.03707850368809273
2016,NORTH CAROLINA,GASTON,31177,3456,61798,96431,0.3233088944426585,0.640852008171646,0.03583909738569547
2016,NORTH CAROLINA,GATES,2385,133,2874,5392,0.4423219584569733,0.5330118694362018,0.024666172106824927
2016,NORTH CAROLINA,GRAHAM,768,117,3283,4168,0.18426103646833014,0.7876679462571977,0.028071017274472167
2016,NORTH CAROLINA,GRANVILLE,12909,853,13591,27353,0.4719409205571601,0.496874200270537,0.031184879172302855
2016,NORTH CAROLINA,GREENE,3605,116,4374,8095,0.44533662754786907,0.5403335392217418,0.01432983323038913
2016,NORTH CAROLINA,GUILFORD,149248,10095,98062,257405,0.5798177968570929,0.3809638507410501,0.039218352401857
2016,NORTH CAROLINA,HALIFAX,15748,388,9031,25167,0.6257400564230937,0.35884292923272537,0.015417014344180871
2016,NORTH CAROLINA,HARNETT,16737,1714,27614,46065,0.3633344187561055,0.5994572886139151,0.03720829262997938
2016,NORTH CAROLINA,HAYWOOD,10473,1325,18929,30727,0.3408403033163016,0.6160380121717056,0.04312168451199271
2016,NORTH CAROLINA,HENDERSON,19827,2540,35809,58176,0.3408106435643564,0.6155287403740374,0.043660616061606164
2016,NORTH CAROLINA,HERTFORD,6910,177,3099,10186,0.6783820930689182,0.30424111525623404,0.01737679167484783
2016,NORTH CAROLINA,HOKE,9726,744,7760,18230,0.5335161821173889,0.42567196928140427,0.040811848601206804
2016,NORTH CAROLINA,HYDE,965,51,1288,2304,0.4188368055555556,0.5590277777777778,0.022135416666666668
2016,NORTH CAROLINA,IREDELL,24734,3079,54754,82567,0.29956277931861397,0.6631462933133092,0.037290927368076834
2016,NORTH CAROLINA,JACKSON,7713,1130,9870,18713,0.41217335542136485,0.5274408165446481,0.060385828033987066
2016,NORTH CAROLINA,JOHNSTON,28362,3175,54372,85909,0.33014003189421365,0.6329022570394255,0.036957711066360914
2016,NORTH CAROLINA,JONES,2065,96,2974,5135,0.4021421616358325,0.5791626095423564,0.0186952288218111
2016,NORTH CAROLINA,LEE,10469,903,13712,25084,0.4173576782012438,0.5466432785839579,0.03599904321479828
2016,NORTH CAROLINA,LENOIR,12634,560,13613,26807,0.47129481105681353,0.5078151229156563,0.020890066027530123
2016,NORTH CAROLINA,LINCOLN,9897,1320,28806,40023,0.24728281238287986,0.7197361517127652,0.03298103590435499
2016,NORTH CAROLINA,MACON,4876,731,12127,17734,0.27495206947107254,0.6838276756512913,0.04122025487763618
2016,NORTH CAROLINA,MADISON,3926,560,6783,11269,0.34838938681338183,0.6019167628006035,0.04969385038601473
2016,NORTH CAROLINA,MARTIN,5846,221,5897,11964,0.4886325643597459,0.4928953527248412,0.018472082915412906
2016,NORTH CAROLINA,MCDOWELL,4667,640,14568,19875,0.2348176100628931,0.7329811320754717,0.03220125786163522
2016,NORTH CAROLINA,MECKLENBURG,294562,22777,155518,472857,0.6229409736981794,0.3288901295740573,0.04816889672776336
2016,NORTH CAROLINA,MITCHELL,1596,218,6282,8096,0.19713438735177866,0.7759387351778656,0.026926877470355732
2016,NORTH CAROLINA,MONTGOMERY,4150,260,7130,11540,0.3596187175043328,0.6178509532062392,0.022530329289428077
2016,NORTH CAROLINA,MOORE,16329,1873,30490,48692,0.3353528300336811,0.6261808921383389,0.038466277827979956
2016,NORTH CAROLINA,NASH,23235,1111,23319,47665,0.48746459666421904,0.4892268960453163,0.0233085072904647
2016,NORTH CAROLINA,NEW HANOVER,50979,5582,55344,111905,0.4555560520084,0.49456235199499576,0.049881595996604265
2016,NORTH CAROLINA,NORTHAMPTON,6144,122,3582,9848,0.6238830219333875,0.3637286758732738,0.012388302193338748
2016,NORTH CAROLINA,ONSLOW,17514,2499,37122,57135,0.30653714885796796,0.6497243370963508,0.043738514045681284
2016,NORTH CAROLINA,ORANGE,59923,3860,18557,82340,0.7277507894097643,0.22537041535098373,0.04687879523925188
2016,NORTH CAROLINA,PAMLICO,2448,164,4258,6870,0.3563318777292576,0.6197962154294032,0.023871906841339156
2016,NORTH CAROLINA,PASQUOTANK,8615,596,8180,17391,0.4953711689954574,0.4703582312690472,0.03427059973549537
2016,NORTH CAROLINA,PENDER,9354,892,17639,27885,0.335449166218397,0.6325623094853864,0.031988524296216604
2016,NORTH CAROLINA,PERQUIMANS,2319,212,4177,6708,0.34570661896243293,0.6226893261776982,0.031604054859868815
2016,NORTH CAROLINA,PERSON,7833,597,11185,19615,0.39933724190670405,0.5702268671934744,0.030435890899821565
2016,NORTH CAROLINA,PITT,41824,3012,35691,80527,0.5193785935152185,0.443217802724552,0.03740360376022949
2016,NORTH CAROLINA,POLK,3735,431,6768,10934,0.34159502469361624,0.6189866471556612,0.03941832815072252
2016,NORTH CAROLINA,RANDOLPH,13194,1951,49430,64575,0.2043205574912892,0.7654665118079752,0.03021293070073558
2016,NORTH CAROLINA,RICHMOND,8501,444,10383,19328,0.4398282284768212,0.5371999172185431,0.02297185430463576
2016,NORTH CAROLINA,ROBESON,19016,1080,20762,40858,0.46541680943756425,0.5081501786675804,0.026433011894855352
2016,NORTH CAROLINA,ROCKINGHAM,14228,1220,26830,42278,0.3365343677562799,0.6346090165097686,0.028856615733951464
2016,NORTH CAROLINA,ROWAN,19400,2159,42810,64369,0.3013873137690503,0.6650716960027342,0.033540990228215446
2016,NORTH CAROLINA,RUTHERFORD,7512,924,21871,30307,0.24786352987758603,0.7216484640512093,0.030488006071204672
2016,NORTH CAROLINA,SAMPSON,10547,543,14838,25928,0.4067803147176797,0.572277074976859,0.020942610305461278
2016,NORTH CAROLINA,SCOTLAND,7319,353,6256,13928,0.5254882251579552,0.4491671453187823,0.025344629523262493
2016,NORTH CAROLINA,STANLY,7094,859,21964,29917,0.23712270615369188,0.7341645218437678,0.02871277200254036
2016,NORTH CAROLINA,STOKES,4665,769,17116,22550,0.20687361419068737,0.7590243902439024,0.0341019955654102
2016,NORTH CAROLINA,SURRY,7488,1037,23671,32196,0.23257547521431235,0.7352155547272953,0.03220897005839235
2016,NORTH CAROLINA,SWAIN,2196,363,3565,6124,0.35858915741345526,0.5821358589157414,0.059274983670803395
2016,NORTH CAROLINA,TRANSYLVANIA,6558,791,10520,17869,0.3670043091387319,0.5887290838882981,0.04426660697296995
2016,NORTH CAROLINA,TYRRELL,720,44,975,1739,0.4140310523289247,0.5606670500287522,0.025301897642323174
2016,NORTH CAROLINA,UNION,34337,4666,66707,105710,0.3248226279443761,0.6310377447734368,0.044139627282187115
2016,NORTH CAROLINA,VANCE,12229,416,7332,19977,0.6121539770736347,0.3670220753866947,0.02082394753967062
2016,NORTH CAROLINA,WAKE,302736,28806,196082,527624,0.5737722317407851,0.3716320713235183,0.05459569693569663
2016,NORTH CAROLINA,WARREN,6413,215,3214,9842,0.6515952042267832,0.32655964234911605,0.021845153424100792
2016,NORTH CAROLINA,WASHINGTON,3510,91,2564,6165,0.5693430656934306,0.4158961881589619,0.014760746147607461
2016,NORTH CAROLINA,WATAUGA,14138,2150,13697,29985,0.4715024178756045,0.45679506419876603,0.07170251792562948
2016,NORTH CAROLINA,WAYNE,21770,1379,27540,50689,0.42948174160074176,0.5433131448637771,0.027205113535481072
2016,NORTH CAROLINA,WILKES,6638,906,23752,31296,0.21210378323108384,0.7589468302658486,0.028949386503067484
2016,NORTH CAROLINA,WILSON,19663,941,17531,38135,0.5156155762422971,0.4597089288055592,0.0246754949521437
2016,NORTH CAROLINA,YADKIN,3160,584,13880,17624,0.1793009532455742,0.787562414888788,0.03313663186563777
2016,NORTH CAROLINA,YANCEY,3196,379,6385,9960,0.3208835341365462,0.6410642570281124,0.03805220883534136
2016,NORTH DAKOTA,ADAMS,216,93,909,1218,0.17733990147783252,0.7463054187192119,0.07635467980295567
2016,NORTH DAKOTA,BARNES,1597,587,3160,5344,0.2988398203592814,0.5913173652694611,0.10984281437125748
2016,NORTH DAKOTA,BENSON,842,240,929,2011,0.41869716558925907,0.4619592242665341,0.11934361014420686
2016,NORTH DAKOTA,BILLINGS,59,51,495,605,0.09752066115702479,0.8181818181818182,0.08429752066115702
2016,NORTH DAKOTA,BOTTINEAU,736,264,2494,3494,0.21064682312535776,0.7137950772753291,0.0755580995993131
2016,NORTH DAKOTA,BOWMAN,227,114,1446,1787,0.12702853945159484,0.8091773922775601,0.063794068270845
2016,NORTH DAKOTA,BURKE,119,38,895,1052,0.11311787072243346,0.8507604562737643,0.03612167300380228
2016,NORTH DAKOTA,BURLEIGH,10881,4566,32532,47979,0.22678671918964546,0.6780466454073657,0.09516663540298881
2016,NORTH DAKOTA,CASS,31361,9644,39816,80821,0.3880303386496084,0.49264423850236944,0.11932542284802217
2016,NORTH DAKOTA,CAVALIER,476,173,1357,2006,0.23728813559322035,0.6764705882352942,0.08624127617148554
2016,NORTH DAKOTA,DICKEY,554,186,1667,2407,0.23016202742002492,0.692563356875779,0.0772746157041961
2016,NORTH DAKOTA,DIVIDE,245,107,867,1219,0.20098441345365053,0.7112387202625102,0.08777686628383921
2016,NORTH DAKOTA,DUNN,358,114,1771,2243,0.15960766830138207,0.7895675434685688,0.05082478823004904
2016,NORTH DAKOTA,EDDY,355,85,791,1231,0.2883834281072299,0.6425670186839968,0.06904955320877336
2016,NORTH DAKOTA,EMMONS,215,89,1677,1981,0.10853104492680464,0.8465421504290762,0.044926804644119134
2016,NORTH DAKOTA,FOSTER,347,131,1241,1719,0.20186154741128562,0.7219313554392088,0.07620709714950552
2016,NORTH DAKOTA,GOLDEN VALLEY,99,62,796,957,0.10344827586206896,0.831765935214211,0.06478578892371996
2016,NORTH DAKOTA,GRAND FORKS,10851,3174,16340,30365,0.3573522147208958,0.5381195455293923,0.10452823974971184
2016,NORTH DAKOTA,GRANT,185,88,1108,1381,0.1339608979000724,0.8023171614771905,0.06372194062273714
2016,NORTH DAKOTA,GRIGGS,298,120,847,1265,0.23557312252964427,0.6695652173913044,0.09486166007905138
2016,NORTH DAKOTA,HETTINGER,168,78,1050,1296,0.12962962962962962,0.8101851851851852,0.06018518518518518
2016,NORTH DAKOTA,KIDDER,179,86,1111,1376,0.1300872093023256,0.8074127906976745,0.0625
2016,NORTH DAKOTA,LAMOURE,502,168,1481,2151,0.23337982333798232,0.6885169688516969,0.07810320781032078
2016,NORTH DAKOTA,LOGAN,114,65,888,1067,0.10684161199625117,0.8322399250234301,0.06091846298031865
2016,NORTH DAKOTA,MCHENRY,490,280,2050,2820,0.17375886524822695,0.7269503546099291,0.09929078014184398
2016,NORTH DAKOTA,MCINTOSH,235,111,1100,1446,0.16251728907330568,0.7607192254495159,0.07676348547717843
2016,NORTH DAKOTA,MCKENZIE,698,304,3670,4672,0.14940068493150685,0.7855308219178082,0.06506849315068493
2016,NORTH DAKOTA,MCLEAN,1081,374,3860,5315,0.20338664158043274,0.7262464722483537,0.07036688617121355
2016,NORTH DAKOTA,MERCER,621,302,3759,4682,0.13263562580093977,0.8028620247757369,0.06450234942332336
2016,NORTH DAKOTA,MORTON,3080,1416,11336,15832,0.19454269833249116,0.7160181910055584,0.08943911066195048
2016,NORTH DAKOTA,MOUNTRAIL,1220,304,2582,4106,0.29712615684364346,0.6288358499756453,0.07403799318071115
2016,NORTH DAKOTA,NELSON,536,156,1025,1717,0.31217239370995925,0.5969714618520675,0.09085614443797321
2016,NORTH DAKOTA,OLIVER,119,68,830,1017,0.11701081612586037,0.816125860373648,0.06686332350049164
2016,NORTH DAKOTA,PEMBINA,681,264,2208,3153,0.2159847764034253,0.7002854424357755,0.08372978116079924
2016,NORTH DAKOTA,PIERCE,431,203,1437,2071,0.2081120231772091,0.6938676967648479,0.09802028005794303
2016,NORTH DAKOTA,RAMSEY,1505,583,3217,5305,0.2836946277097078,0.6064090480678606,0.10989632422243167
2016,NORTH DAKOTA,RANSOM,838,311,1210,2359,0.3552352691818567,0.512929207291225,0.13183552352691819
2016,NORTH DAKOTA,RENVILLE,201,99,993,1293,0.1554524361948956,0.7679814385150812,0.0765661252900232
2016,NORTH DAKOTA,RICHLAND,2064,761,4767,7592,0.2718651211801897,0.6278977871443625,0.10023709167544784
2016,NORTH DAKOTA,ROLETTE,2099,439,1217,3755,0.5589880159786951,0.3241011984021305,0.11691078561917444
2016,NORTH DAKOTA,SARGENT,694,215,1088,1997,0.34752128192288434,0.5448172258387581,0.10766149223835754
2016,NORTH DAKOTA,SHERIDAN,95,42,650,787,0.1207115628970775,0.8259212198221093,0.053367217280813214
2016,NORTH DAKOTA,SIOUX,758,214,260,1232,0.6152597402597403,0.21103896103896103,0.1737012987012987
2016,NORTH DAKOTA,SLOPE,43,25,362,430,0.1,0.8418604651162791,0.05813953488372093
2016,NORTH DAKOTA,STARK,1753,814,9755,12322,0.14226586593085538,0.7916734296380458,0.06606070443109885
2016,NORTH DAKOTA,STEELE,361,100,538,999,0.3613613613613614,0.5385385385385385,0.1001001001001001
2016,NORTH DAKOTA,STUTSMAN,2498,939,6718,10155,0.24598719842442146,0.6615460364352536,0.09246676514032497
2016,NORTH DAKOTA,TOWNER,305,119,733,1157,0.2636127917026793,0.6335350043215212,0.10285220397579949
2016,NORTH DAKOTA,TRAILL,1241,427,2265,3933,0.315535214848716,0.5758962623951183,0.10856852275616578
2016,NORTH DAKOTA,WALSH,1167,474,2995,4636,0.251725625539258,0.6460310612597067,0.10224331320103537
2016,NORTH DAKOTA,WARD,5806,2970,18636,27412,0.21180504888370058,0.6798482416459944,0.10834670947030497
2016,NORTH DAKOTA,WELLS,419,168,1796,2383,0.17582878724297105,0.7536718422156945,0.07049937054133446
2016,NORTH DAKOTA,WILLIAMS,1735,1003,10069,12807,0.13547278831888812,0.7862106660420083,0.07831654563910362
2016,OHIO,ADAMS,2326,374,8659,11359,0.20477154679109077,0.7623030196320099,0.03292543357689937
2016,OHIO,ALLEN,13294,2113,30487,45894,0.2896674946616115,0.6642916285353205,0.04604087680306794
2016,OHIO,ASHLAND,5740,1357,17493,24590,0.23342822285481904,0.7113867425782838,0.05518503456689711
2016,OHIO,ASHTABULA,15577,1972,23318,40867,0.38116328578070324,0.5705826216751902,0.048254092544106494
2016,OHIO,ATHENS,16370,1719,11354,29443,0.5559895391094658,0.38562646469449446,0.0583839961960398
2016,OHIO,AUGLAIZE,3980,989,18658,23627,0.16845134803402886,0.7896897617132941,0.04185889025267702
2016,OHIO,BELMONT,8785,1229,21108,31122,0.2822762033288349,0.6782340466550992,0.039489750016065805
2016,OHIO,BROWN,4353,681,14573,19607,0.2220125465395012,0.7432549599632784,0.03473249349722038
2016,OHIO,BUTLER,58642,8221,106976,173839,0.337335120427522,0.615373995478575,0.04729088409390298
2016,OHIO,CARROLL,3154,666,9254,13074,0.24124216001223803,0.7078170414563255,0.05094079853143644
2016,OHIO,CHAMPAIGN,4594,879,12631,18104,0.2537560760053027,0.6976911179849757,0.04855280600972161
2016,OHIO,CLARK,23328,2896,35205,61429,0.3797554900779762,0.5731006527861433,0.04714385713588045
2016,OHIO,CLERMONT,26715,4888,67518,99121,0.26951907264858105,0.6811674619909001,0.04931346536051896
2016,OHIO,CLINTON,4066,771,13838,18675,0.21772423025435073,0.7409906291834003,0.041285140562248995
2016,OHIO,COLUMBIANA,12432,2093,31676,46201,0.2690850847384256,0.6856128655223913,0.045302049739183135
2016,OHIO,COSHOCTON,4013,754,10785,15552,0.2580375514403292,0.6934799382716049,0.04848251028806584
2016,OHIO,CRAWFORD,4625,1001,13611,19237,0.2404221032385507,0.7075427561470083,0.05203514061444092
2016,OHIO,CUYAHOGA,398271,21340,184211,603822,0.6595834534018303,0.3050750055479926,0.03534154105017704
2016,OHIO,DARKE,4470,1002,20012,25484,0.17540417516873333,0.7852770365719667,0.03931878825929995
2016,OHIO,DEFIANCE,5368,1136,11688,18192,0.29507475813544415,0.6424802110817942,0.06244503078276165
2016,OHIO,DELAWARE,40872,5420,57568,103860,0.3935297515886771,0.5542846139033314,0.052185634507991525
2016,OHIO,ERIE,16057,1873,19648,37578,0.42729788706157856,0.5228591196976955,0.049842993240725955
2016,OHIO,FAIRFIELD,24881,3718,44314,72913,0.3412423024700671,0.6077654190610727,0.05099227846886015
2016,OHIO,FAYETTE,2739,428,7995,11162,0.24538613151764915,0.716269485755241,0.038344382727109834
2016,OHIO,FRANKLIN,351198,30611,199331,581140,0.604325979970403,0.3429999655848849,0.05267405444471212
2016,OHIO,FULTON,6069,1447,13709,21225,0.2859363957597173,0.6458892815076561,0.06817432273262662
2016,OHIO,GALLIA,2628,481,9822,12931,0.2032325419534452,0.759570025520068,0.03719743252648674
2016,OHIO,GEAUGA,17569,2145,30227,49941,0.35179511823952264,0.605254199955948,0.04295068180452934
2016,OHIO,GREENE,28943,4375,48540,81858,0.35357570426836715,0.5929780839991204,0.0534462117325124
2016,OHIO,GUERNSEY,4359,753,11445,16557,0.2632723319441928,0.6912484145678565,0.04547925348795072
2016,OHIO,HAMILTON,215719,19725,173665,409109,0.5272897931847014,0.4244956723024915,0.0482145345128071
2016,OHIO,HANCOCK,9609,2231,24183,36023,0.2667462454542931,0.6713211004080726,0.06193265413763429
2016,OHIO,HARDIN,2920,657,8717,12294,0.2375142345859769,0.7090450626321783,0.053440702781844804
2016,OHIO,HARRISON,1688,293,5098,7079,0.23845175872298346,0.7201582144370674,0.04139002683994915
2016,OHIO,HENRY,3756,875,9301,13932,0.2695951765719208,0.6675997703129486,0.06280505311513064
2016,OHIO,HIGHLAND,3773,708,14020,18501,0.20393492243662506,0.7577968758445489,0.03826820171882601
2016,OHIO,HOCKING,3775,566,8497,12838,0.2940489172768344,0.6618632185698707,0.04408786415329491
2016,OHIO,HOLMES,1788,546,8720,11054,0.16175140220734577,0.7888547132259816,0.0493938845666727
2016,OHIO,HURON,7192,1416,16226,24834,0.28960296367882743,0.6533784327937505,0.05701860352742208
2016,OHIO,JACKSON,3226,518,9949,13693,0.2355948294749142,0.7265756225808807,0.037829547944205066
2016,OHIO,JEFFERSON,9675,1409,21117,32201,0.300456507561877,0.6557870873575354,0.04375640508058756
2016,OHIO,KNOX,8171,1385,19131,28687,0.2848328511172308,0.6668874403039704,0.048279708578798756
2016,OHIO,LAKE,46397,5594,64255,116246,0.3991277119212704,0.5527502021574936,0.048122085921236
2016,OHIO,LAWRENCE,6974,944,18689,26607,0.26211147442402377,0.7024091404517608,0.03547938512421543
2016,OHIO,LICKING,27376,4144,51241,82761,0.3307838232984135,0.619144282935199,0.05007189376638755
2016,OHIO,LOGAN,4647,967,15957,21571,0.21542812108849846,0.7397431737054379,0.0448287052060637
2016,OHIO,LORAIN,66949,6795,66818,140562,0.4762951580085656,0.4753631849290704,0.04834165706236394
2016,OHIO,LUCAS,110833,11025,75698,197556,0.5610206726194091,0.38317236631638624,0.05580696106420458
2016,OHIO,MADISON,4779,880,11631,17290,0.27640254482359744,0.672700983227299,0.05089647194910353
2016,OHIO,MAHONING,57381,4075,53616,115072,0.49865301724137934,0.4659343715239155,0.03541261123470523
2016,OHIO,MARION,7928,1433,16961,26322,0.3011929184712408,0.6443659296406048,0.0544411518881544
2016,OHIO,MEDINA,32182,4381,54810,91373,0.3522046994188655,0.5998489707025051,0.04794632987862935
2016,OHIO,MEIGS,2260,416,7309,9985,0.22633950926389584,0.7319979969954933,0.041662493740610915
2016,OHIO,MERCER,3384,836,17506,21726,0.15575807787903895,0.8057626806591182,0.03847924146184295
2016,OHIO,MIAMI,13120,2535,37079,52734,0.24879584328895968,0.703132703758486,0.04807145295255433
2016,OHIO,MONROE,1662,265,4868,6795,0.2445916114790287,0.7164091243561442,0.03899926416482708
2016,OHIO,MONTGOMERY,122016,12376,123909,258301,0.4723791235806288,0.4797077827805545,0.04791309363881673
2016,OHIO,MORGAN,1736,276,4431,6443,0.2694397020021729,0.6877231103523204,0.04283718764550675
2016,OHIO,MORROW,3761,839,11948,16548,0.22727822093304326,0.7220207880106357,0.050700991056321004
2016,OHIO,MUSKINGUM,11123,1812,24056,36991,0.3006947635911438,0.6503203481928037,0.048984888216052555
2016,OHIO,NOBLE,1221,243,4549,6013,0.20306003658739397,0.756527523698653,0.0404124397139531
2016,OHIO,OTTAWA,8285,1280,12653,22218,0.3728958502115402,0.5694932037087046,0.05761094607975515
2016,OHIO,PAULDING,2093,454,6500,9047,0.23134740798054604,0.7184702111197082,0.05018238089974577
2016,OHIO,PERRY,4138,629,10228,14995,0.2759586528842948,0.6820940313437812,0.041947315771923975
2016,OHIO,PICKAWAY,6529,1140,17076,24745,0.26385128308749245,0.6900788037987472,0.04606991311376035
2016,OHIO,PIKE,3539,438,7902,11879,0.2979207003956562,0.6652075090495833,0.0368717905547605
2016,OHIO,PORTAGE,32397,3771,39971,76139,0.4254981021552687,0.5249740605996926,0.04952783724503868
2016,OHIO,PREBLE,4325,794,15446,20565,0.2103087770483832,0.751081935327012,0.03860928762460491
2016,OHIO,PUTNAM,2922,884,14961,18767,0.1556988330580274,0.7971972078648691,0.04710395907710343
2016,OHIO,RICHLAND,16085,2539,36590,55214,0.2913210417647698,0.6626942442134242,0.04598471402180607
2016,OHIO,ROSS,10356,1372,18652,30380,0.34088215931533905,0.6139565503620803,0.04516129032258064
2016,OHIO,SANDUSKY,9929,1799,16316,28044,0.3540507773498788,0.5818000285266011,0.06414919412352019
2016,OHIO,SCIOTO,9132,1102,20550,30784,0.2966476091476091,0.6675545738045738,0.035797817047817045
2016,OHIO,SENECA,7404,1758,14825,23987,0.308667194730479,0.6180431066827865,0.07328969858673448
2016,OHIO,SHELBY,4243,907,18590,23740,0.1787278854254423,0.7830665543386689,0.038205560235888794
2016,OHIO,STARK,68146,8705,98388,175239,0.3888746226581982,0.5614503620769349,0.04967501526486684
2016,OHIO,SUMMIT,134256,11697,112026,257979,0.5204144523391439,0.4342446478201714,0.045340899840684706
2016,OHIO,TRUMBULL,43014,3991,49024,96029,0.4479271886617584,0.5105124493642546,0.04156036197398703
2016,OHIO,TUSCARAWAS,12188,2183,26918,41289,0.29518758022717917,0.651941194991402,0.05287122478141878
2016,OHIO,UNION,7718,1615,18096,27429,0.2813810200882278,0.6597396915673193,0.058879288344452954
2016,OHIO,VAN WERT,2697,604,10469,13770,0.19586056644880173,0.7602759622367465,0.04386347131445171
2016,OHIO,VINTON,1351,268,3883,5502,0.2455470737913486,0.7057433660487096,0.048709560159941837
2016,OHIO,WARREN,33730,5894,77643,117267,0.28763420229049946,0.6621044283558034,0.05026136935369712
2016,OHIO,WASHINGTON,8026,1300,20514,29840,0.2689678284182306,0.6874664879356568,0.0435656836461126
2016,OHIO,WAYNE,15031,2552,32270,49853,0.30150642890096885,0.6473030710288248,0.05119050007020641
2016,OHIO,WILLIAMS,4358,1011,11939,17308,0.25179107926970185,0.6897966258377629,0.058412294892535244
2016,OHIO,WOOD,27318,4525,32498,64341,0.42458152655383036,0.5050900669868358,0.07032840645933386
2016,OHIO,WYANDOT,2515,609,7468,10592,0.23744335347432025,0.7050604229607251,0.05749622356495468
2016,OKLAHOMA,ADAIR,1382,344,4787,6513,0.2121910026101643,0.7349915553508368,0.05281744203899893
2016,OKLAHOMA,ALFALFA,216,109,1933,2258,0.09565987599645705,0.8560673162090345,0.04827280779450841
2016,OKLAHOMA,ATOKA,795,139,4084,5018,0.1584296532483061,0.8138700677560781,0.027700278995615783
2016,OKLAHOMA,BEAVER,176,74,1993,2243,0.07846633972358448,0.8885421310744539,0.03299152920196166
2016,OKLAHOMA,BECKHAM,960,284,6308,7552,0.1271186440677966,0.8352754237288136,0.03760593220338983
2016,OKLAHOMA,BLAINE,711,198,2884,3793,0.18745056683364092,0.760348009491168,0.05220142367519114
2016,OKLAHOMA,BRYAN,2804,536,10478,13818,0.20292372268056158,0.7582862932407005,0.03878998407873788
2016,OKLAHOMA,CADDO,2420,446,6482,9348,0.2588789045785195,0.6934103551561831,0.04771074026529739
2016,OKLAHOMA,CANADIAN,11674,3618,39986,55278,0.211187090705163,0.7233619161330005,0.06545099316183653
2016,OKLAHOMA,CARTER,4002,780,13752,18534,0.2159274846228553,0.7419876982842344,0.04208481709291033
2016,OKLAHOMA,CHEROKEE,5456,1040,9994,16490,0.3308671922377198,0.6060642813826561,0.06306852637962401
2016,OKLAHOMA,CHOCTAW,1067,153,4206,5426,0.19664577957980095,0.7751566531514928,0.02819756726870623
2016,OKLAHOMA,CIMARRON,71,45,963,1079,0.06580166821130677,0.8924930491195552,0.04170528266913809
2016,OKLAHOMA,CLEVELAND,38829,8083,62538,109450,0.3547647327546825,0.5713841936957514,0.07385107354956601
2016,OKLAHOMA,COAL,411,90,1898,2399,0.1713213839099625,0.791162984576907,0.03751563151313047
2016,OKLAHOMA,COMANCHE,11463,1918,19183,32564,0.35201449453384104,0.5890861073578184,0.0588993981083405
2016,OKLAHOMA,COTTON,424,124,2054,2602,0.16295157571099156,0.7893927747886241,0.04765564950038432
2016,OKLAHOMA,CRAIG,1252,250,4283,5785,0.21642178046672428,0.7403630077787381,0.043215211754537596
2016,OKLAHOMA,CREEK,5841,1414,21575,28830,0.20260145681581684,0.748352410683316,0.04904613250086715
2016,OKLAHOMA,CUSTER,2104,611,7826,10541,0.1996015558296177,0.7424343041457168,0.05796414002466559
2016,OKLAHOMA,DELAWARE,3311,579,11826,15716,0.21067701705268516,0.752481547467549,0.036841435479765844
2016,OKLAHOMA,DEWEY,222,61,1965,2248,0.09875444839857651,0.8741103202846975,0.027135231316725978
2016,OKLAHOMA,ELLIS,155,61,1611,1827,0.08483853311439518,0.8817733990147784,0.033388067870826495
2016,OKLAHOMA,GARFIELD,4397,1304,16009,21710,0.20253339474896362,0.7374021188392446,0.0600644864117918
2016,OKLAHOMA,GARVIN,1855,438,8253,10546,0.17589607434098237,0.782571591124597,0.04153233453442064
2016,OKLAHOMA,GRADY,3882,1088,17316,22286,0.17419007448622453,0.7769900385892489,0.04881988692452661
2016,OKLAHOMA,GRANT,288,86,1827,2201,0.1308496138119037,0.830077237619264,0.03907314856883235
2016,OKLAHOMA,GREER,323,91,1482,1896,0.17035864978902954,0.7816455696202531,0.047995780590717296
2016,OKLAHOMA,HARMON,225,37,715,977,0.23029682702149437,0.7318321392016377,0.037871033776867964
2016,OKLAHOMA,HARPER,134,47,1318,1499,0.08939292861907938,0.8792528352234823,0.03135423615743829
2016,OKLAHOMA,HASKELL,882,155,3701,4738,0.1861544955677501,0.7811312790206838,0.03271422541156606
2016,OKLAHOMA,HUGHES,961,177,3388,4526,0.21232876712328766,0.7485638532920902,0.03910737958462218
2016,OKLAHOMA,JACKSON,1473,364,5969,7806,0.1887009992313605,0.7646682039456828,0.0466307968229567
2016,OKLAHOMA,JEFFERSON,365,75,1910,2350,0.15531914893617021,0.8127659574468085,0.031914893617021274
2016,OKLAHOMA,JOHNSTON,786,139,3093,4018,0.19561971129915381,0.7697859631657541,0.034594325535092084
2016,OKLAHOMA,KAY,3738,893,12172,16803,0.22246027495090162,0.7243944533714217,0.0531452716776766
2016,OKLAHOMA,KINGFISHER,786,189,5156,6131,0.1282009460120698,0.8409721089544936,0.030826945033436633
2016,OKLAHOMA,KIOWA,767,130,2596,3493,0.2195820211852276,0.7432006870884627,0.03721729172630976
2016,OKLAHOMA,LATIMER,797,159,3100,4056,0.19649901380670612,0.7642998027613412,0.03920118343195266
2016,OKLAHOMA,LE FLORE,3250,609,13362,17221,0.1887230706695314,0.7759131293188549,0.035363800011613725
2016,OKLAHOMA,LINCOLN,2430,741,10854,14025,0.17326203208556148,0.773903743315508,0.05283422459893048
2016,OKLAHOMA,LOGAN,4248,1098,13633,18979,0.22382633436956637,0.718320248695927,0.05785341693450656
2016,OKLAHOMA,LOVE,735,132,2922,3789,0.19398258115597783,0.7711797307996833,0.03483768804433888
2016,OKLAHOMA,MAJOR,310,149,2948,3407,0.09098914000587027,0.8652773701203404,0.04373348987378926
2016,OKLAHOMA,MARSHALL,1096,190,4206,5492,0.1995630007283321,0.7658412235979607,0.03459577567370721
2016,OKLAHOMA,MAYES,3423,739,11555,15717,0.21778965451422028,0.7351911942482662,0.04701915123751352
2016,OKLAHOMA,MCCLAIN,2894,795,13169,16858,0.17166923715743268,0.7811721437892989,0.04715861905326848
2016,OKLAHOMA,MCCURTAIN,1802,268,8656,10726,0.16800298340481074,0.8070110013052396,0.024986015289949655
2016,OKLAHOMA,MCINTOSH,2123,335,5505,7963,0.26660806228808237,0.691322365942484,0.04206957176943363
2016,OKLAHOMA,MURRAY,1087,266,4175,5528,0.19663531114327062,0.755246020260492,0.04811866859623734
2016,OKLAHOMA,MUSKOGEE,7977,1196,15043,24216,0.329410307234886,0.6212008589362406,0.04938883382887347
2016,OKLAHOMA,NOBLE,901,262,3715,4878,0.18470684706847068,0.7615826158261583,0.053710537105371055
2016,OKLAHOMA,NOWATA,742,174,3321,4237,0.17512390842577294,0.7838092990323342,0.04106679254189285
2016,OKLAHOMA,OKFUSKEE,943,200,2800,3943,0.239158001521684,0.7101191985797616,0.0507227998985544
2016,OKLAHOMA,OKLAHOMA,112813,19560,141569,273942,0.41181344956231614,0.5167845748370093,0.0714019756006746
2016,OKLAHOMA,OKMULGEE,4385,620,8944,13949,0.3143594522904868,0.641192917054986,0.044447630654527205
2016,OKLAHOMA,OSAGE,5597,792,12577,18966,0.29510703363914376,0.6631340293156174,0.04175893704523885
2016,OKLAHOMA,OTTAWA,2584,475,7631,10690,0.24172123479887744,0.713844714686623,0.04443405051449953
2016,OKLAHOMA,PAWNEE,1344,291,4729,6364,0.21118793211816467,0.7430861093651792,0.045725958516656194
2016,OKLAHOMA,PAYNE,8788,2321,16651,27760,0.3165706051873199,0.5998198847262248,0.08360951008645533
2016,OKLAHOMA,PITTSBURG,3711,807,12753,17271,0.21486885530658328,0.7384054194893174,0.04672572520409936
2016,OKLAHOMA,PONTOTOC,3637,763,10431,14831,0.24522958667655587,0.7033241184006473,0.05144629492279684
2016,OKLAHOMA,POTTAWATOMIE,6015,1589,17848,25452,0.23632720414898634,0.7012415527267012,0.06243124312431243
2016,OKLAHOMA,PUSHMATAHA,748,154,3581,4483,0.16685255409324112,0.7987954494757975,0.03435199643096141
2016,OKLAHOMA,ROGER MILLS,151,61,1547,1759,0.08584422967595225,0.8794769755542922,0.03467879476975554
2016,OKLAHOMA,ROGERS,7902,2047,30913,40862,0.19338260486515588,0.7565219519357839,0.05009544319906025
2016,OKLAHOMA,SEMINOLE,2071,353,5613,8037,0.2576832151300236,0.6983949234789101,0.04392186139106632
2016,OKLAHOMA,SEQUOYAH,3061,488,10888,14437,0.2120246588626446,0.7541733047031932,0.03380203643416222
2016,OKLAHOMA,STEPHENS,3086,636,14182,17904,0.17236371760500446,0.7921134941912422,0.035522788203753354
2016,OKLAHOMA,TEXAS,858,301,4621,5780,0.14844290657439446,0.7994809688581315,0.05207612456747405
2016,OKLAHOMA,TILLMAN,657,105,1944,2706,0.24279379157427938,0.7184035476718403,0.038802660753880266
2016,OKLAHOMA,TULSA,87847,14949,144258,247054,0.3555781327159245,0.5839128287742761,0.060509038509799475
2016,OKLAHOMA,WAGONER,6723,1572,23005,31300,0.2147923322683706,0.7349840255591055,0.05022364217252396
2016,OKLAHOMA,WASHINGTON,5048,1351,15825,22224,0.22714182865370772,0.7120680345572354,0.06079013678905688
2016,OKLAHOMA,WASHITA,588,189,3854,4631,0.12697041675664003,0.8322176635715828,0.04081191967177716
2016,OKLAHOMA,WOODS,522,199,2947,3668,0.14231188658669575,0.8034351145038168,0.05425299890948746
2016,OKLAHOMA,WOODWARD,873,375,6347,7595,0.11494404213298222,0.8356813693219223,0.04937458854509546
2016,OREGON,BAKER,1797,764,6218,8779,0.20469301742795307,0.7082811254129172,0.08702585715912974
2016,OREGON,BENTON,29193,6115,13445,48753,0.5987939203741308,0.27577790084712733,0.12542817877874182
2016,OREGON,CLACKAMAS,102095,23552,88392,214039,0.4769925107106649,0.41297146781661287,0.11003602147272226
2016,OREGON,CLATSOP,9252,2274,8138,19664,0.4705044751830757,0.41385272579332794,0.11564279902359642
2016,OREGON,COLUMBIA,10167,3234,13217,26618,0.3819595762266136,0.49654369223833494,0.12149673153505147
2016,OREGON,COOS,10448,3000,17865,31313,0.3336633347172101,0.5705298118992111,0.09580685338357871
2016,OREGON,CROOK,2637,1024,8511,12172,0.21664475846204403,0.6992277357870522,0.08412750575090372
2016,OREGON,CURRY,4300,1099,7212,12611,0.34097216715565776,0.5718816905875823,0.08714614225675997
2016,OREGON,DESCHUTES,42444,10421,45692,98557,0.4306543421573303,0.46360989072313485,0.10573576711953489
2016,OREGON,DOUGLAS,14096,4843,34582,53521,0.26337325535771006,0.6461388987500234,0.09048784589226659
2016,OREGON,GILLIAM,239,109,671,1019,0.23454367026496564,0.6584887144259077,0.1069676153091266
2016,OREGON,GRANT,739,391,3210,4340,0.17027649769585254,0.7396313364055299,0.09009216589861752
2016,OREGON,HARNEY,683,379,2912,3974,0.17186713638651233,0.7327629592350277,0.09536990437845999
2016,OREGON,HOOD RIVER,6510,1128,3272,10910,0.5967002749770852,0.2999083409715857,0.10339138405132905
2016,OREGON,JACKSON,44447,11010,53870,109327,0.40655098923413246,0.49274195761339834,0.1007070531524692
2016,OREGON,JEFFERSON,2980,996,5483,9459,0.3150438735595729,0.5796595834654826,0.1052965429749445
2016,OREGON,JOSEPHINE,13453,4184,26923,44560,0.3019075403949731,0.6041965888689408,0.09389587073608617
2016,OREGON,KLAMATH,7210,2862,20435,30507,0.23633920083915166,0.6698462647916872,0.09381453436916118
2016,OREGON,LAKE,639,269,3022,3930,0.16259541984732825,0.7689567430025446,0.06844783715012723
2016,OREGON,LANE,102753,22056,67141,191950,0.5353112789789007,0.3497837978640271,0.11490492315707215
2016,OREGON,LINCOLN,12501,2716,10039,25256,0.49497149192271145,0.39748970541653467,0.10753880266075388
2016,OREGON,LINN,17995,7236,33488,58719,0.3064595786712989,0.5703094398746573,0.12323098145404383
2016,OREGON,MALHEUR,2246,995,7194,10435,0.2152371825586967,0.68941063727839,0.09535218016291327
2016,OREGON,MARION,57788,15675,63377,136840,0.4223034200526162,0.463146740719088,0.11454983922829581
2016,OREGON,MORROW,1017,429,2721,4167,0.24406047516198703,0.6529877609791217,0.1029517638588913
2016,OREGON,MULTNOMAH,292561,38588,67954,399103,0.7330463564543489,0.17026682335136545,0.09668682019428569
2016,OREGON,POLK,16420,4935,18940,40295,0.4074947263928527,0.47003350291599455,0.12247177069115275
2016,OREGON,SHERMAN,202,83,732,1017,0.19862340216322516,0.7197640117994101,0.08161258603736479
2016,OREGON,TILLAMOOK,5768,1497,6538,13803,0.4178801709773238,0.4736651452582772,0.10845468376439904
2016,OREGON,UMATILLA,7673,2865,17059,27597,0.2780374678407073,0.6181469000253651,0.1038156321339276
2016,OREGON,UNION,3249,1288,8431,12968,0.2505397902529303,0.6501388032078964,0.09932140653917335
2016,OREGON,WALLOWA,1116,402,2848,4366,0.25561154374713696,0.652313330279432,0.09207512597343105
2016,OREGON,WASCO,4781,1350,5833,11964,0.3996155132062855,0.48754597124707455,0.11283851554663991
2016,OREGON,WASHINGTON,153251,32784,83197,269232,0.5692153978724669,0.30901601592678435,0.12176858620074879
2016,OREGON,WHEELER,155,72,591,818,0.18948655256723718,0.7224938875305623,0.08801955990220049
2016,OREGON,YAMHILL,19301,6202,23250,48753,0.39589358603573116,0.47689372961663895,0.1272126843476299
2016,PENNSYLVANIA,ADAMS,14219,1847,31423,47489,0.29941670702689044,0.6616900755964539,0.038893217376655645
2016,PENNSYLVANIA,ALLEGHENY,367617,23017,259480,650114,0.5654654414456541,0.39912999873868277,0.0354045598156631
2016,PENNSYLVANIA,ARMSTRONG,7178,956,23484,31618,0.22702258207350243,0.7427414763742172,0.030235941552280345
2016,PENNSYLVANIA,BEAVER,32531,2873,48167,83571,0.38926182527431763,0.5763602206507042,0.034377954074978165
2016,PENNSYLVANIA,BEDFORD,3645,440,19552,23637,0.1542073867242036,0.8271777298303508,0.0186148834454457
2016,PENNSYLVANIA,BERKS,78437,8002,96626,183065,0.4284652992106629,0.5278234506869145,0.04371125010242264
2016,PENNSYLVANIA,BLAIR,13958,1816,39135,54909,0.25420240761988017,0.7127246899415396,0.033072902438580194
2016,PENNSYLVANIA,BRADFORD,6369,1198,18141,25708,0.2477438929516104,0.7056558269799285,0.04660028006846118
2016,PENNSYLVANIA,BUCKS,167060,12876,164361,344297,0.4852206089509929,0.47738144683224076,0.037397944216766336
2016,PENNSYLVANIA,BUTLER,28584,4059,64428,97071,0.2944648762246191,0.6637203696263559,0.04181475414902494
2016,PENNSYLVANIA,CAMBRIA,18867,1947,42258,63072,0.2991343226788432,0.669996194824962,0.030869482496194825
2016,PENNSYLVANIA,CAMERON,531,66,1589,2186,0.24290942360475754,0.7268984446477584,0.03019213174748399
2016,PENNSYLVANIA,CARBON,8936,1097,18743,28776,0.31053655824298027,0.6513413956074506,0.038122046149569086
2016,PENNSYLVANIA,CENTRE,37088,3786,35274,76148,0.48705153122865996,0.4632295004464989,0.0497189683248411
2016,PENNSYLVANIA,CHESTER,141682,11004,116114,268800,0.5270907738095238,0.4319717261904762,0.0409375
2016,PENNSYLVANIA,CLARION,4273,686,12576,17535,0.2436840604505275,0.7171941830624465,0.03912175648702595
2016,PENNSYLVANIA,CLEARFIELD,8200,1139,24932,34271,0.23926935309737096,0.7274955501736162,0.03323509672901287
2016,PENNSYLVANIA,CLINTON,4744,628,10022,15394,0.3081720150708068,0.651032869949331,0.04079511497986228
2016,PENNSYLVANIA,COLUMBIA,8934,1290,18004,28228,0.3164942610174295,0.6378064333286099,0.045699305653960604
2016,PENNSYLVANIA,CRAWFORD,10971,1534,24987,37492,0.2926224261175717,0.666462178598101,0.040915395284327326
2016,PENNSYLVANIA,CUMBERLAND,47085,5456,69076,121617,0.38715804533905623,0.5679798054548295,0.044862149206114275
2016,PENNSYLVANIA,DAUPHIN,64706,5303,60863,130872,0.4944220306864723,0.46505746072498316,0.04052050858854453
2016,PENNSYLVANIA,DELAWARE,177402,9565,110667,297634,0.5960407749114685,0.37182243964063244,0.0321367854478991
2016,PENNSYLVANIA,ELK,3853,548,10025,14426,0.2670872036600582,0.6949258283654512,0.037986967974490506
2016,PENNSYLVANIA,ERIE,58112,5498,60069,123679,0.46986149629282253,0.48568471607952846,0.044453787627649
2016,PENNSYLVANIA,FAYETTE,17946,1231,34590,53767,0.33377350419402235,0.6433314114605613,0.022895084345416334
2016,PENNSYLVANIA,FOREST,626,92,1683,2401,0.2607246980424823,0.7009579341940858,0.038317367763431906
2016,PENNSYLVANIA,FRANKLIN,17465,2498,49768,69731,0.2504624915747659,0.7137141300139106,0.03582337841132351
2016,PENNSYLVANIA,FULTON,912,165,5694,6771,0.13469206911829862,0.8409392999556934,0.024368630926007974
2016,PENNSYLVANIA,GREENE,4482,433,10849,15764,0.28431870083735095,0.6882136513575234,0.027467647805125603
2016,PENNSYLVANIA,HUNTINGDON,4539,673,14494,19706,0.23033593829290572,0.7355120267938698,0.0341520349132244
2016,PENNSYLVANIA,INDIANA,11528,1354,24888,37770,0.305215779719354,0.6589356632247816,0.03584855705586444
2016,PENNSYLVANIA,JEFFERSON,3650,636,15192,19478,0.18739090255673066,0.7799568744224253,0.03265222302084403
2016,PENNSYLVANIA,JUNIATA,1821,360,8273,10454,0.17419169695810216,0.7913717237421083,0.034436579299789556
2016,PENNSYLVANIA,LACKAWANNA,51983,3089,48384,103456,0.5024648159604083,0.4676770801113517,0.029858103928240023
2016,PENNSYLVANIA,LANCASTER,91093,12105,137914,241112,0.3778036762998109,0.5719914396628952,0.050204884037293875
2016,PENNSYLVANIA,LAWRENCE,14009,1316,25428,40753,0.34375383407356513,0.6239540647314308,0.03229210119500405
2016,PENNSYLVANIA,LEBANON,18953,2367,40525,61845,0.3064596976311747,0.6552672002587113,0.038273102110114
2016,PENNSYLVANIA,LEHIGH,81324,5979,73690,160993,0.5051399750299702,0.4577217643003112,0.03713826066971856
2016,PENNSYLVANIA,LUZERNE,52451,3844,78688,134983,0.38857485757465754,0.5829474822755458,0.028477660149796642
2016,PENNSYLVANIA,LYCOMING,13020,1918,35627,50565,0.2574903589439336,0.7045782655987343,0.03793137545733215
2016,PENNSYLVANIA,MCKEAN,4025,636,11635,16296,0.24699312714776633,0.7139788905252823,0.0390279823269514
2016,PENNSYLVANIA,MERCER,18733,2032,31544,52309,0.35812192930470854,0.6030319830239538,0.038846087671337626
2016,PENNSYLVANIA,MIFFLIN,3877,630,14094,18601,0.20842965431966023,0.7577011988602763,0.03386914682006344
2016,PENNSYLVANIA,MONROE,33918,2448,33386,69752,0.4862656267920633,0.47863860534464964,0.035095767863287074
2016,PENNSYLVANIA,MONTGOMERY,256082,15874,162731,434687,0.589118147080543,0.3743636225606011,0.03651823035885591
2016,PENNSYLVANIA,MONTOUR,2857,411,5288,8556,0.3339177185600748,0.6180458158017765,0.048036465638148666
2016,PENNSYLVANIA,NORTHAMPTON,66272,5511,71736,143519,0.46176464440248327,0.49983625861384207,0.038399096983674635
2016,PENNSYLVANIA,NORTHUMBERLAND,9788,1407,25427,36622,0.267271039266015,0.6943094314892687,0.03841952924471629
2016,PENNSYLVANIA,PERRY,4632,910,15616,21158,0.21892428395878627,0.7380659797712449,0.043009736269968804
2016,PENNSYLVANIA,PHILADELPHIA,584025,14858,108748,707631,0.8253242155869372,0.15367896544950688,0.020996818963555864
2016,PENNSYLVANIA,PIKE,9256,789,16056,26101,0.35462242825945367,0.615148844871844,0.030228726868702347
2016,PENNSYLVANIA,POTTER,1302,231,6251,7784,0.1672661870503597,0.8030575539568345,0.029676258992805755
2016,PENNSYLVANIA,SCHUYLKILL,16770,2098,44001,62869,0.26674513671284733,0.6998838855397732,0.033370977747379474
2016,PENNSYLVANIA,SNYDER,4002,636,11725,16363,0.24457617796247633,0.7165556438305934,0.03886817820693027
2016,PENNSYLVANIA,SOMERSET,7376,1018,27379,35773,0.20618902524250132,0.7653537584211556,0.02845721633634305
2016,PENNSYLVANIA,SULLIVAN,750,95,2291,3136,0.23915816326530612,0.7305484693877551,0.030293367346938774
2016,PENNSYLVANIA,SUSQUEHANNA,5123,849,12891,18863,0.27158988495997455,0.6834013677569846,0.04500874728304087
2016,PENNSYLVANIA,TIOGA,3901,810,13614,18325,0.21287858117326058,0.7429195088676671,0.044201909959072305
2016,PENNSYLVANIA,UNION,6180,666,10622,17468,0.3537897870391573,0.6080833524158461,0.03812686054499657
2016,PENNSYLVANIA,VENANGO,6309,1018,16021,23348,0.27021586431385985,0.6861829707041288,0.04360116498201131
2016,PENNSYLVANIA,WARREN,5145,812,12477,18434,0.2791038298795704,0.6768471303027015,0.04404903981772811
2016,PENNSYLVANIA,WASHINGTON,36322,3742,61386,101450,0.3580285855101035,0.605086249383933,0.03688516510596353
2016,PENNSYLVANIA,WAYNE,7008,766,16244,24018,0.2917811641269048,0.6763260887667583,0.03189274710633691
2016,PENNSYLVANIA,WESTMORELAND,59669,5860,116522,182051,0.3277598035715267,0.6400514141641628,0.03218878226431055
2016,PENNSYLVANIA,WYOMING,3811,496,8837,13144,0.28994217894096164,0.6723219720024346,0.03773584905660377
2016,PENNSYLVANIA,YORK,68524,8934,128528,205986,0.3326633848902353,0.623964735467459,0.04337187964230579
2016,RHODE ISLAND,BRISTOL,14609,1901,8965,25475,0.5734641805691855,0.35191364082433757,0.07462217860647694
2016,RHODE ISLAND,FEDERAL PRECINCT,637,38,53,728,0.875,0.07280219780219781,0.0521978021978022
2016,RHODE ISLAND,KENT,37788,5929,38336,82053,0.4605316076194655,0.4672102177860651,0.07225817459446943
2016,RHODE ISLAND,NEWPORT,22851,3117,15077,41045,0.5567304178340845,0.36732854184431724,0.07594104032159825
2016,RHODE ISLAND,PROVIDENCE,142899,14693,90882,248474,0.5751064497693924,0.36576060271899674,0.05913294751161087
2016,RHODE ISLAND,WASHINGTON,33741,5398,27230,66369,0.5083849387515256,0.41028190872244574,0.08133315252602871
2016,SOUTH CAROLINA,ABBEVILLE,3741,271,6763,10775,0.3471925754060325,0.6276566125290023,0.025150812064965198
2016,SOUTH CAROLINA,AIKEN,25455,3371,46025,74851,0.3400756168922259,0.6148882446460301,0.045036138461744
2016,SOUTH CAROLINA,ALLENDALE,2735,68,789,3592,0.7614142538975501,0.21965478841870825,0.01893095768374165
2016,SOUTH CAROLINA,ANDERSON,21097,3154,56232,80483,0.26212989078438925,0.6986817091808208,0.039188400034789954
2016,SOUTH CAROLINA,BAMBERG,3898,112,2204,6214,0.6272932088831671,0.35468297392983583,0.018023817186997103
2016,SOUTH CAROLINA,BARNWELL,4400,196,4889,9485,0.46389035318924615,0.5154454401686874,0.020664206642066422
2016,SOUTH CAROLINA,BEAUFORT,32138,3464,42922,78524,0.4092761448729051,0.5466099536447455,0.044113901482349345
2016,SOUTH CAROLINA,BERKELEY,30705,4225,44587,79517,0.3861438434548587,0.56072286429317,0.053133292251971276
2016,SOUTH CAROLINA,CALHOUN,3573,189,3787,7549,0.4733077228772023,0.5016558484567493,0.025036428666048483
2016,SOUTH CAROLINA,CHARLESTON,89299,11603,75443,176345,0.5063880461595168,0.4278147948623437,0.06579715897813944
2016,SOUTH CAROLINA,CHEROKEE,6092,500,15167,21759,0.27997610184291555,0.6970449009605221,0.02297899719656234
2016,SOUTH CAROLINA,CHESTER,6579,348,7265,14192,0.46357102593010147,0.5119081172491544,0.02452085682074408
2016,SOUTH CAROLINA,CHESTERFIELD,6858,411,9312,16581,0.4136059345033472,0.5616066582232676,0.0247874072733852
2016,SOUTH CAROLINA,CLARENDON,7732,277,7386,15395,0.5022409873335498,0.47976615784345567,0.017992854822994477
2016,SOUTH CAROLINA,COLLETON,7627,533,9091,17251,0.44211929743203293,0.5269839429598284,0.03089675960813866
2016,SOUTH CAROLINA,DARLINGTON,13888,797,14989,29674,0.46801914133584954,0.5051223293118555,0.02685852935229494
2016,SOUTH CAROLINA,DILLON,5834,227,5637,11698,0.4987177295264148,0.48187724397332876,0.019405026500256453
2016,SOUTH CAROLINA,DORCHESTER,24055,3525,34987,62567,0.38446785046430226,0.5591925455911263,0.056339603944571416
2016,SOUTH CAROLINA,EDGEFIELD,4491,311,6842,11644,0.3856922019924425,0.5875987633115768,0.026709034695980762
2016,SOUTH CAROLINA,FAIRFIELD,6945,295,4027,11267,0.6164018816011361,0.3574154610810331,0.026182657317830833
2016,SOUTH CAROLINA,FLORENCE,26710,1648,29573,57931,0.4610657506343754,0.5104866133848889,0.028447635980735703
2016,SOUTH CAROLINA,GEORGETOWN,13310,958,17389,31657,0.42044413557822913,0.5492939950090028,0.030261869412768108
2016,SOUTH CAROLINA,GREENVILLE,74483,12850,127832,215165,0.34616689517347154,0.5941114958287825,0.059721608997745916
2016,SOUTH CAROLINA,GREENWOOD,10711,1091,16961,28763,0.37238813753780897,0.5896811876368946,0.037930674825296384
2016,SOUTH CAROLINA,HAMPTON,5170,148,3488,8806,0.5870997047467635,0.3960935725641608,0.01680672268907563
2016,SOUTH CAROLINA,HORRY,39410,4222,89288,132920,0.2964941318086067,0.6717424014444778,0.031763466746915436
2016,SOUTH CAROLINA,JASPER,5956,284,5187,11427,0.5212216679793472,0.4539249146757679,0.024853417344884922
2016,SOUTH CAROLINA,KERSHAW,10330,1123,17542,28995,0.3562683221245042,0.6050008622176237,0.03873081565787205
2016,SOUTH CAROLINA,LANCASTER,13812,1407,23719,38938,0.3547177564333042,0.6091478761107402,0.03613436745595562
2016,SOUTH CAROLINA,LAURENS,8889,861,16816,26566,0.33460061733042235,0.6329895354964993,0.03240984717307837
2016,SOUTH CAROLINA,LEE,5199,154,2803,8156,0.6374448258950466,0.3436733692986758,0.01888180480627759
2016,SOUTH CAROLINA,LEXINGTON,35230,6837,80026,122093,0.28855053115248214,0.65545117246689,0.05599829638062788
2016,SOUTH CAROLINA,MARION,8569,263,5444,14276,0.6002381619501261,0.3813393107312973,0.01842252731857663
2016,SOUTH CAROLINA,MARLBORO,5954,168,4267,10389,0.5731061699874868,0.4107228799691982,0.016170950043315046
2016,SOUTH CAROLINA,MCCORMICK,2479,85,2652,5216,0.47526840490797545,0.5084355828220859,0.01629601226993865
2016,SOUTH CAROLINA,NEWBERRY,6217,573,10017,16807,0.3699053965609567,0.5960016659725115,0.0340929374665318
2016,SOUTH CAROLINA,OCONEE,7998,1459,24178,33635,0.23778801843317973,0.7188345473465141,0.04337743422030623
2016,SOUTH CAROLINA,ORANGEBURG,26318,661,11931,38910,0.6763813929581085,0.3066306861989206,0.016987920842970957
2016,SOUTH CAROLINA,PICKENS,10354,2459,36236,49049,0.21109502742155803,0.7387714326489837,0.0501335399294583
2016,SOUTH CAROLINA,RICHLAND,108000,8253,52469,168722,0.640106210215621,0.31097900688706864,0.04891478289731037
2016,SOUTH CAROLINA,SALUDA,2813,225,5526,8564,0.32846800560485756,0.6452592246613732,0.026272769733769265
2016,SOUTH CAROLINA,SPARTANBURG,39997,4816,76277,121090,0.3303080353456107,0.6299198942935007,0.039772070360888596
2016,SOUTH CAROLINA,SUMTER,24047,1294,18745,44086,0.5454566075398085,0.42519167082520526,0.029351721634986165
2016,SOUTH CAROLINA,UNION,4729,302,7061,12092,0.39108501488587494,0.5839397949057228,0.024975190208402248
2016,SOUTH CAROLINA,WILLIAMSBURG,9953,237,4864,15054,0.6611531818785705,0.32310349408795,0.015743324033479472
2016,SOUTH CAROLINA,YORK,41593,6010,66754,114357,0.36371188471191096,0.5837333962940616,0.05255471899402748
2016,SOUTH DAKOTA,AURORA,340,93,974,1407,0.24164889836531628,0.6922530206112296,0.06609808102345416
2016,SOUTH DAKOTA,BEADLE,1912,405,4455,6772,0.28233904311872415,0.6578558771411696,0.05980507974010632
2016,SOUTH DAKOTA,BENNETT,412,71,666,1149,0.35857267188859876,0.5796344647519582,0.06179286335944299
2016,SOUTH DAKOTA,BON HOMME,704,165,2105,2974,0.2367182246133154,0.7078009414929388,0.0554808338937458
2016,SOUTH DAKOTA,BROOKINGS,4879,1053,6748,12680,0.38477917981072557,0.5321766561514195,0.08304416403785489
2016,SOUTH DAKOTA,BROWN,5452,1049,9613,16114,0.33833933225766416,0.596561995780067,0.06509867196226883
2016,SOUTH DAKOTA,BRULE,571,152,1565,2288,0.24956293706293706,0.6840034965034965,0.06643356643356643
2016,SOUTH DAKOTA,BUFFALO,296,23,171,490,0.6040816326530613,0.3489795918367347,0.04693877551020408
2016,SOUTH DAKOTA,BUTTE,696,298,3357,4351,0.1599632268444036,0.7715467708572742,0.06849000229832222
2016,SOUTH DAKOTA,CAMPBELL,105,22,704,831,0.1263537906137184,0.8471720818291215,0.026474127557160047
2016,SOUTH DAKOTA,CHARLES MIX,935,116,2382,3433,0.27235653946985144,0.6938537722108943,0.033789688319254295
2016,SOUTH DAKOTA,CLARK,398,120,1139,1657,0.24019312009656005,0.6873868436934218,0.07242003621001811
2016,SOUTH DAKOTA,CLAY,2608,352,2109,5069,0.5144999013612153,0.41605839416058393,0.06944170447820083
2016,SOUTH DAKOTA,CODINGTON,3174,731,7764,11669,0.2720027423086811,0.6653526437569629,0.06264461393435598
2016,SOUTH DAKOTA,CORSON,535,52,588,1175,0.4553191489361702,0.5004255319148936,0.04425531914893617
2016,SOUTH DAKOTA,CUSTER,1121,307,3293,4721,0.23744969286168185,0.6975217115018004,0.06502859563651768
2016,SOUTH DAKOTA,DAVISON,2355,440,5157,7952,0.29615191146881287,0.6485160965794768,0.05533199195171026
2016,SOUTH DAKOTA,DAY,974,146,1627,2747,0.3545686203130688,0.592282489989079,0.053148889697852204
2016,SOUTH DAKOTA,DEUEL,570,144,1366,2080,0.27403846153846156,0.6567307692307692,0.06923076923076923
2016,SOUTH DAKOTA,DEWEY,888,97,723,1708,0.5199063231850117,0.42330210772833726,0.056791569086651054
2016,SOUTH DAKOTA,DOUGLAS,214,53,1338,1605,0.13333333333333333,0.8336448598130841,0.03302180685358255
2016,SOUTH DAKOTA,EDMUNDS,380,105,1433,1918,0.1981230448383733,0.7471324296141815,0.05474452554744526
2016,SOUTH DAKOTA,FALL RIVER,821,231,2511,3563,0.23042380016839742,0.7047431939376929,0.06483300589390963
2016,SOUTH DAKOTA,FAULK,204,56,858,1118,0.18246869409660108,0.7674418604651163,0.05008944543828265
2016,SOUTH DAKOTA,GRANT,971,211,2382,3564,0.2724466891133558,0.6683501683501684,0.05920314253647587
2016,SOUTH DAKOTA,GREGORY,391,100,1600,2091,0.18699186991869918,0.7651841224294595,0.04782400765184122
2016,SOUTH DAKOTA,HAAKON,77,31,936,1044,0.07375478927203065,0.896551724137931,0.029693486590038315
2016,SOUTH DAKOTA,HAMLIN,555,156,2051,2762,0.20094134685010862,0.7425778421433744,0.056480811006517015
2016,SOUTH DAKOTA,HAND,334,93,1391,1818,0.18371837183718373,0.7651265126512651,0.05115511551155116
2016,SOUTH DAKOTA,HANSON,424,85,1497,2006,0.21136590229312063,0.7462612163509471,0.0423728813559322
2016,SOUTH DAKOTA,HARDING,38,37,695,770,0.04935064935064935,0.9025974025974026,0.048051948051948054
2016,SOUTH DAKOTA,HUGHES,2450,551,5174,8175,0.2996941896024465,0.6329051987767584,0.06740061162079511
2016,SOUTH DAKOTA,HUTCHINSON,692,156,2517,3365,0.20564635958395244,0.7479940564635958,0.04635958395245171
2016,SOUTH DAKOTA,HYDE,125,22,543,690,0.18115942028985507,0.7869565217391304,0.03188405797101449
2016,SOUTH DAKOTA,JACKSON,323,50,722,1095,0.29497716894977166,0.6593607305936073,0.045662100456621
2016,SOUTH DAKOTA,JERAULD,264,55,648,967,0.2730093071354705,0.6701137538779731,0.05687693898655636
2016,SOUTH DAKOTA,JONES,69,39,450,558,0.12365591397849462,0.8064516129032258,0.06989247311827956
2016,SOUTH DAKOTA,KINGSBURY,703,168,1680,2551,0.275578204625637,0.6585652685221481,0.06585652685221481
2016,SOUTH DAKOTA,LAKE,2314,434,4038,6786,0.34099616858237547,0.5950486295313882,0.06395520188623637
2016,SOUTH DAKOTA,LAWRENCE,3356,1075,7411,11842,0.28339807464955247,0.6258233406519169,0.09077858469853066
2016,SOUTH DAKOTA,LINCOLN,8076,1656,15499,25231,0.3200824382703817,0.6142840156949784,0.06563354603463993
2016,SOUTH DAKOTA,LYMAN,369,75,977,1421,0.25967628430682616,0.6875439831104856,0.05277973258268825
2016,SOUTH DAKOTA,MARSHALL,754,137,1056,1947,0.3872624550590652,0.5423728813559322,0.07036466358500257
2016,SOUTH DAKOTA,MCCOOK,623,170,1794,2587,0.24081948202551218,0.6934673366834171,0.06571318129107073
2016,SOUTH DAKOTA,MCPHERSON,192,53,892,1137,0.16886543535620052,0.7845206684256816,0.04661389621811785
2016,SOUTH DAKOTA,MEADE,2223,957,8441,11621,0.19129162722657259,0.7263574563290595,0.08235091644436796
2016,SOUTH DAKOTA,MELLETTE,238,43,402,683,0.3484626647144949,0.5885797950219619,0.0629575402635432
2016,SOUTH DAKOTA,MINER,281,77,706,1064,0.2640977443609023,0.6635338345864662,0.07236842105263158
2016,SOUTH DAKOTA,MINNEHAHA,30610,5610,42043,78263,0.39111713070033094,0.5372014872928459,0.07168138200682314
2016,SOUTH DAKOTA,MOODY,1043,159,1731,2933,0.3556085918854415,0.59018070235254,0.05421070576201841
2016,SOUTH DAKOTA,OGLALA LAKOTA,2510,154,241,2905,0.8640275387263339,0.08296041308089501,0.05301204819277108
2016,SOUTH DAKOTA,PENNINGTON,14074,3865,29804,47743,0.29478667029721634,0.6242590536832625,0.08095427601952118
2016,SOUTH DAKOTA,PERKINS,188,85,1333,1606,0.11706102117061021,0.8300124533001245,0.05292652552926526
2016,SOUTH DAKOTA,POTTER,215,51,1071,1337,0.16080777860882572,0.8010471204188482,0.0381451009723261
2016,SOUTH DAKOTA,ROBERTS,1540,205,2144,3889,0.3959886860375418,0.5512985343275907,0.052712779634867576
2016,SOUTH DAKOTA,SANBORN,241,63,819,1123,0.21460373998219057,0.7292965271593945,0.05609973285841496
2016,SOUTH DAKOTA,SPINK,919,178,1854,2951,0.3114198576753643,0.6282616062351745,0.0603185360894612
2016,SOUTH DAKOTA,STANLEY,329,90,1148,1567,0.209955328653478,0.7326100829610721,0.0574345883854499
2016,SOUTH DAKOTA,SULLY,137,45,679,861,0.15911730545876887,0.7886178861788617,0.05226480836236934
2016,SOUTH DAKOTA,TODD,1505,133,487,2125,0.7082352941176471,0.2291764705882353,0.06258823529411765
2016,SOUTH DAKOTA,TRIPP,462,99,2069,2630,0.17566539923954372,0.7866920152091255,0.0376425855513308
2016,SOUTH DAKOTA,TURNER,961,252,2937,4150,0.23156626506024097,0.707710843373494,0.060722891566265064
2016,SOUTH DAKOTA,UNION,2227,380,5290,7897,0.28200582499683424,0.6698746359376979,0.0481195390654679
2016,SOUTH DAKOTA,WALWORTH,457,124,1896,2477,0.1844973758578926,0.7654420670165523,0.05006055712555511
2016,SOUTH DAKOTA,YANKTON,3301,663,5659,9623,0.34303231840382414,0.5880702483632962,0.06889743323287956
2016,SOUTH DAKOTA,ZIEBACH,353,46,368,767,0.4602346805736636,0.47979139504563234,0.05997392438070404
2016,TENNESSEE,ANDERSON,9013,1656,19212,29881,0.3016297981995248,0.6429503698002075,0.055419832000267726
2016,TENNESSEE,BEDFORD,3395,474,11486,15355,0.22110061869098013,0.7480299576685119,0.030869423640507977
2016,TENNESSEE,BENTON,1474,138,4716,6328,0.2329329962073325,0.7452591656131479,0.021807838179519597
2016,TENNESSEE,BLEDSOE,897,145,3622,4664,0.19232418524871356,0.7765866209262435,0.031089193825042882
2016,TENNESSEE,BLOUNT,12100,2665,37443,52208,0.23176524670548576,0.7171889365614466,0.05104581673306773
2016,TENNESSEE,BRADLEY,7070,1828,29768,38666,0.18284798013758857,0.769875342678322,0.04727667718408938
2016,TENNESSEE,CAMPBELL,2248,414,9870,12532,0.17938078518991382,0.7875837855090967,0.03303542930098947
2016,TENNESSEE,CANNON,1127,180,4007,5314,0.2120812946932631,0.7540459164471208,0.03387278885961611
2016,TENNESSEE,CARROLL,2327,301,7756,10384,0.22409476117103236,0.7469183359013868,0.028986902927580892
2016,TENNESSEE,CARTER,3453,733,16898,21084,0.16377347751849744,0.8014608233731739,0.03476569910832859
2016,TENNESSEE,CHEATHAM,3878,749,11297,15924,0.24353177593569456,0.7094323034413464,0.047035920622959054
2016,TENNESSEE,CHESTER,1243,183,5081,6507,0.19102504994621178,0.7808513908098971,0.028123559243891195
2016,TENNESSEE,CLAIBORNE,1832,306,8602,10740,0.17057728119180632,0.8009310986964618,0.028491620111731845
2016,TENNESSEE,CLAY,707,72,2141,2920,0.24212328767123287,0.7332191780821918,0.024657534246575342
2016,TENNESSEE,COCKE,1981,354,9791,12126,0.16336796965198747,0.8074385617681016,0.029193468579910935
2016,TENNESSEE,COFFEE,4743,811,14417,19971,0.23749436683190625,0.7218967502879174,0.04060888288017626
2016,TENNESSEE,CROCKETT,1303,112,3982,5397,0.24143042430980174,0.7378173059106912,0.020752269779507133
2016,TENNESSEE,CUMBERLAND,5202,745,20413,26360,0.19734446130500757,0.7743930197268589,0.028262518968133536
2016,TENNESSEE,DAVIDSON,148864,15654,84550,249068,0.5976841665729841,0.3394655274864696,0.06285030594054636
2016,TENNESSEE,DECATUR,894,110,3588,4592,0.1946864111498258,0.7813588850174216,0.023954703832752614
2016,TENNESSEE,DEKALB,1569,215,5171,6955,0.22559309849029474,0.7434938892882819,0.030913012221423435
2016,TENNESSEE,DICKSON,4722,744,13233,18699,0.2525268730948179,0.7076849029359858,0.039788223969196214
2016,TENNESSEE,DYER,2816,340,10180,13336,0.21115776844631073,0.7633473305338933,0.02549490101979604
2016,TENNESSEE,FAYETTE,5874,465,13055,19394,0.3028771785088172,0.6731463339177065,0.023976487573476334
2016,TENNESSEE,FENTRESS,1100,195,6038,7333,0.15000681849174963,0.8234010636847129,0.026592117823537435
2016,TENNESSEE,FRANKLIN,4374,498,11532,16404,0.26664228237015364,0.7029992684711046,0.03035844915874177
2016,TENNESSEE,GIBSON,5258,503,13786,19547,0.268992684299381,0.7052744666700772,0.025732849030541773
2016,TENNESSEE,GILES,2917,250,7970,11137,0.2619197270360061,0.7156325760976924,0.022447696866301516
2016,TENNESSEE,GRAINGER,1154,228,6626,8008,0.1441058941058941,0.8274225774225774,0.028471528471528472
2016,TENNESSEE,GREENE,4216,805,18562,23583,0.17877284484586353,0.7870923970656829,0.034134758088453544
2016,TENNESSEE,GRUNDY,999,128,3636,4763,0.20974175939533907,0.7633844215830359,0.026873819021625025
2016,TENNESSEE,HAMBLEN,4075,760,15857,20692,0.19693601391842258,0.7663348153875894,0.03672917069398801
2016,TENNESSEE,HAMILTON,55316,8359,78733,142408,0.3884332340879726,0.5528692208302904,0.05869754508173698
2016,TENNESSEE,HANCOCK,322,66,1843,2231,0.14432989690721648,0.8260869565217391,0.029583146571044376
2016,TENNESSEE,HARDEMAN,4185,169,4919,9273,0.4513102555807182,0.5304647902512671,0.018224954168014666
2016,TENNESSEE,HARDIN,1622,315,8012,9949,0.16303146044828626,0.8053070660367876,0.031661473514926125
2016,TENNESSEE,HAWKINS,3507,619,16648,20774,0.1688167902185424,0.8013863483200154,0.029796861461442187
2016,TENNESSEE,HAYWOOD,3711,110,3013,6834,0.5430201931518877,0.4408838162130524,0.016095990635059995
2016,TENNESSEE,HENDERSON,1800,279,8138,10217,0.17617695996867966,0.796515611236175,0.027307428795145347
2016,TENNESSEE,HENRY,3063,374,9508,12945,0.23661645422943223,0.7344920818848977,0.028891463885670144
2016,TENNESSEE,HICKMAN,1824,294,5695,7813,0.2334570587482401,0.728913349545629,0.03762959170613081
2016,TENNESSEE,HOUSTON,866,120,2182,3168,0.27335858585858586,0.6887626262626263,0.03787878787878788
2016,TENNESSEE,HUMPHREYS,1967,256,4930,7153,0.2749895148888578,0.689221305745841,0.03578917936530127
2016,TENNESSEE,JACKSON,1129,101,3236,4466,0.2527989252127183,0.7245857590685177,0.022615315718763993
2016,TENNESSEE,JEFFERSON,3494,802,14776,19072,0.1832005033557047,0.774748322147651,0.04205117449664429
2016,TENNESSEE,JOHNSON,988,181,5410,6579,0.15017479860161118,0.8223134214926281,0.027511779905760755
2016,TENNESSEE,KNOX,62878,12052,105767,180697,0.34797478652108227,0.5853279246473378,0.06669728883157994
2016,TENNESSEE,LAKE,577,36,1357,1970,0.2928934010152284,0.6888324873096446,0.018274111675126905
2016,TENNESSEE,LAUDERDALE,3056,147,4884,8087,0.3778904414492395,0.6039322369234574,0.018177321627303077
2016,TENNESSEE,LAWRENCE,2821,425,12420,15666,0.18007149240393208,0.7927996936039832,0.02712881399208477
2016,TENNESSEE,LEWIS,890,147,3585,4622,0.19255733448723497,0.7756382518390307,0.031804413673734315
2016,TENNESSEE,LINCOLN,2554,396,10398,13348,0.19133952652082709,0.7789931075816602,0.029667365897512735
2016,TENNESSEE,LOUDON,4919,862,17610,23391,0.21029455773588132,0.7528536616647429,0.03685178059937583
2016,TENNESSEE,MACON,1072,169,6263,7504,0.14285714285714285,0.8346215351812367,0.022521321961620468
2016,TENNESSEE,MADISON,15448,1337,21335,38120,0.40524658971668415,0.5596799580272823,0.03507345225603358
2016,TENNESSEE,MARION,2832,334,7696,10862,0.26072546492358684,0.708525133492911,0.030749401583502117
2016,TENNESSEE,MARSHALL,2852,419,8184,11455,0.24897424705368834,0.7144478393714535,0.036577913574858144
2016,TENNESSEE,MAURY,10038,1532,23799,35369,0.2838078543357177,0.6728773784952925,0.04331476716898979
2016,TENNESSEE,MCMINN,3510,554,14691,18755,0.1871500933084511,0.7833111170354572,0.029538789656091708
2016,TENNESSEE,MCNAIRY,1848,349,7841,10038,0.18410041841004185,0.7811316995417413,0.03476788204821678
2016,TENNESSEE,MEIGS,856,122,3342,4320,0.19814814814814816,0.7736111111111111,0.02824074074074074
2016,TENNESSEE,MONROE,3186,533,13374,17093,0.1863920903293746,0.7824255543204821,0.031182355350143333
2016,TENNESSEE,MONTGOMERY,21699,3580,32341,57620,0.37658799028115236,0.5612808052759458,0.06213120444290177
2016,TENNESSEE,MOORE,496,105,2325,2926,0.1695146958304853,0.7946001367053999,0.03588516746411483
2016,TENNESSEE,MORGAN,1054,210,5441,6705,0.15719612229679344,0.8114839671886652,0.03131991051454139
2016,TENNESSEE,OBION,2426,297,9526,12249,0.19805698424361173,0.7776961384602825,0.024246877296105803
2016,TENNESSEE,OVERTON,1945,225,6059,8229,0.23635921740187144,0.7362984566776036,0.027342325920524973
2016,TENNESSEE,PERRY,597,91,2167,2855,0.20910683012259193,0.7590192644483362,0.03187390542907181
2016,TENNESSEE,PICKETT,536,58,2021,2615,0.20497131931166349,0.772848948374761,0.022179732313575527
2016,TENNESSEE,POLK,1252,171,5097,6520,0.19202453987730062,0.7817484662576687,0.026226993865030676
2016,TENNESSEE,PUTNAM,6851,1359,19002,27212,0.25176392767896516,0.6982948699103336,0.049941202410701165
2016,TENNESSEE,RHEA,1942,460,8660,11062,0.1755559573314048,0.7828602422708371,0.04158380039775809
2016,TENNESSEE,ROANE,4837,952,15880,21669,0.22322211454151092,0.7328441552448198,0.043933730213669295
2016,TENNESSEE,ROBERTSON,6637,1066,19410,27113,0.24479032198576328,0.71589274517759,0.039316932836646626
2016,TENNESSEE,RUTHERFORD,36706,6215,64515,107436,0.3416545664395547,0.6004970400982911,0.057848393462154216
2016,TENNESSEE,SCOTT,934,145,6044,7123,0.13112452618278816,0.8485188824933315,0.020356591323880388
2016,TENNESSEE,SEQUATCHIE,1053,200,4441,5694,0.18493150684931506,0.7799438004917457,0.035124692658939236
2016,TENNESSEE,SEVIER,6297,1386,28629,36312,0.1734137475214805,0.788417052214144,0.03816920026437541
2016,TENNESSEE,SHELBY,208992,12047,116344,337383,0.6194502983256418,0.3448425083658631,0.035707193308495096
2016,TENNESSEE,SMITH,1689,253,5494,7436,0.2271382463690156,0.7388380849919312,0.034023668639053255
2016,TENNESSEE,STEWART,1222,213,3864,5299,0.23060954897150407,0.7291941875825627,0.040196263445933196
2016,TENNESSEE,SULLIVAN,12578,2721,46979,62278,0.20196538103343076,0.7543434278557436,0.04369119111082565
2016,TENNESSEE,SUMNER,18161,3215,50129,71505,0.2539822390042654,0.7010558702188658,0.04496189077686875
2016,TENNESSEE,TIPTON,5785,786,16910,23481,0.24636940505089222,0.7201567224564541,0.033473872492653635
2016,TENNESSEE,TROUSDALE,946,111,2103,3160,0.2993670886075949,0.665506329113924,0.03512658227848101
2016,TENNESSEE,UNICOI,1262,262,5671,7195,0.1753995830437804,0.7881862404447533,0.0364141765114663
2016,TENNESSEE,UNION,1012,182,5053,6247,0.16199775892428367,0.8088682567632464,0.029133984312469986
2016,TENNESSEE,VAN BUREN,539,60,1820,2419,0.22281934683753618,0.7523770152955767,0.024803637866887142
2016,TENNESSEE,WARREN,3535,537,9540,13612,0.2596973258889215,0.700852189244784,0.03945048486629445
2016,TENNESSEE,WASHINGTON,13024,2474,34252,49750,0.2617889447236181,0.6884824120603015,0.0497286432160804
2016,TENNESSEE,WAYNE,717,104,5036,5857,0.1224176199419498,0.8598258494109613,0.017756530647088955
2016,TENNESSEE,WEAKLEY,2772,404,9008,12184,0.22751149047931712,0.7393302692055155,0.03315824031516743
2016,TENNESSEE,WHITE,1845,309,7671,9825,0.18778625954198475,0.7807633587786259,0.031450381679389315
2016,TENNESSEE,WILLIAMSON,31013,7046,68212,106271,0.2918293796049722,0.6418684307101655,0.06630218968486229
2016,TENNESSEE,WILSON,14385,2943,39406,56734,0.25355166214263053,0.6945746818486269,0.05187365600874255
2016,TEXAS,ANDERSON,3369,407,13201,16977,0.19844495493903516,0.7775814337044237,0.0239736113565412
2016,TEXAS,ANDREWS,836,180,3927,4943,0.16912805988266236,0.7944568076067166,0.03641513251062108
2016,TEXAS,ANGELINA,7538,705,21668,29911,0.25201430911704725,0.7244157667747652,0.023569924108187625
2016,TEXAS,ARANSAS,2465,307,7740,10512,0.2344939117199391,0.7363013698630136,0.029204718417047183
2016,TEXAS,ARCHER,394,103,3786,4283,0.09199159467662853,0.8839598412327807,0.024048564090590707
2016,TEXAS,ARMSTRONG,70,27,924,1021,0.06856023506366307,0.9049951028403526,0.02644466209598433
2016,TEXAS,ATASCOSA,4651,404,8618,13673,0.3401594383090763,0.6302932787244935,0.02954728296643019
2016,TEXAS,AUSTIN,2320,317,9637,12274,0.1890174352289392,0.7851556134919342,0.025826951279126608
2016,TEXAS,BAILEY,397,52,1344,1793,0.22141662018962632,0.7495817066369214,0.029001673173452314
2016,TEXAS,BANDERA,1726,329,8163,10218,0.16891759639851242,0.7988843217850852,0.03219808181640243
2016,TEXAS,BASTROP,10569,1557,16328,28454,0.371441625079075,0.5738384761369227,0.05471989878400225
2016,TEXAS,BAYLOR,191,41,1267,1499,0.12741827885256837,0.8452301534356238,0.027351567711807873
2016,TEXAS,BEE,3444,297,4744,8485,0.40589275191514435,0.559104301708898,0.03500294637595757
2016,TEXAS,BELL,37801,5195,51998,94994,0.3979303956039329,0.5473819399119945,0.05468766448407268
2016,TEXAS,BEXAR,319550,29762,240333,589645,0.5419362497774084,0.4075893122132809,0.05047443800931069
2016,TEXAS,BLANCO,1244,229,4212,5685,0.21882145998240984,0.7408970976253298,0.040281442392260336
2016,TEXAS,BORDEN,31,4,330,365,0.08493150684931507,0.9041095890410958,0.010958904109589041
2016,TEXAS,BOSQUE,1278,221,6339,7838,0.16305179892829805,0.8087522327124267,0.028195968359275327
2016,TEXAS,BOWIE,8838,840,24924,34602,0.2554187619212762,0.7203051846714063,0.024276053407317495
2016,TEXAS,BRAZORIA,43200,5190,72791,121181,0.3564915292001221,0.6006799745834743,0.04282849621640356
2016,TEXAS,BRAZOS,23121,5352,38738,67211,0.34400618946303435,0.5763639880376724,0.07962982249929328
2016,TEXAS,BREWSTER,1873,302,2077,4252,0.44049858889934146,0.48847601128880525,0.07102539981185324
2016,TEXAS,BRISCOE,91,20,625,736,0.12364130434782608,0.8491847826086957,0.02717391304347826
2016,TEXAS,BROOKS,1937,46,613,2596,0.7461479198767335,0.23613251155624038,0.017719568567026195
2016,TEXAS,BROWN,1621,388,12017,14026,0.11557108227577356,0.8567660059888778,0.027662911735348638
2016,TEXAS,BURLESON,1491,153,5316,6960,0.21422413793103448,0.7637931034482759,0.021982758620689654
2016,TEXAS,BURNET,3797,769,14638,19204,0.1977192251614247,0.7622370339512602,0.04004374088731514
2016,TEXAS,CALDWELL,4795,606,6691,12092,0.39654316903738007,0.5533410519351637,0.05011577902745617
2016,TEXAS,CALHOUN,2118,209,4638,6965,0.304091888011486,0.6659009332376167,0.030007178750897343
2016,TEXAS,CALLAHAN,569,145,4865,5579,0.10198960387166159,0.8720200752823086,0.025990320846029754
2016,TEXAS,CAMERON,59402,3205,29472,92079,0.6451199513461267,0.32007298080995666,0.034807067843916635
2016,TEXAS,CAMP,1260,81,3201,4542,0.2774108322324967,0.7047556142668429,0.0178335535006605
2016,TEXAS,CARSON,249,95,2620,2964,0.0840080971659919,0.8839406207827261,0.03205128205128205
2016,TEXAS,CASS,2391,227,9726,12344,0.19369734283862605,0.7879131561892417,0.01838950097213221
2016,TEXAS,CASTRO,526,57,1414,1997,0.26339509263895844,0.7080620931397096,0.028542814221331998
2016,TEXAS,CHAMBERS,2948,499,13339,16786,0.17562254259501967,0.7946503038246158,0.02972715358036459
2016,TEXAS,CHEROKEE,3469,402,12919,16790,0.2066110780226325,0.769446098868374,0.023942823108993448
2016,TEXAS,CHILDRESS,253,29,1802,2084,0.12140115163147792,0.8646833013435701,0.013915547024952015
2016,TEXAS,CLAY,536,105,4377,5018,0.1068154643284177,0.8722598644878438,0.02092467118373854
2016,TEXAS,COCHRAN,190,32,679,901,0.21087680355160932,0.753607103218646,0.03551609322974473
2016,TEXAS,COKE,140,18,1265,1423,0.09838369641602249,0.8889669711876318,0.012649332396345749
2016,TEXAS,COLEMAN,388,78,3177,3643,0.1065056272303047,0.872083447707933,0.021410925061762284
2016,TEXAS,COLLIN,140624,19781,201014,361419,0.3890885647959847,0.5561799462673518,0.05473148893666354
2016,TEXAS,COLLINGSWORTH,145,28,983,1156,0.1254325259515571,0.8503460207612457,0.02422145328719723
2016,TEXAS,COLORADO,1987,201,6325,8513,0.23340772935510395,0.7429813226829555,0.023610947961940562
2016,TEXAS,COMAL,14238,2804,45136,62178,0.2289877448615266,0.7259159188137283,0.045096336324745086
2016,TEXAS,COMANCHE,789,115,4333,5237,0.15065877410731335,0.8273820889822417,0.02195913691044491
2016,TEXAS,CONCHO,148,35,885,1068,0.13857677902621723,0.8286516853932584,0.03277153558052434
2016,TEXAS,COOKE,2352,422,13181,15955,0.1474146035725478,0.8261360075211532,0.026449388906298967
2016,TEXAS,CORYELL,5064,964,12225,18253,0.2774338464909878,0.6697529173286583,0.05281323618035391
2016,TEXAS,COTTLE,92,14,506,612,0.1503267973856209,0.826797385620915,0.02287581699346405
2016,TEXAS,CRANE,299,36,1049,1384,0.21604046242774566,0.7579479768786127,0.02601156069364162
2016,TEXAS,CROCKETT,372,43,980,1395,0.26666666666666666,0.7025089605734767,0.03082437275985663
2016,TEXAS,CROSBY,468,79,1181,1728,0.2708333333333333,0.6834490740740741,0.045717592592592594
2016,TEXAS,CULBERSON,454,33,280,767,0.5919165580182529,0.3650586701434159,0.04302477183833116
2016,TEXAS,DALLAM,222,61,1261,1544,0.14378238341968913,0.8167098445595855,0.03950777202072539
2016,TEXAS,DALLAS,461080,34948,262945,758973,0.6075051418166391,0.34644842438400314,0.046046433799357814
2016,TEXAS,DAWSON,835,92,2636,3563,0.2343530732528768,0.7398259893348302,0.02582093741229301
2016,TEXAS,DEAF SMITH,1185,120,2911,4216,0.2810721062618596,0.6904648956356736,0.028462998102466792
2016,TEXAS,DELTA,400,45,1836,2281,0.17536168347216133,0.8049101271372205,0.01972818939061815
2016,TEXAS,DENTON,110890,17152,170603,298645,0.37131041872457266,0.5712568434093991,0.057432737866028226
2016,TEXAS,DEWITT,1163,162,5519,6844,0.16992986557568673,0.8063997662185857,0.023670368205727644
2016,TEXAS,DICKENS,128,26,755,909,0.1408140814081408,0.8305830583058306,0.028602860286028604
2016,TEXAS,DIMMIT,2173,78,974,3225,0.6737984496124031,0.302015503875969,0.024186046511627906
2016,TEXAS,DONLEY,191,49,1225,1465,0.13037542662116042,0.8361774744027304,0.033447098976109216
2016,TEXAS,DUVAL,2783,69,1316,4168,0.6677063339731286,0.31573896353166986,0.016554702495201537
2016,TEXAS,EASTLAND,776,176,6011,6963,0.11144621571161856,0.8632773229929628,0.02527646129541864
2016,TEXAS,ECTOR,10249,1261,25020,36530,0.2805639200656994,0.6849165069805639,0.03451957295373666
2016,TEXAS,EDWARDS,303,24,746,1073,0.28238583410997203,0.6952469711090401,0.022367194780987885
2016,TEXAS,EL PASO,147843,10653,55512,214008,0.6908293147919704,0.2593921722552428,0.04977851295278681
2016,TEXAS,ELLIS,16253,2479,44941,63673,0.2552573304226281,0.705809369748559,0.03893329982881284
2016,TEXAS,ERATH,2160,523,11210,13893,0.1554739797020082,0.8068811631757,0.0376448571222918
2016,TEXAS,FALLS,1684,123,3441,5248,0.3208841463414634,0.6556783536585366,0.0234375
2016,TEXAS,FANNIN,2132,364,9548,12044,0.17701760212553969,0.7927598804383925,0.030222517436067752
2016,TEXAS,FAYETTE,2144,287,8743,11174,0.19187399319849652,0.7824413817791301,0.025684625022373366
2016,TEXAS,FISHER,403,61,1265,1729,0.23308270676691728,0.7316367842683632,0.035280508964719494
2016,TEXAS,FLOYD,435,50,1474,1959,0.222052067381317,0.7524247064828994,0.025523226135783564
2016,TEXAS,FOARD,113,17,383,513,0.2202729044834308,0.746588693957115,0.03313840155945419
2016,TEXAS,FORT BEND,134686,10089,117291,262066,0.5139392366808361,0.44756282768462907,0.03849793563453481
2016,TEXAS,FRANKLIN,665,130,3585,4380,0.15182648401826485,0.8184931506849316,0.02968036529680365
2016,TEXAS,FREESTONE,1471,187,6026,7684,0.19143675169182717,0.7842269651223321,0.024336283185840708
2016,TEXAS,FRIO,2444,100,1856,4400,0.5554545454545454,0.4218181818181818,0.022727272727272728
2016,TEXAS,GAINES,597,116,3907,4620,0.1292207792207792,0.8456709956709957,0.025108225108225107
2016,TEXAS,GALVESTON,43658,5488,73757,122903,0.35522322481957314,0.6001236747679064,0.04465310041252044
2016,TEXAS,GARZA,230,29,1225,1484,0.15498652291105122,0.8254716981132075,0.01954177897574124
2016,TEXAS,GILLESPIE,2288,480,10446,13214,0.17314968972302103,0.7905252005448766,0.03632510973210232
2016,TEXAS,GLASSCOCK,34,17,553,604,0.056291390728476824,0.9155629139072847,0.028145695364238412
2016,TEXAS,GOLIAD,973,115,2620,3708,0.26240560949298813,0.7065803667745415,0.031014023732470336
2016,TEXAS,GONZALES,1571,176,4587,6334,0.2480265235238396,0.7241869276918219,0.02778654878433849
2016,TEXAS,GRAY,701,204,6500,7405,0.09466576637407158,0.8777852802160703,0.027548953409858204
2016,TEXAS,GRAYSON,10301,1790,35325,47416,0.21724734266914122,0.745001687194196,0.03775097013666273
2016,TEXAS,GREGG,11677,1308,28764,41749,0.2796953220436418,0.688974586217634,0.03133009173872428
2016,TEXAS,GRIMES,2194,274,7065,9533,0.23014790726948495,0.7411098290150006,0.02874226371551453
2016,TEXAS,GUADALUPE,18391,2799,36632,57822,0.31806232921725297,0.633530490124866,0.048407180657881084
2016,TEXAS,HALE,2101,391,6366,8858,0.23718672386543238,0.7186723865432377,0.04414088959132987
2016,TEXAS,HALL,164,34,893,1091,0.15032080659945005,0.8185151237396884,0.031164069660861594
2016,TEXAS,HAMILTON,479,81,3060,3620,0.13232044198895027,0.8453038674033149,0.022375690607734807
2016,TEXAS,HANSFORD,171,46,1730,1947,0.08782742681047766,0.8885464817668207,0.02362609142270159
2016,TEXAS,HARDEMAN,249,57,1207,1513,0.16457369464639787,0.797752808988764,0.03767349636483807
2016,TEXAS,HARDIN,2780,394,19606,22780,0.12203687445127305,0.860667251975417,0.01729587357330992
2016,TEXAS,HARRIS,707914,58243,545955,1312112,0.5395225407587158,0.4160887180362652,0.04438874120501908
2016,TEXAS,HARRISON,7151,648,18749,26548,0.26936115714931447,0.7062302244990206,0.02440861835166491
2016,TEXAS,HARTLEY,173,49,1730,1952,0.08862704918032786,0.8862704918032787,0.025102459016393443
2016,TEXAS,HASKELL,314,53,1403,1770,0.17740112994350282,0.7926553672316384,0.029943502824858758
2016,TEXAS,HAYS,33224,5114,33826,72164,0.4603957652014855,0.4687378748406408,0.07086635995787373
2016,TEXAS,HEMPHILL,181,52,1462,1695,0.10678466076696165,0.8625368731563422,0.030678466076696165
2016,TEXAS,HENDERSON,5669,726,23650,30045,0.18868364120485936,0.7871526044266933,0.024163754368447327
2016,TEXAS,HIDALGO,118809,5986,48642,173437,0.6850268397170154,0.28045918690936766,0.03451397337361693
2016,TEXAS,HILL,2547,315,10108,12970,0.1963762528912876,0.779336931380108,0.02428681572860447
2016,TEXAS,HOCKLEY,1260,242,5809,7311,0.1723430447271235,0.7945561482697305,0.033100807003145945
2016,TEXAS,HOOD,4008,872,21382,26262,0.15261594699565914,0.8141801842967025,0.03320386870763841
2016,TEXAS,HOPKINS,2510,321,10707,13538,0.18540404786526812,0.7908849165312454,0.02371103560348648
2016,TEXAS,HOUSTON,1978,170,6205,8353,0.23680114928768106,0.7428468813599904,0.020351969352328504
2016,TEXAS,HOWARD,1770,316,6637,8723,0.20291184225610456,0.7608620887309412,0.03622606901295426
2016,TEXAS,HUDSPETH,324,44,503,871,0.3719862227324914,0.5774971297359357,0.0505166475315729
2016,TEXAS,HUNT,6396,1248,23910,31554,0.20270013310515306,0.7577486214109146,0.03955124548393231
2016,TEXAS,HUTCHINSON,854,259,7042,8155,0.10472103004291845,0.863519313304721,0.03175965665236052
2016,TEXAS,IRION,90,16,660,766,0.1174934725848564,0.8616187989556136,0.020887728459530026
2016,TEXAS,JACK,314,63,2973,3350,0.09373134328358208,0.8874626865671642,0.018805970149253733
2016,TEXAS,JACKSON,904,132,4266,5302,0.17050169747265184,0.8046020369671822,0.024896265560165973
2016,TEXAS,JASPER,2590,220,10609,13419,0.19300991131977047,0.7905954243982413,0.016394664281988224
2016,TEXAS,JEFF DAVIS,422,74,695,1191,0.35432409739714527,0.5835432409739715,0.06213266162888329
2016,TEXAS,JEFFERSON,42443,2313,42862,87618,0.4844095962016937,0.4891917185966354,0.02639868520167089
2016,TEXAS,JIM HOGG,1635,54,430,2119,0.7715903728173666,0.20292590844738084,0.025483718735252476
2016,TEXAS,JIM WELLS,6694,265,5420,12379,0.5407545035947976,0.43783827449713225,0.02140722190807012
2016,TEXAS,JOHNSON,10988,2236,44382,57606,0.19074401972016805,0.7704405791063431,0.038815401173488875
2016,TEXAS,JONES,936,205,4819,5960,0.15704697986577182,0.8085570469798657,0.034395973154362415
2016,TEXAS,KARNES,1145,88,2965,4198,0.27274892806098144,0.7062887089090043,0.02096236303001429
2016,TEXAS,KAUFMAN,10278,1400,29587,41265,0.2490730643402399,0.7169998788319399,0.033927056827820185
2016,TEXAS,KENDALL,3643,777,15700,20120,0.18106361829025844,0.7803180914512923,0.0386182902584493
2016,TEXAS,KENEDY,99,3,84,186,0.532258064516129,0.45161290322580644,0.016129032258064516
2016,TEXAS,KENT,59,15,360,434,0.1359447004608295,0.8294930875576036,0.03456221198156682
2016,TEXAS,KERR,4681,889,17727,23297,0.20092715800317637,0.7609134223290552,0.03815941966776838
2016,TEXAS,KIMBLE,206,49,1697,1952,0.10553278688524591,0.8693647540983607,0.025102459016393443
2016,TEXAS,KING,5,5,149,159,0.031446540880503145,0.9371069182389937,0.031446540880503145
2016,TEXAS,KINNEY,458,36,936,1430,0.3202797202797203,0.6545454545454545,0.025174825174825177
2016,TEXAS,KLEBERG,4716,429,4367,9512,0.49579478553406225,0.45910428931875524,0.04510092514718251
2016,TEXAS,KNOX,247,42,1078,1367,0.18068763716166789,0.7885881492318947,0.030724213606437453
2016,TEXAS,LA SALLE,1129,58,872,2059,0.5483244293346284,0.4235065565808645,0.028169014084507043
2016,TEXAS,LAMAR,3583,467,14561,18611,0.19252055236150664,0.7823867605179733,0.025092687120520124
2016,TEXAS,LAMB,771,113,3111,3995,0.19299123904881102,0.7787234042553192,0.02828535669586984
2016,TEXAS,LAMPASAS,1483,337,6385,8205,0.18074344911639245,0.7781840341255332,0.04107251675807434
2016,TEXAS,LAVACA,1170,144,7347,8661,0.13508832698302736,0.8482854173882923,0.01662625562868029
2016,TEXAS,LEE,1372,166,4997,6535,0.20994644223412395,0.7646518745218056,0.02540168324407039
2016,TEXAS,LEON,909,139,6391,7439,0.1221938432585025,0.859120849576556,0.018685307164941524
2016,TEXAS,LIBERTY,4862,513,18892,24267,0.200354390736391,0.7785057897556352,0.021139819507973792
2016,TEXAS,LIMESTONE,1778,165,5796,7739,0.22974544514795192,0.7489339707972607,0.02132058405478744
2016,TEXAS,LIPSCOMB,135,38,1159,1332,0.10135135135135136,0.8701201201201201,0.028528528528528527
2016,TEXAS,LIVE OAK,742,96,3464,4302,0.1724779172477917,0.805206880520688,0.022315202231520222
2016,TEXAS,LLANO,1825,323,8299,10447,0.17469129893749402,0.7943907341820619,0.030917966880444146
2016,TEXAS,LOVING,4,3,58,65,0.06153846153846154,0.8923076923076924,0.046153846153846156
2016,TEXAS,LUBBOCK,28023,5339,65651,99013,0.2830234413662852,0.6630543463989577,0.05392221223475705
2016,TEXAS,LYNN,403,60,1546,2009,0.20059731209556994,0.7695370831259333,0.029865604778496764
2016,TEXAS,MADISON,881,57,3351,4289,0.2054091862905106,0.7813010025647004,0.013289811144788995
2016,TEXAS,MARION,1165,90,2983,4238,0.2748938178386031,0.7038697498820198,0.021236432279377066
2016,TEXAS,MARTIN,266,41,1455,1762,0.15096481271282633,0.825766174801362,0.023269012485811577
2016,TEXAS,MASON,354,47,1656,2057,0.17209528439474964,0.8050559066601848,0.022848808945065628
2016,TEXAS,MATAGORDA,3500,330,8366,12196,0.2869793374877009,0.6859626106920301,0.02705805182026894
2016,TEXAS,MAVERICK,10397,375,2816,13588,0.7651604356785399,0.2072416838386812,0.027597880482778923
2016,TEXAS,MCCULLOCH,482,69,2552,3103,0.15533354817918144,0.822429906542056,0.02223654527876249
2016,TEXAS,MCLENNAN,27063,3752,48260,79075,0.3422447043945621,0.610306670882074,0.0474486247233639
2016,TEXAS,MCMULLEN,40,5,454,499,0.08016032064128256,0.9098196392785571,0.01002004008016032
2016,TEXAS,MEDINA,4634,527,12085,17246,0.268699988403108,0.7007422010901079,0.030557810506784182
2016,TEXAS,MENARD,154,28,682,864,0.17824074074074073,0.7893518518518519,0.032407407407407406
2016,TEXAS,MIDLAND,10025,2214,36973,49212,0.20371047711940177,0.7513004958140291,0.044989027066569126
2016,TEXAS,MILAM,2051,249,6364,8664,0.23672668513388734,0.734533702677747,0.02873961218836565
2016,TEXAS,MILLS,243,51,1951,2245,0.10824053452115813,0.8690423162583519,0.02271714922048998
2016,TEXAS,MITCHELL,354,62,1780,2196,0.16120218579234974,0.8105646630236795,0.028233151183970857
2016,TEXAS,MONTAGUE,885,193,7526,8604,0.10285913528591353,0.8747094374709438,0.022431427243142725
2016,TEXAS,MONTGOMERY,45835,8483,150314,204632,0.22398745064310568,0.7345576449431174,0.04145490441377692
2016,TEXAS,MOORE,1098,209,3977,5284,0.2077971233913702,0.7526495079485238,0.03955336866010598
2016,TEXAS,MORRIS,1425,102,3446,4973,0.2865473557208928,0.6929418861854012,0.020510758093706012
2016,TEXAS,MOTLEY,40,9,566,615,0.06504065040650407,0.9203252032520325,0.014634146341463415
2016,TEXAS,NACOGDOCHES,6846,1005,14771,22622,0.3026257625320484,0.6529484572540005,0.04442578021395102
2016,TEXAS,NAVARRO,4002,437,11994,16433,0.24353435160956613,0.7298728168928376,0.026592831497596302
2016,TEXAS,NEWTON,1156,90,4288,5534,0.20889049512106975,0.7748464040477051,0.016263100831225154
2016,TEXAS,NOLAN,1029,276,3552,4857,0.2118591723285979,0.7313156269302038,0.05682520074119827
2016,TEXAS,NUECES,49198,4441,50766,104405,0.4712226425937455,0.48624108040802644,0.042536276998228054
2016,TEXAS,OCHILTREE,274,100,2628,3002,0.09127248500999334,0.8754163890739507,0.033311125916055964
2016,TEXAS,OLDHAM,78,20,850,948,0.08227848101265822,0.8966244725738397,0.02109704641350211
2016,TEXAS,ORANGE,5735,752,25513,32000,0.17921875,0.79728125,0.0235
2016,TEXAS,PALO PINTO,1708,278,8284,10270,0.16630963972736124,0.8066212268743914,0.027069133398247323
2016,TEXAS,PANOLA,1835,136,8445,10416,0.17617127496159754,0.8107718894009217,0.013056835637480798
2016,TEXAS,PARKER,8344,2000,46473,56817,0.14685745463505642,0.8179418131897144,0.035200732175229246
2016,TEXAS,PARMER,485,66,1915,2466,0.19667477696674776,0.7765612327656123,0.0267639902676399
2016,TEXAS,PECOS,1554,163,2468,4185,0.37132616487455194,0.5897252090800478,0.03894862604540024
2016,TEXAS,POLK,4187,489,15176,19852,0.2109107394720935,0.764456981664316,0.02463227886359057
2016,TEXAS,POTTER,7657,1364,19630,28651,0.2672507067816132,0.6851418798645772,0.04760741335380964
2016,TEXAS,PRESIDIO,1458,98,652,2208,0.6603260869565217,0.29528985507246375,0.044384057971014496
2016,TEXAS,RAINS,628,105,3968,4701,0.133588598170602,0.8440757285683897,0.022335673261008295
2016,TEXAS,RANDALL,8367,2476,43462,54305,0.15407421047785655,0.8003314611914188,0.04559432833072461
2016,TEXAS,REAGAN,167,28,709,904,0.1847345132743363,0.7842920353982301,0.030973451327433628
2016,TEXAS,REAL,262,37,1382,1681,0.15585960737656157,0.8221296847114813,0.022010707911957167
2016,TEXAS,RED RIVER,1149,86,3926,5161,0.22263127300910676,0.760705289672544,0.016663437318349156
2016,TEXAS,REEVES,1659,108,1417,3184,0.5210427135678392,0.44503768844221103,0.03391959798994975
2016,TEXAS,REFUGIO,1034,84,1830,2948,0.35074626865671643,0.6207598371777476,0.028493894165535955
2016,TEXAS,ROBERTS,20,10,524,554,0.036101083032490974,0.9458483754512635,0.018050541516245487
2016,TEXAS,ROBERTSON,2203,164,4668,7035,0.3131485429992893,0.6635394456289979,0.023312011371712866
2016,TEXAS,ROCKWALL,9655,1842,28451,39948,0.24168919595474117,0.7122008611194552,0.046109942925803546
2016,TEXAS,RUNNELS,453,79,3250,3782,0.1197778952934955,0.8593336858804865,0.02088841882601798
2016,TEXAS,RUSK,3935,384,14675,18994,0.20717068547962514,0.7726124039170265,0.020216910603348424
2016,TEXAS,SABINE,614,39,3998,4651,0.13201462051171792,0.8596000860030101,0.008385293485271984
2016,TEXAS,SAN AUGUSTINE,910,37,2622,3569,0.25497338189969176,0.7346595685065844,0.010367049593723731
2016,TEXAS,SAN JACINTO,2038,246,8059,10343,0.19704147732766122,0.779174320796674,0.023784201875664702
2016,TEXAS,SAN PATRICIO,7871,755,13030,21656,0.3634558551902475,0.6016808274843,0.03486331732545253
2016,TEXAS,SAN SABA,293,39,2025,2357,0.12431056427662282,0.859142978362325,0.016546457361052185
2016,TEXAS,SCHLEICHER,208,30,821,1059,0.1964117091595845,0.7752596789423984,0.028328611898016998
2016,TEXAS,SCURRY,733,146,4410,5289,0.13858952543013803,0.8338060124787294,0.02760446209113254
2016,TEXAS,SHACKELFORD,103,23,1378,1504,0.06848404255319149,0.9162234042553191,0.015292553191489361
2016,TEXAS,SHELBY,1758,149,7179,9086,0.19348448162007484,0.790116662998019,0.01639885538190623
2016,TEXAS,SHERMAN,96,32,807,935,0.10267379679144385,0.8631016042780749,0.034224598930481284
2016,TEXAS,SMITH,22300,3538,58930,84768,0.2630709701774254,0.6951915817289543,0.04173744809362023
2016,TEXAS,SOMERVELL,541,150,3206,3897,0.1388247369771619,0.8226841159866564,0.03849114703618168
2016,TEXAS,STARR,9289,227,2224,11740,0.7912265758091993,0.18943781942078364,0.019335604770017036
2016,TEXAS,STEPHENS,348,79,3034,3461,0.10054897428488876,0.8766252528171049,0.022825772898006358
2016,TEXAS,STERLING,70,14,549,633,0.11058451816745656,0.8672985781990521,0.022116903633491312
2016,TEXAS,STONEWALL,135,11,555,701,0.19258202567760344,0.7917261055634808,0.015691868758915834
2016,TEXAS,SUTTON,313,28,1075,1416,0.221045197740113,0.759180790960452,0.01977401129943503
2016,TEXAS,SWISHER,462,71,1671,2204,0.20961887477313976,0.7581669691470054,0.03221415607985481
2016,TEXAS,TARRANT,288392,34201,345921,668514,0.431392611074712,0.5174476525547708,0.051159736370517295
2016,TEXAS,TAYLOR,10085,2424,33250,45759,0.22039380231211347,0.7266330120850543,0.05297318560283223
2016,TEXAS,TERRELL,140,10,288,438,0.319634703196347,0.6575342465753424,0.0228310502283105
2016,TEXAS,TERRY,753,143,2459,3355,0.22444113263785395,0.7329359165424739,0.04262295081967213
2016,TEXAS,THROCKMORTON,84,9,715,808,0.10396039603960396,0.8849009900990099,0.011138613861386138
2016,TEXAS,TITUS,2597,311,6511,9419,0.2757192907952012,0.6912623420745302,0.03301836713026861
2016,TEXAS,TOM GREEN,9173,1812,27494,38479,0.23838977104394604,0.7145196080979236,0.04709062085813041
2016,TEXAS,TRAVIS,308260,33251,127209,468720,0.657663423792456,0.2713965693804403,0.07094000682710361
2016,TEXAS,TRINITY,1154,94,4737,5985,0.1928153717627402,0.7914786967418547,0.015705931495405178
2016,TEXAS,TYLER,1248,144,6624,8016,0.15568862275449102,0.8263473053892215,0.017964071856287425
2016,TEXAS,UPSHUR,2380,424,13209,16013,0.14862923874352088,0.8248922750265409,0.026478486229938175
2016,TEXAS,UPTON,286,54,1007,1347,0.21232368225686712,0.7475872308834447,0.0400890868596882
2016,TEXAS,UVALDE,3867,262,4835,8964,0.43139223560910306,0.5393797411869701,0.02922802320392682
2016,TEXAS,VAL VERDE,6964,763,5890,13617,0.5114195490930454,0.4325475508555482,0.05603290005140633
2016,TEXAS,VAN ZANDT,2799,618,18473,21890,0.127866605756053,0.8439013248058475,0.02823206943809959
2016,TEXAS,VICTORIA,8866,982,21275,31123,0.2848697105034862,0.6835780612408829,0.031552228255630886
2016,TEXAS,WALKER,6091,821,12884,19796,0.30768842190341483,0.6508385532430794,0.041473024853505756
2016,TEXAS,WALLER,5748,505,10531,16784,0.3424690181124881,0.6274428026692088,0.030088179218303146
2016,TEXAS,WARD,783,115,2547,3445,0.22728592162554426,0.7393323657474601,0.033381712626995644
2016,TEXAS,WASHINGTON,3382,501,10945,14828,0.22808200701375775,0.7381305637982196,0.03378742918802266
2016,TEXAS,WEBB,42307,1651,12947,56905,0.7434671821456814,0.22751955012740532,0.029013267726913275
2016,TEXAS,WHARTON,4238,345,10149,14732,0.28767309258756446,0.6889084985066521,0.02341840890578333
2016,TEXAS,WHEELER,194,25,2087,2306,0.08412836079791847,0.9050303555941024,0.010841283607979185
2016,TEXAS,WICHITA,8770,1718,27631,38119,0.23006899446470264,0.7248616175660432,0.04506938796925418
2016,TEXAS,WILBARGER,809,130,3166,4105,0.19707673568818515,0.7712545676004872,0.031668696711327646
2016,TEXAS,WILLACY,3422,126,1547,5095,0.6716388616290481,0.30363101079489696,0.024730127576054955
2016,TEXAS,WILLIAMSON,84468,14438,104175,203081,0.41593255892968817,0.512972656230765,0.07109478483954679
2016,TEXAS,WILSON,4790,644,13998,19432,0.2465006175380815,0.7203581720872787,0.03314121037463977
2016,TEXAS,WINKLER,420,53,1403,1876,0.22388059701492538,0.747867803837953,0.028251599147121536
2016,TEXAS,WISE,3412,694,20670,24776,0.13771391669357444,0.8342751049402648,0.028010978366160802
2016,TEXAS,WOOD,2630,397,15700,18727,0.1404389384311422,0.8383617237144231,0.02119933785443477
2016,TEXAS,YOAKUM,426,80,1797,2303,0.1849761181068172,0.7802865827181936,0.03473729917498915
2016,TEXAS,YOUNG,876,230,6601,7707,0.11366290385363954,0.8564940962761126,0.029842999870247827
2016,TEXAS,ZAPATA,2063,50,1029,3142,0.6565881604073839,0.32749840865690644,0.015913430935709738
2016,TEXAS,ZAVALA,2636,66,694,3396,0.7762073027090695,0.2043580683156655,0.019434628975265017
2016,UTAH,BEAVER,264,389,1838,2491,0.10598153352067442,0.7378562826174228,0.15616218386190284
2016,UTAH,BOX ELDER,2282,5223,12230,19735,0.11563212566506208,0.6197111730428173,0.2646567012921206
2016,UTAH,CACHE,8563,16455,21139,46157,0.18551898953571505,0.45798037134129166,0.35650063912299323
2016,UTAH,CARBON,1717,960,5275,7952,0.215920523138833,0.6633551307847082,0.12072434607645875
2016,UTAH,DAGGETT,77,66,331,474,0.16244725738396623,0.6983122362869199,0.13924050632911392
2016,UTAH,DAVIS,28776,47416,62219,138411,0.20790255109781736,0.44952352052943767,0.3425739283727449
2016,UTAH,DUCHESNE,500,934,5508,6942,0.07202535292422933,0.7934312878133103,0.1345433592624604
2016,UTAH,EMERY,380,484,3425,4289,0.08859874096525996,0.7985544415947773,0.1128468174399627
2016,UTAH,GARFIELD,358,380,1606,2344,0.15273037542662116,0.6851535836177475,0.1621160409556314
2016,UTAH,GRAND,1960,598,1975,4533,0.43238473417163026,0.4356938010147805,0.13192146481358924
2016,UTAH,IRON,2450,3643,11561,17654,0.1387787470261697,0.6548657528038971,0.20635550016993315
2016,UTAH,JUAB,442,908,2827,4177,0.10581757242039741,0.6768015322001436,0.21738089537945895
2016,UTAH,KANE,741,499,2265,3505,0.21141226818830242,0.6462196861626248,0.14236804564907277
2016,UTAH,MILLARD,431,951,3860,5242,0.08222052651659671,0.7363601678748569,0.18141930560854636
2016,UTAH,MORGAN,577,1427,3188,5192,0.11113251155624038,0.6140215716486903,0.2748459167950693
2016,UTAH,PIUTE,47,56,626,729,0.0644718792866941,0.8587105624142661,0.07681755829903979
2016,UTAH,RICH,104,208,797,1109,0.09377817853922453,0.7186654643823264,0.18755635707844906
2016,UTAH,SALT LAKE,175863,104962,138043,418868,0.4198530324589131,0.32956205773656616,0.25058490980452075
2016,UTAH,SAN JUAN,2042,760,2645,5447,0.37488525794015054,0.48558839728290804,0.13952634477694142
2016,UTAH,SANPETE,1061,2430,6673,10164,0.10438803620621802,0.6565328610783157,0.23907910271546634
2016,UTAH,SEVIER,695,1219,6740,8654,0.08030968338340652,0.7788305985671365,0.1408597180494569
2016,UTAH,SUMMIT,10503,2805,7333,20641,0.5088416258902185,0.355263795358752,0.1358945787510295
2016,UTAH,TOOELE,4573,6087,11169,21829,0.2094919602363828,0.511658802510422,0.27884923725319527
2016,UTAH,UINTAH,995,1992,9810,12797,0.07775259826521841,0.766585918574666,0.15566148316011566
2016,UTAH,UTAH,28522,70847,102182,201551,0.1415125700194988,0.5069783826426066,0.3515090473378946
2016,UTAH,WASATCH,3063,2942,6115,12120,0.2527227722772277,0.5045379537953796,0.24273927392739275
2016,UTAH,WASHINGTON,10288,9025,42650,61963,0.166034569016994,0.6883139938350306,0.1456514371479754
2016,UTAH,WAYNE,271,184,966,1421,0.19071076706544687,0.6798029556650246,0.1294862772695285
2016,UTAH,WEBER,23131,21673,40235,85039,0.27200460964969014,0.47313585531344443,0.2548595350368654
2016,VERMONT,ADDISON,11219,2515,5297,19031,0.5895118490883295,0.27833534759077294,0.1321528033208975
2016,VERMONT,BENNINGTON,9539,1917,5925,17381,0.5488176744721247,0.34088947701513145,0.1102928485127438
2016,VERMONT,CALEDONIA,6445,2096,5534,14075,0.45790408525754883,0.39317939609236235,0.1489165186500888
2016,VERMONT,CHITTENDEN,54814,10003,18601,83418,0.6571003860078161,0.22298544678606536,0.11991416720611858
2016,VERMONT,ESSEX,1019,400,1506,2925,0.3483760683760684,0.5148717948717949,0.13675213675213677
2016,VERMONT,FRANKLIN,9351,3308,8752,21411,0.43673812526271544,0.4087618513848022,0.15450002335248236
2016,VERMONT,GRAND ISLE,2094,529,1487,4110,0.5094890510948905,0.36180048661800485,0.12871046228710462
2016,VERMONT,LAMOILLE,7241,1951,3570,12762,0.5673875568092775,0.27973671838269865,0.15287572480802383
2016,VERMONT,ORANGE,7541,2101,5007,14649,0.5147791658133661,0.3417980749539218,0.14342275923271214
2016,VERMONT,ORLEANS,5185,1703,5159,12047,0.430397609363327,0.42823939570017433,0.1413629949364987
2016,VERMONT,RUTLAND,13635,3505,12479,29619,0.4603463992707384,0.42131739761639486,0.11833620311286674
2016,VERMONT,WASHINGTON,18594,4499,7993,31086,0.5981470758540822,0.2571253940680692,0.14472753007784855
2016,VERMONT,WINDHAM,14340,2841,5454,22635,0.633532140490391,0.24095427435387673,0.12551358515573227
2016,VERMONT,WINDSOR,17556,3767,8605,29928,0.5866078588612671,0.28752338946805667,0.1258687516706763
2016,VIRGINIA,ACCOMACK,6740,495,8583,15818,0.4260968516879504,0.542609685168795,0.03129346314325452
2016,VIRGINIA,ALBEMARLE,33345,4122,19259,56726,0.587825688396855,0.3395092197581356,0.07266509184500934
2016,VIRGINIA,ALEXANDRIA,57242,5243,13285,75770,0.7554705028375347,0.17533324534776296,0.06919625181470239
2016,VIRGINIA,ALLEGHANY,2166,285,4874,7325,0.2956996587030717,0.6653924914675768,0.03890784982935153
2016,VIRGINIA,AMELIA,2128,204,4708,7040,0.30227272727272725,0.66875,0.028977272727272727
2016,VIRGINIA,AMHERST,5057,620,9719,15396,0.32846193816575736,0.6312678617822811,0.040270200051961545
2016,VIRGINIA,APPOMATTOX,2023,273,5715,8011,0.2525277743103233,0.7133940831356884,0.034078142553988264
2016,VIRGINIA,ARLINGTON,92016,9154,20186,121356,0.7582319786413527,0.16633705791225814,0.07543096344638914
2016,VIRGINIA,AUGUSTA,8177,2003,26163,36343,0.22499518476735547,0.7198910381641581,0.055113777068486365
2016,VIRGINIA,BATH,603,102,1548,2253,0.26764314247669774,0.6870838881491345,0.045272969374167776
2016,VIRGINIA,BEDFORD,9768,2098,30659,42525,0.22970017636684303,0.7209641387419166,0.04933568489124045
2016,VIRGINIA,BLAND,453,113,2573,3139,0.14431347562918126,0.8196877986619943,0.03599872570882447
2016,VIRGINIA,BOTETOURT,4494,870,13375,18739,0.23982069480762047,0.7137520678798228,0.0464272373125567
2016,VIRGINIA,BRISTOL,1835,305,4892,7032,0.2609499431171786,0.6956769055745164,0.043373151308304894
2016,VIRGINIA,BRUNSWICK,4481,142,3046,7669,0.5843004303038206,0.3971834659016821,0.018516103794497328
2016,VIRGINIA,BUCHANAN,1721,230,7296,9247,0.1861144154861036,0.789012652752244,0.02487293176165243
2016,VIRGINIA,BUCKINGHAM,3128,217,3950,7295,0.42878684030157643,0.5414667580534612,0.029746401644962304
2016,VIRGINIA,BUENA VISTA,693,284,1430,2407,0.28791026173660156,0.5941005400914001,0.11798919817199834
2016,VIRGINIA,CAMPBELL,6664,1320,19551,27535,0.24201924822952606,0.7100417650263301,0.04793898674414382
2016,VIRGINIA,CAROLINE,6432,1284,7147,14863,0.43275247258292404,0.48085850770369376,0.08638901971338223
2016,VIRGINIA,CARROLL,2559,446,10663,13668,0.18722563652326601,0.7801434006438396,0.03263096283289435
2016,VIRGINIA,CHARLES CITY,2496,135,1476,4107,0.6077428780131483,0.3593864134404675,0.03287070854638422
2016,VIRGINIA,CHARLOTTE,2155,174,3479,5808,0.3710399449035813,0.5990013774104683,0.029958677685950414
2016,VIRGINIA,CHARLOTTESVILLE,17901,1611,2960,22472,0.7965913136347454,0.13171947312210752,0.07168921324314703
2016,VIRGINIA,CHESAPEAKE,52627,6031,54047,112705,0.4669446785856883,0.47954394214986024,0.053511379264451445
2016,VIRGINIA,CHESTERFIELD,81074,10342,85045,176461,0.4594442964734417,0.48194785249998584,0.05860785102657244
2016,VIRGINIA,CLARKE,3051,501,4661,8213,0.37148423231462313,0.5675149153780592,0.061000852307317666
2016,VIRGINIA,COLONIAL HEIGHTS,2367,409,5681,8457,0.2798864845689961,0.6717512120137165,0.04836230341728746
2016,VIRGINIA,COVINGTON,914,119,1349,2382,0.38371116708648195,0.5663308144416457,0.049958018471872374
2016,VIRGINIA,CRAIG,541,113,2140,2794,0.19362920544022907,0.7659269863994274,0.04044380816034359
2016,VIRGINIA,CULPEPER,7759,1110,13349,22218,0.3492213520568908,0.6008191556395716,0.049959492303537675
2016,VIRGINIA,CUMBERLAND,2036,173,2697,4906,0.415002038320424,0.5497350183448838,0.035262943334692216
2016,VIRGINIA,DANVILLE,11059,590,7303,18952,0.5835268045588856,0.3853419164204306,0.031131279020683834
2016,VIRGINIA,DICKENSON,1335,173,4932,6440,0.20729813664596272,0.7658385093167702,0.02686335403726708
2016,VIRGINIA,DINWIDDIE,5765,363,7447,13575,0.42467771639042357,0.5485819521178638,0.026740331491712708
2016,VIRGINIA,EMPORIA,1530,48,789,2367,0.6463878326996197,0.3333333333333333,0.020278833967046894
2016,VIRGINIA,ESSEX,2542,209,2657,5408,0.47004437869822485,0.49130917159763315,0.038646449704142015
2016,VIRGINIA,FAIRFAX,362500,39301,161412,563213,0.6436286094248534,0.28659139615030194,0.0697799944248446
2016,VIRGINIA,FALLS CHURCH,5819,614,1324,7757,0.7501611447724635,0.17068454299342528,0.07915431223411112
2016,VIRGINIA,FAUQUIER,12971,2369,22127,37467,0.34619798756238823,0.590573037606427,0.06322897483118478
2016,VIRGINIA,FLOYD,2300,458,5293,8051,0.28567879766488635,0.657433859147932,0.056887343187181715
2016,VIRGINIA,FLUVANNA,5760,812,7025,13597,0.4236228579833787,0.5166580863425756,0.05971905567404574
2016,VIRGINIA,FRANKLIN,9776,1275,19990,31041,0.3149383073998905,0.6439869849553816,0.04107470764472794
2016,VIRGINIA,FREDERICK,11932,2425,26083,40440,0.2950544015825915,0.6449802176063304,0.05996538081107814
2016,VIRGINIA,FREDERICKSBURG,6707,813,3744,11264,0.5954367897727273,0.33238636363636365,0.07217684659090909
2016,VIRGINIA,GALAX,681,92,1603,2376,0.2866161616161616,0.6746632996632996,0.03872053872053872
2016,VIRGINIA,GILES,1950,352,5910,8212,0.23745737944471504,0.7196785192401364,0.04286410131514856
2016,VIRGINIA,GLOUCESTER,5404,1119,13096,19619,0.27544727050308376,0.667516183291707,0.05703654620520924
2016,VIRGINIA,GOOCHLAND,4889,764,8384,14037,0.3482937949704353,0.5972786207879176,0.05442758424164708
2016,VIRGINIA,GRAYSON,1407,286,5592,7285,0.1931365820178449,0.7676046671242278,0.039258750857927245
2016,VIRGINIA,GREENE,2924,739,5945,9608,0.30432972522897583,0.6187552039966694,0.07691507077435471
2016,VIRGINIA,GREENSVILLE,2558,68,1737,4363,0.5862938345175338,0.3981205592482237,0.015585606234242494
2016,VIRGINIA,HALIFAX,6897,400,9704,17001,0.4056820187047821,0.5707899535321451,0.02352802776307276
2016,VIRGINIA,HAMPTON,41312,3142,17902,62356,0.6625184424915004,0.2870934633395343,0.050388094168965294
2016,VIRGINIA,HANOVER,19382,3741,39630,62753,0.3088617277261645,0.6315235924975698,0.059614679776265674
2016,VIRGINIA,HARRISONBURG,10212,1519,6262,17993,0.5675540487967543,0.34802423164563995,0.08442171955760573
2016,VIRGINIA,HENRICO,93935,9862,59857,163654,0.5739853593557139,0.3657533576936708,0.06026128295061532
2016,VIRGINIA,HENRY,8198,700,15208,24106,0.34008130755828425,0.6308802787687713,0.029038413672944494
2016,VIRGINIA,HIGHLAND,371,62,958,1391,0.26671459381739754,0.6887131560028756,0.04457225017972682
2016,VIRGINIA,HOPEWELL,4724,399,3885,9008,0.5244227353463587,0.4312833037300178,0.04429396092362345
2016,VIRGINIA,ISLE OF WIGHT,7881,990,12204,21075,0.37395017793594304,0.5790747330960854,0.04697508896797153
2016,VIRGINIA,JAMES CITY,19105,2762,21306,43173,0.44252194658698724,0.4935028837467862,0.06397516966622657
2016,VIRGINIA,KING AND QUEEN,1468,130,2099,3697,0.39707871246956994,0.5677576413308087,0.03516364619962131
2016,VIRGINIA,KING GEORGE,4007,711,7341,12059,0.33228294220084587,0.6087569450203167,0.058960112778837385
2016,VIRGINIA,KING WILLIAM,2760,426,5975,9161,0.3012771531492195,0.6522213732125314,0.0465014736382491
2016,VIRGINIA,LANCASTER,2869,253,3523,6645,0.43175319789315275,0.5301730624529721,0.038073739653875095
2016,VIRGINIA,LEE,1627,229,7543,9399,0.1731035216512395,0.8025321842749229,0.024364294073837642
2016,VIRGINIA,LEXINGTON,1514,185,766,2465,0.6141987829614605,0.3107505070993915,0.07505070993914807
2016,VIRGINIA,LOUDOUN,100795,12353,69949,183097,0.5505005543509724,0.3820324745899714,0.06746697105905614
2016,VIRGINIA,LOUISA,6212,891,10528,17631,0.35233395723441663,0.5971300550167319,0.05053598774885146
2016,VIRGINIA,LUNENBURG,2227,155,3204,5586,0.3986752595775152,0.5735767991407089,0.027747941281775868
2016,VIRGINIA,LYNCHBURG,14792,2897,17982,35671,0.41467859045162736,0.5041069776569201,0.08121443189145244
2016,VIRGINIA,MADISON,2203,357,4419,6979,0.3156612695228543,0.6331852700960023,0.05115346038114343
2016,VIRGINIA,MANASSAS,8423,1035,5953,15411,0.5465576536240347,0.38628252546882097,0.06715982090714424
2016,VIRGINIA,MANASSAS PARK,3204,295,1733,5232,0.6123853211009175,0.3312308868501529,0.05638379204892966
2016,VIRGINIA,MARTINSVILLE,3533,225,2149,5907,0.5981039444726596,0.3638056543084476,0.03809040121889284
2016,VIRGINIA,MATHEWS,1563,231,3517,5311,0.29429485972509883,0.6622105064959518,0.04349463377894935
2016,VIRGINIA,MECKLENBURG,6285,372,8288,14945,0.420541987286718,0.5545667447306791,0.024891267982602876
2016,VIRGINIA,MIDDLESEX,2108,239,3670,6017,0.35034070134618583,0.6099385075619079,0.039720791091906266
2016,VIRGINIA,MONTGOMERY,20021,3551,19459,43031,0.4652692245125607,0.4522088726731891,0.08252190281425019
2016,VIRGINIA,NELSON,3689,475,4154,8318,0.4434960327001683,0.4993988939648954,0.05710507333493628
2016,VIRGINIA,NEW KENT,3546,578,8118,12242,0.2896585525240974,0.6631269400424767,0.04721450743342591
2016,VIRGINIA,NEWPORT NEWS,45618,4629,25468,75715,0.6024962028660107,0.3363666380505844,0.06113715908340488
2016,VIRGINIA,NORFOLK,57023,4813,21552,83388,0.683827409219552,0.2584544538782559,0.057718136902192164
2016,VIRGINIA,NORTHAMPTON,3255,231,2686,6172,0.5273817239144524,0.4351911860012962,0.037427090084251456
2016,VIRGINIA,NORTHUMBERLAND,2852,244,4302,7398,0.3855095971884293,0.5815085158150851,0.032981886996485535
2016,VIRGINIA,NORTON,383,56,1021,1460,0.2623287671232877,0.6993150684931507,0.038356164383561646
2016,VIRGINIA,NOTTOWAY,2829,203,3712,6744,0.4194839857651246,0.5504151838671412,0.030100830367734283
2016,VIRGINIA,ORANGE,5957,792,10521,17270,0.34493341053850607,0.6092067168500289,0.045859872611464965
2016,VIRGINIA,PAGE,2514,395,7831,10740,0.2340782122905028,0.7291433891992551,0.03677839851024209
2016,VIRGINIA,PATRICK,1768,303,6454,8525,0.2073900293255132,0.7570674486803519,0.0355425219941349
2016,VIRGINIA,PETERSBURG,12021,314,1451,13786,0.8719715653561584,0.10525170462788336,0.02277673001595822
2016,VIRGINIA,PITTSYLVANIA,9199,845,21554,31598,0.29112602063421733,0.6821317804924363,0.026742198873346414
2016,VIRGINIA,POQUOSON,1601,484,5092,7177,0.2230737076773025,0.70948864428034,0.06743764804235754
2016,VIRGINIA,PORTSMOUTH,28497,1973,12795,43265,0.6586617358141685,0.29573558303478564,0.04560268115104588
2016,VIRGINIA,POWHATAN,4060,955,11885,16900,0.24023668639053256,0.7032544378698224,0.05650887573964497
2016,VIRGINIA,PRINCE EDWARD,4591,451,4101,9143,0.5021327791753254,0.44853986656458494,0.04932735426008968
2016,VIRGINIA,PRINCE GEORGE,6419,608,9157,16184,0.39662629757785467,0.5658057340583292,0.037567968363816116
2016,VIRGINIA,PRINCE WILLIAM,113144,11673,71721,196538,0.5756851092409611,0.36492179629384647,0.05939309446519248
2016,VIRGINIA,PULASKI,4172,673,10322,15167,0.2750708775631305,0.6805564712863453,0.04437265115052416
2016,VIRGINIA,RADFORD,2925,522,2638,6085,0.4806902218570255,0.43352506162695154,0.08578471651602301
2016,VIRGINIA,RAPPAHANNOCK,1747,197,2539,4483,0.38969440107071157,0.5663618112870845,0.04394378764220388
2016,VIRGINIA,RICHMOND,82606,6745,17794,107145,0.7709739138550562,0.16607401185309628,0.0629520742918475
2016,VIRGINIA,ROANOKE,39486,5272,46197,90955,0.4341267659831785,0.5079105051948766,0.05796272882194492
2016,VIRGINIA,ROCKBRIDGE,3508,607,6680,10795,0.32496526169522927,0.618805002315887,0.05622973598888374
2016,VIRGINIA,ROCKINGHAM,9366,2131,25990,37487,0.24984661349267745,0.6933070130978739,0.056846373409448606
2016,VIRGINIA,RUSSELL,2330,395,9521,12246,0.19026620937448963,0.777478360280908,0.03225543034460232
2016,VIRGINIA,SALEM,4202,797,7226,12225,0.34372188139059306,0.5910838445807771,0.06519427402862986
2016,VIRGINIA,SCOTT,1581,272,8247,10100,0.15653465346534653,0.8165346534653465,0.02693069306930693
2016,VIRGINIA,SHENANDOAH,5273,1146,14094,20513,0.25705650075561837,0.6870764880807293,0.055867011163652315
2016,VIRGINIA,SMYTH,2665,475,9750,12890,0.20674941815360745,0.756400310318076,0.036850271528316526
2016,VIRGINIA,SOUTHAMPTON,3595,248,5035,8878,0.40493354359089884,0.5671322369903131,0.027934219418788014
2016,VIRGINIA,SPOTSYLVANIA,24207,3732,34623,62562,0.38692816725808,0.553419008343723,0.05965282439819699
2016,VIRGINIA,STAFFORD,27908,4158,33868,65934,0.4232717566050899,0.513665180331847,0.06306306306306306
2016,VIRGINIA,STAUNTON,5333,789,5133,11255,0.47383385162150155,0.4560639715681919,0.07010217681030653
2016,VIRGINIA,SUFFOLK,23280,1954,18006,43240,0.5383903792784459,0.41641998149861237,0.04518963922294172
2016,VIRGINIA,SURRY,2272,137,1819,4228,0.5373699148533586,0.4302270577105014,0.03240302743614002
2016,VIRGINIA,SUSSEX,2879,110,2055,5044,0.5707771609833465,0.40741475019825535,0.021808088818398096
2016,VIRGINIA,TAZEWELL,2895,503,15168,18566,0.1559301949800711,0.8169772702790047,0.02709253474092427
2016,VIRGINIA,VIRGINIA BEACH,91032,14006,98224,203262,0.4478554771673997,0.4832383819897472,0.06890614084285307
2016,VIRGINIA,WARREN,5169,1018,11773,17960,0.2878062360801782,0.6555122494432071,0.0566815144766147
2016,VIRGINIA,WASHINGTON,5553,974,19320,25847,0.21484118079467637,0.747475529074941,0.037683290130382636
2016,VIRGINIA,WAYNESBORO,3764,639,4801,9204,0.40895262929161236,0.5216210343328987,0.06942633637548892
2016,VIRGINIA,WESTMORELAND,3836,290,4448,8574,0.44739911359925355,0.5187777000233263,0.03382318637742011
2016,VIRGINIA,WILLIAMSBURG,5206,495,1925,7626,0.6826645685811696,0.25242591135588777,0.06490952006294257
2016,VIRGINIA,WINCHESTER,5164,713,4790,10667,0.4841098715665135,0.4490484672353989,0.06684166119808756
2016,VIRGINIA,WISE,2701,376,12086,15163,0.1781309767196465,0.7970718195607729,0.02479720371958056
2016,VIRGINIA,WYTHE,2770,527,10046,13343,0.20759949036948214,0.7529041444952409,0.03949636513527693
2016,VIRGINIA,YORK,12999,2282,18837,34118,0.38100123102174804,0.5521132540008207,0.06688551497743127
2016,WASHINGTON,ADAMS,1299,262,3083,4644,0.2797157622739018,0.6638673557278209,0.056416881998277345
2016,WASHINGTON,ASOTIN,3134,861,5741,9736,0.32189811010682007,0.5896672144617913,0.08843467543138867
2016,WASHINGTON,BENTON,26360,6473,47194,80027,0.32938883126944657,0.5897259674859735,0.08088520124457996
2016,WASHINGTON,CHELAN,13032,2234,18114,33380,0.3904134212103056,0.5426602756141402,0.06692630317555423
2016,WASHINGTON,CLALLAM,17677,2986,18794,39457,0.44800669082798994,0.47631598955825327,0.07567731961375675
2016,WASHINGTON,CLARK,92757,14962,92441,200160,0.4634142685851319,0.4618355315747402,0.0747501998401279
2016,WASHINGTON,COLUMBIA,526,159,1497,2182,0.24106324472960586,0.6860678276810266,0.07286892758936755
2016,WASHINGTON,COWLITZ,17908,3599,24185,45692,0.39192856517552305,0.5293049111441828,0.07876652368029415
2016,WASHINGTON,DOUGLAS,4918,1022,9603,15543,0.3164125329730425,0.6178343949044586,0.06575307212249887
2016,WASHINGTON,FERRY,1098,301,2202,3601,0.304915301305193,0.6114968064426548,0.08358789225215218
2016,WASHINGTON,FRANKLIN,8886,1628,13206,23720,0.3746205733558179,0.5567453625632378,0.06863406408094436
2016,WASHINGTON,GARFIELD,279,116,851,1246,0.22391653290529695,0.6829855537720706,0.09309791332263243
2016,WASHINGTON,GRANT,7810,2018,18518,28346,0.27552388344034434,0.6532844140266705,0.07119170253298525
2016,WASHINGTON,GRAYS HARBOR,12020,2280,14067,28367,0.42373180103641556,0.4958931152395389,0.08037508372404555
2016,WASHINGTON,ISLAND,20960,3451,18465,42876,0.4888515719749977,0.43066050937587463,0.08048791864912772
2016,WASHINGTON,JEFFERSON,12656,1583,6037,20276,0.6241862300256461,0.2977411718287631,0.07807259814559085
2016,WASHINGTON,KING,718322,63838,216339,998499,0.7194018221350247,0.21666421298368851,0.06393396488128682
2016,WASHINGTON,KITSAP,63156,12143,49018,124317,0.5080238422741862,0.394298446712839,0.0976777110129749
2016,WASHINGTON,KITTITAS,7489,1366,10100,18955,0.39509364283830123,0.5328409390662094,0.07206541809548932
2016,WASHINGTON,KLICKITAT,4194,786,5789,10769,0.3894512025257684,0.537561519175411,0.0729872782988207
2016,WASHINGTON,LEWIS,9654,2503,21992,34149,0.28270227532284986,0.6440012884711119,0.07329643620603825
2016,WASHINGTON,LINCOLN,1244,361,4108,5713,0.2177489935235428,0.719061788902503,0.06318921757395414
2016,WASHINGTON,MASON,11993,2403,13677,28073,0.42720763723150357,0.48719410109357747,0.08559826167491896
2016,WASHINGTON,OKANOGAN,6298,1183,9610,17091,0.36849803990404306,0.5622842431689193,0.06921771692703763
2016,WASHINGTON,PACIFIC,4620,736,5360,10716,0.4311310190369541,0.5001866368047779,0.06868234415826802
2016,WASHINGTON,PEND OREILLE,1934,495,4373,6802,0.28432813878271096,0.6428991473096148,0.07277271390767422
2016,WASHINGTON,PIERCE,172538,29123,146824,348485,0.49510882821355295,0.42132086029527815,0.08357031149116892
2016,WASHINGTON,SAN JUAN,7172,914,2688,10774,0.6656766289214776,0.2494895117876369,0.08483385929088547
2016,WASHINGTON,SKAGIT,26690,4542,24736,55968,0.47687964551172096,0.4419668381932533,0.08115351629502573
2016,WASHINGTON,SKAMANIA,2232,479,2928,5639,0.3958148607909204,0.5192410001773364,0.08494413903174322
2016,WASHINGTON,SNOHOMISH,185227,28691,128255,342173,0.5413255867645899,0.37482501541617835,0.08384939781923179
2016,WASHINGTON,SPOKANE,93767,20044,113435,227246,0.4126233245029616,0.49917270270983866,0.08820397278719977
2016,WASHINGTON,STEVENS,5767,1749,15161,22677,0.2543105349032059,0.6685628610486396,0.07712660404815452
2016,WASHINGTON,THURSTON,68798,11988,48624,129410,0.5316281585657986,0.3757360327640831,0.09263580867011822
2016,WASHINGTON,WAHKIAKUM,832,182,1344,2358,0.35284139100932993,0.5699745547073791,0.07718405428329092
2016,WASHINGTON,WALLA WALLA,9694,2074,13651,25419,0.3813682678311499,0.5370392226287423,0.0815925095401078
2016,WASHINGTON,WHATCOM,60340,8734,40599,109673,0.5501809925870542,0.3701822691090788,0.07963673830386694
2016,WASHINGTON,WHITMAN,8146,1756,7403,17305,0.4707310026004045,0.4277954348454204,0.1014735625541751
2016,WASHINGTON,YAKIMA,31291,4724,41735,77750,0.4024565916398714,0.5367845659163987,0.0607588424437299
2016,WEST VIRGINIA,BARBOUR,1222,305,4527,6054,0.20185001651800463,0.7477700693756194,0.05037991410637595
2016,WEST VIRGINIA,BERKELEY,12321,2285,28244,42850,0.2875379229871645,0.6591365227537923,0.05332555425904317
2016,WEST VIRGINIA,BOONE,1790,389,6504,8683,0.20614994817459403,0.7490498675572959,0.0448001842681101
2016,WEST VIRGINIA,BRAXTON,1321,232,3537,5090,0.2595284872298625,0.6948919449901768,0.04557956777996071
2016,WEST VIRGINIA,BROOKE,2568,420,6625,9613,0.26713825028607097,0.6891709143867679,0.043690835327161136
2016,WEST VIRGINIA,CABELL,11447,1788,19850,33085,0.3459876076771951,0.5999697748224271,0.05404261750037782
2016,WEST VIRGINIA,CALHOUN,456,126,2035,2617,0.17424531906763469,0.7776079480320979,0.04814673290026748
2016,WEST VIRGINIA,CLAY,568,104,2300,2972,0.1911170928667564,0.7738896366083445,0.034993270524899055
2016,WEST VIRGINIA,DODDRIDGE,362,120,2358,2840,0.12746478873239436,0.8302816901408451,0.04225352112676056
2016,WEST VIRGINIA,FAYETTE,4290,690,10357,15337,0.27971572015387625,0.6752950381430527,0.044989241703071
2016,WEST VIRGINIA,GILMER,545,102,1896,2543,0.21431380259535981,0.7455760912308297,0.04011010617381046
2016,WEST VIRGINIA,GRANT,512,98,4346,4956,0.1033091202582728,0.8769168684422922,0.01977401129943503
2016,WEST VIRGINIA,GREENBRIER,3765,745,9556,14066,0.2676667140622778,0.6793686904592635,0.05296459547845869
2016,WEST VIRGINIA,HAMPSHIRE,1580,336,6692,8608,0.18355018587360594,0.7774163568773235,0.03903345724907063
2016,WEST VIRGINIA,HANCOCK,3262,531,8909,12702,0.2568099511887892,0.7013856085655802,0.04180444024563061
2016,WEST VIRGINIA,HARDY,1155,214,4274,5643,0.2046783625730994,0.7573985468722311,0.037923090554669504
2016,WEST VIRGINIA,HARRISON,7694,1516,18750,27960,0.2751788268955651,0.6706008583690987,0.05422031473533619
2016,WEST VIRGINIA,JACKSON,2663,504,9020,12187,0.21851152867809961,0.7401329285304012,0.04135554279149914
2016,WEST VIRGINIA,JEFFERSON,9518,1425,13204,24147,0.39416904791485485,0.5468174100302315,0.05901354205491365
2016,WEST VIRGINIA,KANAWHA,28263,3577,43850,75690,0.3734046769718589,0.5793367683974104,0.047258554630730615
2016,WEST VIRGINIA,LEWIS,1347,307,5274,6928,0.19442840646651272,0.7612586605080831,0.04431293302540416
2016,WEST VIRGINIA,LINCOLN,1459,300,5307,7066,0.20648174356071328,0.751061420888763,0.04245683555052363
2016,WEST VIRGINIA,LOGAN,2092,370,9897,12359,0.16926935836232704,0.8007929444129784,0.029937697224694554
2016,WEST VIRGINIA,MARION,6964,1397,14668,23029,0.30240132007468845,0.6369360371705242,0.060662642754787444
2016,WEST VIRGINIA,MARSHALL,2918,632,9666,13216,0.22079297820823243,0.7313861985472155,0.04782082324455206
2016,WEST VIRGINIA,MASON,2081,451,7654,10186,0.20430001963479286,0.7514235224818379,0.04427645788336933
2016,WEST VIRGINIA,MCDOWELL,1438,136,4629,6203,0.2318233113009834,0.746251813638562,0.02192487506045462
2016,WEST VIRGINIA,MERCER,4704,874,17404,22982,0.2046819249847707,0.7572883125924637,0.038029762422765644
2016,WEST VIRGINIA,MINERAL,2050,444,9070,11564,0.1772742995503286,0.7843306814251124,0.038395019024558975
2016,WEST VIRGINIA,MINGO,1370,229,7911,9510,0.1440588853838065,0.8318611987381703,0.024079915878023134
2016,WEST VIRGINIA,MONONGALIA,14699,2917,18432,36048,0.4077618730581447,0.511318242343542,0.08091988459831335
2016,WEST VIRGINIA,MONROE,1111,251,4443,5805,0.19138673557278207,0.765374677002584,0.043238587424633934
2016,WEST VIRGINIA,MORGAN,1573,349,5732,7654,0.20551345701593937,0.7488894695584009,0.04559707342565979
2016,WEST VIRGINIA,NICHOLAS,1840,400,7251,9491,0.19386787482878517,0.7639869349910442,0.04214519018017069
2016,WEST VIRGINIA,OHIO,5493,1306,11139,17938,0.3062214293678225,0.6209722377076597,0.07280633292451778
2016,WEST VIRGINIA,PENDLETON,729,98,2398,3225,0.22604651162790698,0.7435658914728682,0.030387596899224805
2016,WEST VIRGINIA,PLEASANTS,621,171,2358,3150,0.19714285714285715,0.7485714285714286,0.054285714285714284
2016,WEST VIRGINIA,POCAHONTAS,928,222,2496,3646,0.2545255074053758,0.6845858475041141,0.060888645090510146
2016,WEST VIRGINIA,PRESTON,2470,651,9538,12659,0.19511809779603445,0.75345603918161,0.05142586302235563
2016,WEST VIRGINIA,PUTNAM,5884,1221,17788,24893,0.23637167075081347,0.7145783955328807,0.04904993371630579
2016,WEST VIRGINIA,RALEIGH,6443,1127,22048,29618,0.21753663312850294,0.7444121817813492,0.038051185090147883
2016,WEST VIRGINIA,RANDOLPH,2735,512,7629,10876,0.25147112909157776,0.7014527399779331,0.04707613093048915
2016,WEST VIRGINIA,RITCHIE,496,174,3405,4075,0.12171779141104294,0.8355828220858895,0.04269938650306748
2016,WEST VIRGINIA,ROANE,1222,244,3781,5247,0.23289498761196875,0.7206022489041357,0.04650276348389556
2016,WEST VIRGINIA,SUMMERS,1190,217,3455,4862,0.24475524475524477,0.7106129164952695,0.04463183874948581
2016,WEST VIRGINIA,TAYLOR,1491,314,4733,6538,0.22805139186295503,0.7239216885897828,0.04802691954726216
2016,WEST VIRGINIA,TUCKER,751,159,2565,3475,0.21611510791366906,0.7381294964028777,0.045755395683453236
2016,WEST VIRGINIA,TYLER,507,151,2996,3654,0.138752052545156,0.8199233716475096,0.04132457580733443
2016,WEST VIRGINIA,UPSHUR,1766,447,7005,9218,0.19158168800173572,0.7599262312866132,0.04849208071165112
2016,WEST VIRGINIA,WAYNE,3357,673,11152,15182,0.22111711236991174,0.7345540771966803,0.044328810433407986
2016,WEST VIRGINIA,WEBSTER,556,120,2302,2978,0.18670248488918736,0.7730020147750168,0.040295500335795834
2016,WEST VIRGINIA,WETZEL,1359,387,4519,6265,0.2169193934557063,0.7213088587390263,0.06177174780526736
2016,WEST VIRGINIA,WIRT,386,125,1911,2422,0.1593724194880264,0.7890173410404624,0.051610239471511145
2016,WEST VIRGINIA,WOOD,8400,1781,25434,35615,0.23585567878702793,0.7141373016987225,0.050007019514249615
2016,WEST VIRGINIA,WYOMING,1062,222,6547,7831,0.13561486400204317,0.8360362661218235,0.028348869876133317
2016,WISCONSIN,ADAMS,3770,411,5983,10164,0.3709169618260527,0.5886462022825659,0.04043683589138135
2016,WISCONSIN,ASHLAND,4228,499,3302,8029,0.5265911072362686,0.4112591854527338,0.062149707310997636
2016,WISCONSIN,BARRON,7879,1158,13606,22643,0.34796625888795657,0.6008921079362275,0.05114163317581592
2016,WISCONSIN,BAYFIELD,4954,450,4125,9529,0.5198866617693357,0.4328890754538776,0.04722426277678665
2016,WISCONSIN,BROWN,53364,8416,67199,128979,0.41374177191635847,0.5210072957613255,0.06525093232231603
2016,WISCONSIN,BUFFALO,2531,408,4049,6988,0.36219232970807097,0.5794218660560961,0.05838580423583286
2016,WISCONSIN,BURNETT,2948,383,5412,8743,0.3371840329406382,0.6190094933089328,0.04380647375042891
2016,WISCONSIN,CALUMET,9646,1656,15348,26650,0.3619512195121951,0.5759099437148217,0.06213883677298312
2016,WISCONSIN,CHIPPEWA,11886,1766,17909,31561,0.37660403662748326,0.567440828871075,0.055955134501441656
2016,WISCONSIN,CLARK,4227,723,8646,13596,0.3109002647837599,0.6359223300970874,0.05317740511915269
2016,WISCONSIN,COLUMBIA,13526,2085,14160,29771,0.4543347552987807,0.475630647274193,0.07003459742702631
2016,WISCONSIN,CRAWFORD,3425,475,3844,7744,0.44227789256198347,0.49638429752066116,0.06133780991735537
2016,WISCONSIN,DANE,217526,21212,71279,310017,0.7016582961579526,0.22991964956760436,0.06842205427444302
2016,WISCONSIN,DODGE,13968,2454,26643,43065,0.3243469174503657,0.6186694531522118,0.0569836293974225
2016,WISCONSIN,DOOR,8026,998,8584,17608,0.4558155383916402,0.48750567923671057,0.05667878237164925
2016,WISCONSIN,DOUGLAS,11345,1507,9659,22511,0.5039758340366932,0.4290791168761939,0.06694504908711296
2016,WISCONSIN,DUNN,9026,1577,11488,22091,0.40858268072970894,0.5200307817663302,0.07138653750396089
2016,WISCONSIN,EAU CLAIRE,27294,4280,23311,54885,0.49729434271658923,0.42472442379520814,0.0779812334882026
2016,WISCONSIN,FLORENCE,666,94,1897,2657,0.2506586375611592,0.713963116296575,0.035378246142265715
2016,WISCONSIN,FOND DU LAC,17391,2892,31044,51327,0.3388275176807528,0.6048278683733708,0.05634461394587644
2016,WISCONSIN,FOREST,1584,168,2788,4540,0.34889867841409694,0.6140969162995594,0.03700440528634361
2016,WISCONSIN,GRANT,10046,1926,12349,24321,0.4130586735742774,0.5077505036799473,0.07919082274577526
2016,WISCONSIN,GREEN,9122,1170,8693,18985,0.48048459309981567,0.4578878061627601,0.06162760073742428
2016,WISCONSIN,GREEN LAKE,2701,474,6213,9388,0.28770771197273115,0.661802300809544,0.050489987217724755
2016,WISCONSIN,IOWA,6669,782,4809,12260,0.5439641109298532,0.39225122349102776,0.06378466557911909
2016,WISCONSIN,IRON,1273,134,2090,3497,0.3640263082642265,0.597655132971118,0.03831855876465542
2016,WISCONSIN,JACKSON,3821,544,4907,9272,0.4121009490940466,0.5292277825711821,0.058671268334771355
2016,WISCONSIN,JEFFERSON,16561,3175,23410,43146,0.38383627682751587,0.5425763686089092,0.07358735456357483
2016,WISCONSIN,JUNEAU,4073,536,7123,11732,0.34717013296965565,0.6071428571428571,0.045687009887487216
2016,WISCONSIN,KENOSHA,35771,5280,36025,77076,0.46410036846748665,0.46739581711557426,0.06850381441693912
2016,WISCONSIN,KEWAUNEE,3623,519,6616,10758,0.33677263431864657,0.6149841978062837,0.048243167875069715
2016,WISCONSIN,LA CROSSE,32406,4173,26389,62968,0.5146423580231229,0.41908588489391435,0.06627175708296278
2016,WISCONSIN,LAFAYETTE,3288,397,3977,7662,0.4291307752545027,0.5190550770033934,0.05181414774210389
2016,WISCONSIN,LANGLADE,3260,436,6436,10132,0.32175286221871296,0.6352151598894591,0.043031977891827874
2016,WISCONSIN,LINCOLN,5370,936,8400,14706,0.36515707874337006,0.5711954304365565,0.06364749082007344
2016,WISCONSIN,MANITOWOC,14506,2647,23193,40346,0.35953997918009223,0.5748525256531006,0.06560749516680711
2016,WISCONSIN,MARATHON,26477,4025,39013,69515,0.3808818240667482,0.5612170035244192,0.05790117240883263
2016,WISCONSIN,MARINETTE,6243,808,12995,20046,0.31143370248428615,0.6482590042901327,0.040307293225581166
2016,WISCONSIN,MARQUETTE,2809,370,4714,7893,0.35588496135816544,0.5972380590396554,0.046876979602179146
2016,WISCONSIN,MENOMINEE,1003,7,269,1279,0.784206411258796,0.21032056293979673,0.00547302580140735
2016,WISCONSIN,MILWAUKEE,288797,25604,125846,440247,0.6559885700527204,0.2858531687893387,0.058158261157940885
2016,WISCONSIN,MONROE,7048,1270,11352,19670,0.358312150482969,0.5771225216065073,0.06456532791052363
2016,WISCONSIN,OCONTO,5884,841,13253,19978,0.2945239763740114,0.6633797176894584,0.04209630593653018
2016,WISCONSIN,ONEIDA,8104,1252,12117,21473,0.37740418199599496,0.5642900386531924,0.05830577935081265
2016,WISCONSIN,OUTAGAMIE,38087,5897,49884,93868,0.4057506285422082,0.5314271104103635,0.0628222610474283
2016,WISCONSIN,OZAUKEE,20168,3925,30430,54523,0.3698989417310126,0.5581130898886708,0.07198796838031657
2016,WISCONSIN,PEPIN,1345,188,2206,3739,0.3597218507622359,0.5899973254880985,0.050280823749665686
2016,WISCONSIN,PIERCE,8382,1549,11258,21189,0.3955826136202747,0.5313134173391855,0.07310396904053991
2016,WISCONSIN,POLK,7570,1364,13815,22749,0.33276187964306125,0.6072794408545431,0.05995867950239571
2016,WISCONSIN,PORTAGE,18521,2669,17306,38496,0.4811149210307564,0.44955320033250207,0.06933187863674148
2016,WISCONSIN,PRICE,2669,346,4562,7577,0.3522502309621222,0.6020852580176851,0.045664511020192686
2016,WISCONSIN,RACINE,42512,5010,46611,94133,0.4516163300861547,0.49516110184526146,0.05322256806858381
2016,WISCONSIN,RICHLAND,3577,455,4023,8055,0.4440720049658597,0.4994413407821229,0.05648665425201738
2016,WISCONSIN,ROCK,39343,5237,31488,76068,0.5172082873218699,0.41394541725824263,0.06884629541988747
2016,WISCONSIN,RUSK,2171,352,4564,7087,0.3063355439537181,0.6439960491039932,0.0496684069422887
2016,WISCONSIN,SAUK,14692,1835,14791,31318,0.469123187943036,0.4722843093428699,0.05859250271409413
2016,WISCONSIN,SAWYER,3504,432,5185,9121,0.38416840258743556,0.5684683696963052,0.047363227716259185
2016,WISCONSIN,SHAWANO,6056,953,12742,19751,0.306617386461445,0.6451318920560984,0.048250721482456585
2016,WISCONSIN,SHEBOYGAN,22956,4241,32458,59655,0.38481267286899673,0.5440952141480178,0.0710921129829855
2016,WISCONSIN,ST. CROIX,17486,3802,26220,47508,0.36806432600825123,0.5519070472341501,0.08002862675759873
2016,WISCONSIN,TAYLOR,2398,497,6589,9484,0.2528469000421763,0.6947490510333193,0.052404048924504426
2016,WISCONSIN,TREMPEALEAU,5636,675,7364,13675,0.41213893967093235,0.5385009140767825,0.04936014625228519
2016,WISCONSIN,VERNON,6352,865,6996,14213,0.4469147963132344,0.4922254274255963,0.060859776261169354
2016,WISCONSIN,VILAS,4770,673,8169,13612,0.350426094622392,0.6001322362621216,0.049441669115486336
2016,WISCONSIN,WALWORTH,18706,3767,28851,51324,0.36446886446886445,0.5621346738368015,0.07339646169433403
2016,WISCONSIN,WASHBURN,3284,460,5404,9148,0.3589855706165282,0.5907302142544818,0.050284215128989944
2016,WISCONSIN,WASHINGTON,20855,5419,51729,78003,0.26736151173672806,0.663166801276874,0.06947168698639795
2016,WISCONSIN,WAUKESHA,79200,17321,142521,239042,0.3313225290953054,0.596217401126162,0.07246006977853264
2016,WISCONSIN,WAUPACA,8440,1395,16189,26024,0.3243160159852444,0.622079618813403,0.053604365201352595
2016,WISCONSIN,WAUSHARA,3792,538,7669,11999,0.31602633552796067,0.6391365947162263,0.04483706975581298
2016,WISCONSIN,WINNEBAGO,37054,6642,43448,87144,0.42520425961626734,0.4985770678417332,0.07621867254199945
2016,WISCONSIN,WOOD,14232,2065,21503,37800,0.3765079365079365,0.5688624338624338,0.05462962962962963
2016,WYOMING,ALBANY,6890,2568,7602,17060,0.40386869871043374,0.4456037514654162,0.15052754982415006
2016,WYOMING,BIG HORN,604,646,4067,5317,0.1135978935489938,0.764905021628738,0.1214970848222682
2016,WYOMING,CAMPBELL,1324,1097,15778,18199,0.07275125006868509,0.8669707126765207,0.06027803725479422
2016,WYOMING,CARBON,1279,686,4409,6374,0.20065892689049264,0.6917163476623784,0.10762472544712896
2016,WYOMING,CONVERSE,668,466,5520,6654,0.1003907424105801,0.8295761947700632,0.07003306281935678
2016,WYOMING,CROOK,273,205,3348,3826,0.07135389440669106,0.8750653423941454,0.05358076319916362
2016,WYOMING,FREMONT,4200,1656,11167,17023,0.24672501909181696,0.6559948305234095,0.09728015038477354
2016,WYOMING,GOSHEN,924,454,4418,5796,0.15942028985507245,0.7622498274672188,0.07832988267770877
2016,WYOMING,HOT SPRINGS,400,247,1939,2586,0.15467904098994587,0.7498066511987626,0.09551430781129157
2016,WYOMING,JOHNSON,638,302,3477,4417,0.14444192891102559,0.7871858727643197,0.06837219832465474
2016,WYOMING,LARAMIE,11573,4549,24847,40969,0.28248187654079915,0.6064829505235666,0.11103517293563427
2016,WYOMING,LINCOLN,1105,991,6779,8875,0.12450704225352113,0.7638309859154929,0.11166197183098592
2016,WYOMING,NATRONA,6577,3219,23552,33348,0.19722322178241575,0.7062492503298549,0.0965275278877294
2016,WYOMING,NIOBRARA,115,83,1116,1314,0.08751902587519025,0.8493150684931506,0.06316590563165905
2016,WYOMING,PARK,2535,1445,11115,15095,0.16793640278237826,0.7363365352765816,0.09572706194104008
2016,WYOMING,PLATTE,719,373,3437,4529,0.15875469198498565,0.758887171561051,0.08235813645396335
2016,WYOMING,SHERIDAN,2927,1317,10266,14510,0.20172294968986906,0.7075120606478291,0.09076498966230186
2016,WYOMING,SUBLETTE,644,337,3409,4390,0.14669703872437356,0.7765375854214123,0.07676537585421413
2016,WYOMING,SWEETWATER,3231,1745,12154,17130,0.18861646234676008,0.7095154699357852,0.10186806771745475
2016,WYOMING,TETON,7314,1392,3921,12627,0.5792349726775956,0.31052506533618435,0.11023996198622
2016,WYOMING,UINTA,1202,1114,6154,8470,0.14191263282172373,0.7265643447461629,0.13152302243211333
2016,WYOMING,WASHAKIE,532,371,2911,3814,0.13948610382800208,0.7632406921866807,0.09727320398531725
2016,WYOMING,WESTON,299,194,3033,3526,0.08479863868406126,0.8601815087918321,0.055019852524106634
2020,ALABAMA,AUTAUGA,7503,429,19838,27770,0.27018365142239825,0.714368023046453,0.015448325531148721
2020,ALABAMA,BALDWIN,24578,1557,83544,109679,0.22409029987509005,0.7617137282433283,0.014195971881581707
2020,ALABAMA,BARBOUR,4816,80,5622,10518,0.45788172656398557,0.5345122646891044,0.007606008746910059
2020,ALABAMA,BIBB,1986,84,7525,9595,0.20698280354351226,0.7842626367899947,0.008754559666492965
2020,ALABAMA,BLOUNT,2640,237,24711,27588,0.09569377990430622,0.8957155284906481,0.008590691605045673
2020,ALABAMA,BULLOCK,3446,21,1146,4613,0.7470192933015392,0.24842835464990246,0.004552352048558422
2020,ALABAMA,BUTLER,3965,65,5458,9488,0.4178962900505902,0.5752529510961214,0.006850758853288365
2020,ALABAMA,CALHOUN,15216,666,35101,50983,0.29845242531824334,0.6884843967597042,0.013063177922052449
2020,ALABAMA,CHAMBERS,6365,166,8753,15284,0.41644857367181365,0.5726903951845067,0.010861031143679666
2020,ALABAMA,CHEROKEE,1624,94,10583,12301,0.13202178684659785,0.8603365580034144,0.007641655149987806
2020,ALABAMA,CHILTON,3073,152,16085,19310,0.1591403417918177,0.8329880890730191,0.007871569135163127
2020,ALABAMA,CHOCTAW,3127,41,4296,7464,0.41894426580921756,0.5755627009646302,0.005493033226152197
2020,ALABAMA,CLARKE,5755,56,7324,13135,0.4381423677198325,0.5575942139322421,0.0042634183479253905
2020,ALABAMA,CLAY,1267,62,5601,6930,0.18282828282828284,0.8082251082251082,0.008946608946608947
2020,ALABAMA,CLEBURNE,675,68,6484,7227,0.09339975093399751,0.8971910889719109,0.0094091600940916
2020,ALABAMA,COFFEE,5076,300,16899,22275,0.22787878787878788,0.7586531986531987,0.013468013468013467
2020,ALABAMA,COLBERT,8343,340,19203,27886,0.2991823854263788,0.688625116545937,0.012192498027684143
2020,ALABAMA,CONECUH,2966,33,3442,6441,0.46048750194069243,0.5343890700201832,0.005123428039124359
2020,ALABAMA,COOSA,1796,52,3631,5479,0.3277970432560686,0.6627121737543348,0.009490782989596642
2020,ALABAMA,COVINGTON,2721,123,14586,17430,0.15611015490533564,0.8368330464716007,0.0070567986230636835
2020,ALABAMA,CRENSHAW,1700,53,4864,6617,0.2569140093698051,0.7350763185733716,0.008009672056823333
2020,ALABAMA,CULLMAN,4478,493,36880,41851,0.10699863802537574,0.8812214761893383,0.011779885785285896
2020,ALABAMA,DALE,5170,265,14303,19738,0.2619313000303982,0.724642820954504,0.01342587901509778
2020,ALABAMA,DALLAS,12230,110,5524,17864,0.6846171070309002,0.30922525750111957,0.006157635467980296
2020,ALABAMA,DEKALB,4281,308,24767,29356,0.14583049461779535,0.8436776127537812,0.010491892628423491
2020,ALABAMA,ELMORE,10367,499,30164,41030,0.2526687789422374,0.7351693882524982,0.012161832805264441
2020,ALABAMA,ESCAMBIA,4918,123,10869,15910,0.3091137649277184,0.6831552482715273,0.007730986800754243
2020,ALABAMA,ETOWAH,11567,633,35528,47728,0.2423524974857526,0.7443848474689909,0.013262655045256453
2020,ALABAMA,FAYETTE,1395,71,7300,8766,0.1591375770020534,0.8327629477526808,0.008099475245265799
2020,ALABAMA,FRANKLIN,2086,116,10376,12578,0.16584512641119414,0.8249324216886628,0.009222451900143107
2020,ALABAMA,GENEVA,1595,102,10848,12545,0.12714228776404943,0.8647269828616979,0.008130729374252691
2020,ALABAMA,GREENE,3884,16,875,4775,0.8134031413612566,0.18324607329842932,0.003350785340314136
2020,ALABAMA,HALE,4663,45,3192,7900,0.590253164556962,0.4040506329113924,0.00569620253164557
2020,ALABAMA,HENRY,2606,85,6607,9298,0.2802753280275328,0.7105829210582921,0.009141750914175092
2020,ALABAMA,HOUSTON,12917,638,32618,46173,0.27975223615532885,0.7064301648149351,0.013817599029735993
2020,ALABAMA,JACKSON,3717,249,19670,23636,0.15726011169402607,0.8322051108478592,0.010534777458114741
2020,ALABAMA,JEFFERSON,181688,5317,138843,325848,0.5575851317178562,0.426097444207115,0.016317424075028848
2020,ALABAMA,LAMAR,978,41,6174,7193,0.13596552203531212,0.858334491867093,0.005699986097594884
2020,ALABAMA,LAUDERDALE,11915,703,31721,44339,0.26872505018155574,0.7154198335551095,0.015855116263334763
2020,ALABAMA,LAWRENCE,3562,147,12322,16031,0.22219449815981535,0.7686357681991142,0.009169733641070425
2020,ALABAMA,LEE,27860,1368,42221,71449,0.38992848045459,0.590924995451301,0.019146524094109083
2020,ALABAMA,LIMESTONE,13672,923,34640,49235,0.27768863613283234,0.7035645374225652,0.01874682644460242
2020,ALABAMA,LOWNDES,4972,27,1836,6835,0.7274323335771763,0.2686174103877103,0.003950256035113387
2020,ALABAMA,MACON,7108,74,1541,8723,0.8148572738736674,0.1766594061676029,0.008483319958729795
2020,ALABAMA,MADISON,87286,4701,102780,194767,0.4481560017867503,0.5277074658438031,0.02413653236944657
2020,ALABAMA,MARENGO,5488,69,5343,10900,0.50348623853211,0.4901834862385321,0.006330275229357798
2020,ALABAMA,MARION,1463,139,12205,13807,0.10596074454986601,0.8839718983124502,0.010067357137683784
2020,ALABAMA,MARSHALL,5943,521,33191,39655,0.1498676081200353,0.8369940738872778,0.013138317992686924
2020,ALABAMA,MOBILE,79474,2447,101243,183164,0.43389530693804457,0.5527450809110961,0.013359612150859339
2020,ALABAMA,MONROE,4455,66,6147,10668,0.4176040494938133,0.5762092238470191,0.006186726659167604
2020,ALABAMA,MONTGOMERY,64529,1299,33311,99139,0.6508941990538537,0.3360029857069367,0.013102815239209595
2020,ALABAMA,MORGAN,13234,824,39664,53722,0.24634228062990954,0.7383194966680318,0.015338222702058747
2020,ALABAMA,PERRY,3860,31,1339,5230,0.7380497131931166,0.2560229445506692,0.005927342256214149
2020,ALABAMA,PICKENS,4022,52,5594,9668,0.41601158460901944,0.5786098469176665,0.005378568473314025
2020,ALABAMA,PIKE,5636,163,8042,13841,0.40719601184885484,0.5810273824145654,0.011776605736579727
2020,ALABAMA,RANDOLPH,2203,75,8559,10837,0.20328504198578942,0.7897942234935867,0.0069207345206237884
2020,ALABAMA,RUSSELL,11228,237,9864,21329,0.5264194289465047,0.46246893900323505,0.011111632050260209
2020,ALABAMA,SHELBY,33268,1982,79700,114950,0.28941278816876903,0.6933449325793823,0.01724227925184863
2020,ALABAMA,ST. CLAIR,7744,531,36166,44441,0.1742535046466101,0.8137980693503747,0.011948426003015234
2020,ALABAMA,SUMTER,4648,45,1598,6291,0.7388332538547131,0.2540136703226832,0.00715307582260372
2020,ALABAMA,TALLADEGA,13138,290,22235,35663,0.3683930123657572,0.623475310545944,0.008131677088298797
2020,ALABAMA,TALLAPOOSA,5859,169,14963,20991,0.2791196226954409,0.7128293077985803,0.008051069505978753
2020,ALABAMA,TUSCALOOSA,37765,1290,51117,90172,0.41881071729583463,0.566883289712993,0.014305992991172425
2020,ALABAMA,WALKER,4834,334,26002,31170,0.15508501764517163,0.8341995508501765,0.010715431504651908
2020,ALABAMA,WASHINGTON,2258,54,6564,8876,0.254393871113114,0.7395223073456512,0.00608382154123479
2020,ALABAMA,WILCOX,4048,22,1833,5903,0.6857530069456209,0.3105200745383703,0.003726918516008809
2020,ALABAMA,WINSTON,974,115,10195,11284,0.08631690889755406,0.9034916696207019,0.010191421481744062
2020,ALASKA,DISTRICT 1,3477,326,3511,7314,0.4753896636587367,0.48003828274541976,0.04457205359584359
2020,ALASKA,DISTRICT 10,2727,397,8081,11205,0.2433734939759036,0.7211958946898706,0.035430611334225794
2020,ALASKA,DISTRICT 11,3130,402,7096,10628,0.29450508091832894,0.6676703048550997,0.037824614226571324
2020,ALASKA,DISTRICT 12,2957,388,7893,11238,0.2631251112297562,0.702349172450614,0.03452571631962983
2020,ALASKA,DISTRICT 13,2666,395,4652,7713,0.3456502009594192,0.6031375599636977,0.05121223907688319
2020,ALASKA,DISTRICT 14,4261,468,6714,11443,0.37236738617495413,0.586734248011885,0.040898365813160885
2020,ALASKA,DISTRICT 15,2622,266,2671,5559,0.4716675661090124,0.48048210109731965,0.047850332793667925
2020,ALASKA,DISTRICT 16,4274,328,3516,8118,0.5264843557526484,0.43311160384331115,0.04040404040404041
2020,ALASKA,DISTRICT 17,4136,293,2810,7239,0.5713496339273381,0.3881751623152369,0.04047520375742506
2020,ALASKA,DISTRICT 18,4681,279,2760,7720,0.6063471502590674,0.35751295336787564,0.03613989637305699
2020,ALASKA,DISTRICT 19,3118,208,1975,5301,0.5881909073759668,0.3725712129786833,0.039237879645349936
2020,ALASKA,DISTRICT 2,2104,358,3674,6136,0.3428943937418514,0.598761408083442,0.05834419817470665
2020,ALASKA,DISTRICT 20,4881,233,2383,7497,0.6510604241696679,0.31786047752434304,0.031079098305989063
2020,ALASKA,DISTRICT 21,5414,325,3690,9429,0.5741860218474918,0.3913458479160038,0.0344681302365044
2020,ALASKA,DISTRICT 22,4553,283,4684,9520,0.4782563025210084,0.49201680672268905,0.02972689075630252
2020,ALASKA,DISTRICT 23,3810,274,3655,7739,0.4923116681741827,0.4722832407287763,0.03540509109704096
2020,ALASKA,DISTRICT 24,4736,314,5378,10428,0.45416187188339086,0.5157268891446106,0.030111238971998466
2020,ALASKA,DISTRICT 25,4600,318,4407,9325,0.4932975871313673,0.4726005361930295,0.034101876675603215
2020,ALASKA,DISTRICT 26,4558,310,5243,10111,0.45079616259519334,0.5185441598259322,0.030659677578874493
2020,ALASKA,DISTRICT 27,4844,338,4324,9506,0.5095729013254786,0.4548706080370292,0.03555649063749211
2020,ALASKA,DISTRICT 28,6264,323,6162,12749,0.4913326535414542,0.48333202604125813,0.02533532041728763
2020,ALASKA,DISTRICT 29,2985,298,7464,10747,0.27775193077137805,0.6945194007630037,0.027728668465618313
2020,ALASKA,DISTRICT 3,1903,406,6076,8385,0.22695289206917113,0.7246273106738224,0.04841979725700656
2020,ALASKA,DISTRICT 30,2638,358,7180,10176,0.2592374213836478,0.7055817610062893,0.03518081761006289
2020,ALASKA,DISTRICT 31,5037,402,6971,12410,0.40588235294117647,0.5617244157937148,0.032393231265108784
2020,ALASKA,DISTRICT 32,3506,389,4440,8335,0.4206358728254349,0.5326934613077384,0.04667066586682663
2020,ALASKA,DISTRICT 33,7535,361,3059,10955,0.687813783660429,0.2792332268370607,0.03295298950251027
2020,ALASKA,DISTRICT 34,5763,423,4543,10729,0.5371423245409638,0.42343182030012116,0.03942585515891509
2020,ALASKA,DISTRICT 35,5011,322,4769,10102,0.49604038804197187,0.4720847356959018,0.03187487626212631
2020,ALASKA,DISTRICT 36,3796,382,5114,9292,0.40852346104175635,0.550365906155833,0.041110632802410674
2020,ALASKA,DISTRICT 37,2560,224,2358,5142,0.4978607545702061,0.45857642940490084,0.043562816024893036
2020,ALASKA,DISTRICT 38,3202,360,1737,5299,0.6042649556520098,0.32779769767880734,0.06793734666918287
2020,ALASKA,DISTRICT 39,3580,372,1939,5891,0.6077066711933458,0.3291461551519267,0.06314717365472755
2020,ALASKA,DISTRICT 4,5345,476,4690,10511,0.5085148891637332,0.4461992198649034,0.04528589097136333
2020,ALASKA,DISTRICT 40,2318,291,1994,4603,0.5035846187269172,0.43319574190745164,0.06321963936563112
2020,ALASKA,DISTRICT 5,4204,373,4077,8654,0.4857869193436561,0.4711116246822279,0.043101455974116014
2020,ALASKA,DISTRICT 6,3272,418,5770,9460,0.34587737843551797,0.6099365750528541,0.044186046511627906
2020,ALASKA,DISTRICT 7,2215,380,7027,9622,0.23020162128455623,0.7303055497817501,0.039492828933693616
2020,ALASKA,DISTRICT 8,1953,341,7618,9912,0.19703389830508475,0.7685633575464084,0.03440274414850686
2020,ALASKA,DISTRICT 9,2769,437,7787,10993,0.2518875648139725,0.7083598653688711,0.03975256981715637
2020,ALASKA,DISTRICT 99,373,1,59,433,0.8614318706697459,0.13625866050808313,0.0023094688221709007
2020,CALIFORNIA,ALAMEDA,617659,16102,136309,770070,0.8020816289428234,0.17700858363525393,0.020909787421922683
2020,CALIFORNIA,ALPINE,476,21,244,741,0.6423751686909581,0.3292847503373819,0.02834008097165992
2020,CALIFORNIA,AMADOR,8153,566,13585,22304,0.36553981348637016,0.6090835724533716,0.02537661406025825
2020,CALIFORNIA,BUTTE,50426,2910,48730,102066,0.4940528677522387,0.4774361687535516,0.02851096349420963
2020,CALIFORNIA,CALAVERAS,10046,600,16518,27164,0.36982771314975704,0.6080842291267855,0.022088057723457517
2020,CALIFORNIA,COLUSA,3239,163,4559,7961,0.4068584348699912,0.5726667504082402,0.02047481472176862
2020,CALIFORNIA,CONTRA COSTA,416386,12053,152877,581316,0.7162816781234302,0.26298433210164524,0.02073398977492448
2020,CALIFORNIA,DEL NORTE,4677,315,6461,11453,0.40836462062341744,0.5641316685584563,0.027503710818126255
2020,CALIFORNIA,EL DORADO,51621,2700,61838,116159,0.44439948691018344,0.5323565113336031,0.023244001756213467
2020,CALIFORNIA,FRESNO,193025,7428,164464,364917,0.528955899560722,0.4506887867652096,0.02035531367406835
2020,CALIFORNIA,GLENN,3995,239,7063,11297,0.35363370806408784,0.6252102328051695,0.021156059130742675
2020,CALIFORNIA,HUMBOLDT,44768,2305,21770,68843,0.6502912423921096,0.316226776869108,0.033481980738782446
2020,CALIFORNIA,IMPERIAL,34678,1218,20847,56743,0.6111414623830252,0.36739333486068765,0.02146520275628712
2020,CALIFORNIA,INYO,4634,230,4620,9484,0.4886123998312948,0.48713622943905527,0.024251370729649935
2020,CALIFORNIA,KERN,133366,7442,164484,305292,0.43684734614729503,0.5387759915097677,0.024376662342937252
2020,CALIFORNIA,KINGS,18699,1090,24072,43861,0.42632406921866806,0.548824696199357,0.024851234581974874
2020,CALIFORNIA,LAKE,14941,748,13123,28812,0.5185686519505761,0.4554699430792725,0.025961404970151324
2020,CALIFORNIA,LASSEN,2799,218,8970,11987,0.23350296154167013,0.7483106698923834,0.01818636856594644
2020,CALIFORNIA,LOS ANGELES,3028885,89950,1145530,4264365,0.7102780836068208,0.26862850623715373,0.021093410156025574
2020,CALIFORNIA,MADERA,23168,1186,29378,53732,0.43117695228169434,0.5467505397156257,0.02207250800267997
2020,CALIFORNIA,MARIN,128288,2930,24612,155830,0.8232561124302125,0.15794134633895912,0.018802541230828466
2020,CALIFORNIA,MARIPOSA,4088,242,5950,10280,0.3976653696498054,0.5787937743190662,0.023540856031128404
2020,CALIFORNIA,MENDOCINO,28782,1291,13267,43340,0.6640978311029072,0.30611444393170284,0.02978772496538994
2020,CALIFORNIA,MERCED,48991,2166,39397,90554,0.5410142014709455,0.4350663692382446,0.023919429290809903
2020,CALIFORNIA,MODOC,1150,84,3109,4343,0.2647939212525904,0.7158646097167857,0.019341469030623993
2020,CALIFORNIA,MONO,4013,212,2513,6738,0.5955773226476699,0.37295933511427726,0.03146334223805283
2020,CALIFORNIA,MONTEREY,113953,3671,46299,163923,0.6951617527741684,0.28244358631796634,0.02239466090786528
2020,CALIFORNIA,NAPA,49817,1657,20676,72150,0.6904643104643104,0.28656964656964656,0.022966042966042967
2020,CALIFORNIA,NEVADA,36359,1612,26779,64750,0.5615289575289575,0.41357528957528955,0.024895752895752896
2020,CALIFORNIA,ORANGE,814009,31606,676498,1522113,0.534788810029216,0.4444466343825984,0.020764555588185633
2020,CALIFORNIA,PLACER,106869,5727,122488,235084,0.4545992070919331,0.5210392880842593,0.02436150482380766
2020,CALIFORNIA,PLUMAS,4561,254,6445,11260,0.4050621669626998,0.572380106571936,0.022557726465364122
2020,CALIFORNIA,RIVERSIDE,528340,19672,449144,997156,0.5298468845396307,0.4504250087248134,0.01972810673555592
2020,CALIFORNIA,SACRAMENTO,440808,18227,259405,718440,0.6135627192249875,0.3610670341295028,0.025370246645509714
2020,CALIFORNIA,SAN BENITO,17628,612,10590,28830,0.6114464099895942,0.3673257023933403,0.021227887617065556
2020,CALIFORNIA,SAN BERNARDINO,455859,19014,366257,841130,0.541960220179996,0.4354344750514189,0.02260530476858512
2020,CALIFORNIA,SAN DIEGO,964650,37399,600094,1602143,0.6020998125635477,0.3745570776141705,0.02334310982228178
2020,CALIFORNIA,SAN FRANCISCO,378156,8980,56417,443553,0.8525610242744385,0.1271933680980627,0.020245607627498857
2020,CALIFORNIA,SAN JOAQUIN,161137,6257,121098,288492,0.5585492838622909,0.419762073125078,0.0216886430126312
2020,CALIFORNIA,SAN LUIS OBISPO,88310,3968,67436,159714,0.5529258549657513,0.4222297356524788,0.024844409381769912
2020,CALIFORNIA,SAN MATEO,291496,7171,75584,374251,0.778878346350444,0.20196071620383113,0.01916093744572493
2020,CALIFORNIA,SANTA BARBARA,129963,4640,65736,200339,0.6487154273506407,0.328123830107967,0.02316074254139234
2020,CALIFORNIA,SANTA CLARA,617967,18162,214612,850741,0.726386761658366,0.2522647903415963,0.021348448000037615
2020,CALIFORNIA,SANTA CRUZ,114246,3654,26937,144837,0.7887901572112098,0.18598148263220032,0.025228360156589823
2020,CALIFORNIA,SHASTA,30000,2141,60789,92930,0.3228236306897665,0.6541375228666738,0.02303884644355967
2020,CALIFORNIA,SIERRA,730,59,1142,1931,0.3780424650440186,0.5914034179181771,0.030554117037804248
2020,CALIFORNIA,SISKIYOU,9593,589,13290,23472,0.40869972733469667,0.5662065439672802,0.025093728698023177
2020,CALIFORNIA,SOLANO,131639,4932,69306,205877,0.6394060531288099,0.33663789544242434,0.02395605142876572
2020,CALIFORNIA,SONOMA,199938,6554,61825,268317,0.7451559163228569,0.23041775213646545,0.02442633154067763
2020,CALIFORNIA,STANISLAUS,105841,4968,104145,214954,0.49238906928924325,0.484499009090317,0.02311192162043972
2020,CALIFORNIA,SUTTER,17367,902,24375,42644,0.4072554169402495,0.571592721133102,0.021151861926648533
2020,CALIFORNIA,TEHAMA,8911,679,19141,28731,0.3101527966308169,0.6662141937280289,0.023633009641154154
2020,CALIFORNIA,TRINITY,2851,220,3188,6259,0.4555040741332481,0.5093465409809874,0.0351493848857645
2020,CALIFORNIA,TULARE,66105,3201,77579,146885,0.45004595431800387,0.5281614868774892,0.021792558804506926
2020,CALIFORNIA,TUOLUMNE,11978,741,17689,30408,0.39390949750065773,0.5817219152854513,0.024368587213891083
2020,CALIFORNIA,VENTURA,251388,9230,162207,422825,0.5945438420150181,0.38362679595577365,0.0218293620292083
2020,CALIFORNIA,YOLO,67598,2404,27292,97294,0.6947807675704566,0.2805106173042531,0.024708615125290358
2020,CALIFORNIA,YUBA,11230,890,17676,29796,0.376896227681568,0.5932339911397503,0.029869781178681703
2020,COLORADO,ADAMS,134202,6881,95657,236740,0.5668750528005406,0.40405930556728903,0.029065641632170312
2020,COLORADO,ALAMOSA,3759,236,3813,7808,0.48142930327868855,0.4883452868852459,0.030225409836065573
2020,COLORADO,ARAPAHOE,213607,9253,127323,350183,0.60998677834161,0.36358989442662837,0.02642332723176168
2020,COLORADO,ARCHULETA,3738,217,5189,9144,0.40879265091863515,0.5674759405074365,0.023731408573928258
2020,COLORADO,BACA,317,41,1867,2225,0.14247191011235955,0.8391011235955056,0.018426966292134833
2020,COLORADO,BENT,732,39,1503,2274,0.32189973614775724,0.6609498680738787,0.017150395778364115
2020,COLORADO,BOULDER,159089,4521,42501,206111,0.7718607934559534,0.20620442382987808,0.02193478271416858
2020,COLORADO,BROOMFIELD,29077,1260,16295,46632,0.6235417738891749,0.3494381540572997,0.027020072053525475
2020,COLORADO,CHAFFEE,7160,336,6222,13718,0.5219419740486951,0.4535646595713661,0.024493366379938767
2020,COLORADO,CHEYENNE,131,12,993,1136,0.1153169014084507,0.8741197183098591,0.01056338028169014
2020,COLORADO,CLEAR CREEK,3604,190,2754,6548,0.550397067806964,0.4205864386072083,0.029016493585827734
2020,COLORADO,CONEJOS,1959,88,2286,4333,0.45211170090006925,0.5275790445418879,0.020309254558042927
2020,COLORADO,COSTILLA,1311,42,741,2094,0.6260744985673352,0.3538681948424069,0.02005730659025788
2020,COLORADO,CROWLEY,437,42,1271,1750,0.24971428571428572,0.7262857142857143,0.024
2020,COLORADO,CUSTER,1112,49,2474,3635,0.30591471801925724,0.68060522696011,0.013480055020632738
2020,COLORADO,DELTA,5887,402,13081,19370,0.3039235931853381,0.6753226639132679,0.02075374290139391
2020,COLORADO,DENVER,313293,8918,71618,393829,0.7955051557909651,0.1818504985666368,0.022644345642398096
2020,COLORADO,DOLORES,341,19,1089,1449,0.23533471359558317,0.7515527950310559,0.013112491373360938
2020,COLORADO,DOUGLAS,104653,5682,121270,231605,0.4518598475853285,0.5236070033030374,0.024533149111634033
2020,COLORADO,EAGLE,18588,660,9892,29140,0.6378860672614962,0.3394646533973919,0.022649279341111873
2020,COLORADO,EL PASO,161941,14082,202828,378851,0.4274530092305418,0.5353767048259078,0.03717028594355037
2020,COLORADO,ELBERT,4490,466,14027,18983,0.23652741926987306,0.7389243006900912,0.02454828004003582
2020,COLORADO,FREMONT,7369,671,17517,25557,0.2883358766678405,0.6854090855734241,0.026255037758735375
2020,COLORADO,GARFIELD,15427,760,14717,30904,0.4991910432306498,0.47621667098110276,0.024592285788247476
2020,COLORADO,GILPIN,2223,130,1833,4186,0.531055900621118,0.43788819875776397,0.031055900621118012
2020,COLORADO,GRAND,4710,277,4883,9870,0.47720364741641336,0.49473150962512663,0.02806484295845998
2020,COLORADO,GUNNISON,7132,323,3735,11190,0.6373547810545129,0.33378016085790885,0.028865058087578194
2020,COLORADO,HINSDALE,255,24,353,632,0.40348101265822783,0.5585443037974683,0.0379746835443038
2020,COLORADO,HUERFANO,2076,127,2203,4406,0.4711756695415343,0.5,0.02882433045846573
2020,COLORADO,JACKSON,175,20,681,876,0.1997716894977169,0.7773972602739726,0.0228310502283105
2020,COLORADO,JEFFERSON,218396,10545,148417,377358,0.5787501523751981,0.3933055612972297,0.027944286327572225
2020,COLORADO,KIOWA,98,10,795,903,0.10852713178294573,0.8803986710963455,0.01107419712070875
2020,COLORADO,KIT CARSON,662,65,3144,3871,0.17101524153965383,0.812193231723069,0.01679152673727719
2020,COLORADO,LA PLATA,20548,886,14233,35667,0.5761067653573331,0.3990523453051841,0.024840889337482828
2020,COLORADO,LAKE,2303,161,1497,3961,0.5814188336278717,0.3779348649330977,0.04064630143903055
2020,COLORADO,LARIMER,126120,6729,91489,224338,0.5621874136347832,0.40781766798313257,0.029994918382084176
2020,COLORADO,LAS ANIMAS,3497,180,4284,7961,0.4392664238161035,0.5381233513377717,0.02261022484612486
2020,COLORADO,LINCOLN,470,46,2135,2651,0.17729158807996984,0.8053564692568842,0.01735194266314598
2020,COLORADO,LOGAN,2218,227,8087,10532,0.21059627800987465,0.7678503608051652,0.02155336118496012
2020,COLORADO,MESA,31536,2193,56894,90623,0.347991128080068,0.6278097171799654,0.024199154739966675
2020,COLORADO,MINERAL,317,12,427,756,0.4193121693121693,0.5648148148148148,0.015873015873015872
2020,COLORADO,MOFFAT,1203,153,5670,7026,0.17122117847993168,0.807002561912895,0.021776259607173356
2020,COLORADO,MONTEZUMA,5836,358,9306,15500,0.37651612903225806,0.6003870967741936,0.023096774193548386
2020,COLORADO,MONTROSE,7687,465,16770,24922,0.3084423401011155,0.6728994462723698,0.018658213626514725
2020,COLORADO,MORGAN,3876,275,9593,13744,0.2820139697322468,0.697977299185099,0.02000873108265425
2020,COLORADO,OTERO,3605,215,5756,9576,0.37646198830409355,0.6010860484544696,0.022451963241436924
2020,COLORADO,OURAY,2365,78,1577,4020,0.5883084577114428,0.39228855721393036,0.019402985074626865
2020,COLORADO,PARK,4903,397,6991,12291,0.39890977137743067,0.5687901716703279,0.03230005695224148
2020,COLORADO,PHILLIPS,486,41,1958,2485,0.19557344064386317,0.7879275653923541,0.016498993963782696
2020,COLORADO,PITKIN,8989,188,2780,11957,0.7517772016392071,0.2324997909174542,0.01572300744333863
2020,COLORADO,PROWERS,1458,95,4008,5561,0.2621830606006114,0.7207336809926272,0.017083258406761375
2020,COLORADO,PUEBLO,43772,2277,42252,88301,0.495713525328139,0.47849967724034836,0.025786797431512666
2020,COLORADO,RIO BLANCO,561,69,3061,3691,0.1519913302628014,0.8293145489027364,0.018694120834462206
2020,COLORADO,RIO GRANDE,2495,150,3660,6305,0.3957176843774782,0.5804916732751785,0.023790642347343377
2020,COLORADO,ROUTT,10582,369,5925,16876,0.62704432329936,0.35109030575965866,0.021865370940981274
2020,COLORADO,SAGUACHE,1884,92,1413,3389,0.5559161994688698,0.4169371496016524,0.027146650929477722
2020,COLORADO,SAN JUAN,342,18,202,562,0.608540925266904,0.3594306049822064,0.03202846975088968
2020,COLORADO,SAN MIGUEL,3924,87,1136,5147,0.7623858558383524,0.22071109384107246,0.016903050320575094
2020,COLORADO,SEDGWICK,301,24,1121,1446,0.20816044260027664,0.7752420470262794,0.016597510373443983
2020,COLORADO,SUMMIT,12631,526,5322,18479,0.6835326586936522,0.2880025975431571,0.02846474376319065
2020,COLORADO,TELLER,5278,420,11241,16939,0.3115886415963162,0.6636165062872661,0.024794852116417736
2020,COLORADO,WASHINGTON,369,44,2595,3008,0.12267287234042554,0.8626994680851063,0.014627659574468085
2020,COLORADO,WELD,66060,4769,96145,166974,0.3956304574364871,0.5758082096613845,0.028561332902128474
2020,COLORADO,YUMA,785,89,4107,4981,0.15759887572776551,0.8245332262597872,0.0178678980124473
2020,CONNECTICUT,FAIRFIELD,297505,6446,168445,472396,0.6297788296259917,0.35657583891480876,0.013645331459199486
2020,CONNECTICUT,HARTFORD,283368,6944,159024,449336,0.6306372069008492,0.3539088788790571,0.015453914220093649
2020,CONNECTICUT,LITCHFIELD,50164,1779,55601,107544,0.4664509410101912,0.5170069924867962,0.01654206650301272
2020,CONNECTICUT,MIDDLESEX,56848,1685,40665,99198,0.5730760700820581,0.40993770035686206,0.01698622956107986
2020,CONNECTICUT,NEW HAVEN,242630,5460,169893,417983,0.5804781534177227,0.40645911436589527,0.013062732216382007
2020,CONNECTICUT,NEW LONDON,79459,3035,57110,139604,0.5691742356952523,0.40908569955015617,0.02174006475459156
2020,CONNECTICUT,TOLLAND,44151,1725,34838,80714,0.5470054761255793,0.43162276680625417,0.021371757068166613
2020,CONNECTICUT,WINDHAM,26706,1235,29141,57082,0.46785326372586805,0.5105111944220595,0.021635541852072455
2020,DELAWARE,KENT,44552,1464,41009,87025,0.5119448434357943,0.47123240448147086,0.016822752082734847
2020,DELAWARE,NEW CASTLE,195034,4235,88364,287633,0.6780654514607156,0.3072109250329413,0.014723623506343153
2020,DELAWARE,SUSSEX,56682,1440,71230,129352,0.43819964128888617,0.5506679448327045,0.011132413878409301
2020,DISTRICT OF COLUMBIA,DISTRICT OF COLUMBIA,317323,8447,18586,344356,0.9214969392140692,0.05397321376714795,0.02452984701878289
2020,FLORIDA,ALACHUA,89704,1928,50972,142604,0.629042663599899,0.35743737903565115,0.013519957364449805
2020,FLORIDA,BAKER,2037,111,11911,14059,0.14488939469379045,0.8472153069208336,0.007895298385375915
2020,FLORIDA,BAY,25614,1313,66097,93024,0.2753482972136223,0.7105370657034744,0.014114637082903336
2020,FLORIDA,BRADFORD,3160,138,10334,13632,0.2318075117370892,0.7580692488262911,0.010123239436619719
2020,FLORIDA,BREVARD,148549,4332,207883,360764,0.4117622600924704,0.5762298899003226,0.012007850007206928
2020,FLORIDA,BROWARD,618752,5511,333409,957672,0.646100126139221,0.3481452940046279,0.005754579856151167
2020,FLORIDA,CALHOUN,1209,43,5274,6526,0.1852589641434263,0.8081520073551947,0.006589028501379099
2020,FLORIDA,CHARLOTTE,42273,824,73243,116340,0.36335740072202166,0.629559910606842,0.007082688671136325
2020,FLORIDA,CITRUS,27092,764,65352,93208,0.29066174577289505,0.7011415329156295,0.00819672131147541
2020,FLORIDA,CLAY,38317,1608,84480,124405,0.3080020899481532,0.6790723845504602,0.0129255255013866
2020,FLORIDA,COLLIER,77621,1247,128950,207818,0.37350470122895996,0.6204948560759895,0.006000442695050477
2020,FLORIDA,COLUMBIA,8914,292,23836,33042,0.2697778584831427,0.7213849040614975,0.008837237455359845
2020,FLORIDA,DESOTO,4259,87,8313,12659,0.33644047713089503,0.6566869420965321,0.006872580772572873
2020,FLORIDA,DIXIE,1365,43,6759,8167,0.16713603526386678,0.8275988735153668,0.005265091220766499
2020,FLORIDA,DUVAL,252556,6502,233762,492820,0.5124710847774036,0.4743354571648878,0.013193458057708697
2020,FLORIDA,ESCAMBIA,70929,2769,96674,170372,0.4163184091282605,0.5674289202451107,0.016252670626628787
2020,FLORIDA,FLAGLER,28161,512,43043,71716,0.3926738803056501,0.6001868481231525,0.007139271571197502
2020,FLORIDA,FRANKLIN,2120,54,4675,6849,0.3095342385749745,0.6825813987443422,0.00788436268068331
2020,FLORIDA,GADSDEN,16153,144,7465,23762,0.6797828465617373,0.31415705748674355,0.006060095951519232
2020,FLORIDA,GILCHRIST,1700,90,7895,9685,0.17552916881775943,0.8151781104801239,0.009292720702116675
2020,FLORIDA,GLADES,1385,26,3782,5193,0.2667051800500674,0.7282880801078375,0.005006739842095128
2020,FLORIDA,GULF,1985,65,6113,8163,0.24317040303809873,0.7488668381722406,0.007962758789660664
2020,FLORIDA,HAMILTON,1963,52,3815,5830,0.3367066895368782,0.6543739279588336,0.008919382504288165
2020,FLORIDA,HARDEE,2298,65,6122,8485,0.27083087802003536,0.7215085444902769,0.0076605774896876845
2020,FLORIDA,HENDRY,4929,105,7906,12940,0.3809119010819165,0.6109737248840804,0.00811437403400309
2020,FLORIDA,HERNANDO,37519,991,70412,108922,0.3444575016984631,0.6464442445052423,0.009098253796294597
2020,FLORIDA,HIGHLANDS,16938,359,34873,52170,0.3246693502012651,0.668449300364194,0.006881349434540924
2020,FLORIDA,HILLSBOROUGH,376367,8298,327398,712063,0.5285585685536252,0.459787968199443,0.011653463246931802
2020,FLORIDA,HOLMES,924,64,8080,9068,0.10189677988531098,0.8910454344949272,0.0070577856197618
2020,FLORIDA,INDIAN RIVER,37844,768,58872,97484,0.3882072955561938,0.6039144885314514,0.007878215912354849
2020,FLORIDA,JACKSON,6766,165,15488,22419,0.3017975824077791,0.6908425888755074,0.007359828716713502
2020,FLORIDA,JEFFERSON,3897,75,4479,8451,0.46112886048988283,0.5299964501242457,0.008874689385871494
2020,FLORIDA,LAFAYETTE,510,20,3128,3658,0.1394204483324221,0.8551120831055221,0.005467468562055768
2020,FLORIDA,LAKE,83505,1950,125859,211314,0.3951702206195519,0.5956018058434368,0.009227973537011273
2020,FLORIDA,LEE,157695,2957,233247,393899,0.40034374293917985,0.5921492565353047,0.007507000525515424
2020,FLORIDA,LEON,103517,1959,57453,162929,0.6353503673379202,0.35262599046210313,0.012023642199976677
2020,FLORIDA,LEVY,6205,191,16749,23145,0.26809246057463815,0.7236552171095268,0.008252322315834953
2020,FLORIDA,LIBERTY,694,21,2846,3561,0.19488907610221848,0.7992137040157259,0.005897219882055603
2020,FLORIDA,MADISON,3747,57,5576,9380,0.39946695095948825,0.594456289978678,0.0060767590618336885
2020,FLORIDA,MANATEE,90166,1805,124987,216958,0.41559195789046727,0.5760884595175103,0.00831958259202242
2020,FLORIDA,MARION,74858,1692,127826,204376,0.36627588366540104,0.6254452577602067,0.008278858574392296
2020,FLORIDA,MARTIN,36893,665,61168,98726,0.3736908210603083,0.6195733646658428,0.006735814273848834
2020,FLORIDA,MIAMI-DADE,617864,6119,532833,1156816,0.5341074120689894,0.4606030691138435,0.00528951881716712
2020,FLORIDA,MONROE,21881,455,25693,48029,0.4555789210685211,0.5349476358033688,0.0094734431281101
2020,FLORIDA,NASSAU,15564,681,42566,58811,0.2646443692506504,0.7237761643230008,0.011579466426348812
2020,FLORIDA,OKALOOSA,34248,2327,79798,116373,0.29429506844371117,0.6857088843632114,0.019996047193077432
2020,FLORIDA,OKEECHOBEE,4390,94,11470,15954,0.2751661025448163,0.7189419581296227,0.005891939325560988
2020,FLORIDA,ORANGE,395014,6991,245398,647403,0.6101516366158328,0.37904983449258034,0.010798528891586848
2020,FLORIDA,OSCEOLA,97297,1659,73480,172436,0.5642499246097102,0.4261291145700434,0.009620960820246353
2020,FLORIDA,PALM BEACH,433572,4875,334711,773158,0.5607805907718733,0.43291410035206257,0.006305308876064142
2020,FLORIDA,PASCO,119073,3276,179621,301970,0.39432062787694144,0.5948306123124814,0.010848759810577209
2020,FLORIDA,PINELLAS,277450,6056,276209,559715,0.49569870380461484,0.493481503979704,0.010819792215681195
2020,FLORIDA,POLK,145049,3621,194586,343256,0.42256799589810523,0.5668830260796607,0.010548978022234133
2020,FLORIDA,PUTNAM,10527,332,25514,36373,0.2894179748714706,0.7014543754983091,0.009127649630220218
2020,FLORIDA,SANTA ROSA,27612,1931,77385,106928,0.258229836899596,0.7237112823582224,0.018058880742181656
2020,FLORIDA,SARASOTA,120110,2095,148370,270575,0.4439064954264067,0.5483507345467985,0.007742770026794789
2020,FLORIDA,SEMINOLE,132528,3046,125241,260815,0.5081302839177194,0.48019093993827044,0.011678776144010122
2020,FLORIDA,ST. JOHNS,63850,1826,110946,176622,0.3615064940947334,0.6281550429731291,0.01033846293213756
2020,FLORIDA,ST. LUCIE,84137,1201,86831,172169,0.48868843984689464,0.5043358560484176,0.006975704104687836
2020,FLORIDA,SUMTER,29341,383,62761,92485,0.3172514461804617,0.6786073417310915,0.004141212088446775
2020,FLORIDA,SUWANNEE,4485,162,16410,21057,0.21299330388944293,0.7793132924918079,0.00769340361874911
2020,FLORIDA,TAYLOR,2299,77,7751,10127,0.2270168855534709,0.7653796780882789,0.007603436358250222
2020,FLORIDA,UNION,1053,59,5133,6245,0.16861489191353082,0.821937550040032,0.00944755804643715
2020,FLORIDA,VOLUSIA,130575,3043,173821,307439,0.4247183994223244,0.5653837021327808,0.00989789844489476
2020,FLORIDA,WAKULLA,5351,179,12874,18404,0.2907520104325147,0.6995218430775918,0.009726146489893502
2020,FLORIDA,WALTON,10338,426,32947,43711,0.23650797282148658,0.7537461966095491,0.009745830568964334
2020,FLORIDA,WASHINGTON,2347,104,9876,12327,0.19039506773748682,0.8011681674373327,0.008436764825180498
2020,HAWAII,HAWAII,58731,2186,26897,87814,0.6688113512651741,0.3062951237843624,0.02489352495046348
2020,HAWAII,HONOLULU,238866,6986,136250,382102,0.6251367435920252,0.3565801801613182,0.018283076246656652
2020,HAWAII,KAUAI,21225,690,11582,33497,0.6336388333283578,0.3457623070722751,0.02059885959936711
2020,HAWAII,MAUI,47305,1613,22126,71044,0.6658549631214459,0.311440797252407,0.022704239626147177
2020,IDAHO,ADA,120539,8151,130699,259389,0.46470359190250937,0.5038725620593009,0.03142384603818975
2020,IDAHO,ADAMS,591,54,1941,2586,0.228538283062645,0.7505800464037123,0.02088167053364269
2020,IDAHO,BANNOCK,14682,1540,23331,39553,0.37119813920562283,0.5898667610547872,0.03893509973958992
2020,IDAHO,BEAR LAKE,350,51,2914,3315,0.10558069381598793,0.8790346907993967,0.015384615384615385
2020,IDAHO,BENEWAH,977,118,3878,4973,0.1964608887995174,0.779810979288156,0.023728131912326565
2020,IDAHO,BINGHAM,4124,577,15295,19996,0.20624124824964993,0.7649029805961193,0.028855771154230846
2020,IDAHO,BLAINE,8919,338,4032,13289,0.6711565956806381,0.30340883437429456,0.025434569945067348
2020,IDAHO,BOISE,1204,131,3485,4820,0.24979253112033195,0.7230290456431535,0.027178423236514523
2020,IDAHO,BONNER,8310,656,18369,27335,0.30400585330162794,0.671995610023779,0.023998536674593014
2020,IDAHO,BONNEVILLE,14254,1936,37805,53995,0.26398740624131867,0.700157421983517,0.03585517177516437
2020,IDAHO,BOUNDARY,1220,156,4937,6313,0.19325201964200855,0.7820370663709805,0.02471091398701093
2020,IDAHO,BUTTE,188,25,1202,1415,0.13286219081272085,0.8494699646643109,0.0176678445229682
2020,IDAHO,CAMAS,149,98,507,754,0.1976127320954907,0.6724137931034483,0.129973474801061
2020,IDAHO,CANYON,25881,2770,61759,90410,0.28626258157283485,0.6830992146886407,0.030638203738524498
2020,IDAHO,CARIBOU,431,79,2906,3416,0.12617096018735363,0.8507025761124122,0.023126463700234193
2020,IDAHO,CASSIA,1464,258,7907,9629,0.15204071035413855,0.8211652300342714,0.02679405961158999
2020,IDAHO,CLARK,41,6,264,311,0.13183279742765272,0.8488745980707395,0.01929260450160772
2020,IDAHO,CLEARWATER,877,89,3453,4419,0.1984611903145508,0.781398506449423,0.02014030323602625
2020,IDAHO,CUSTER,603,47,2089,2739,0.22015334063526834,0.7626871120847024,0.01715954728002921
2020,IDAHO,ELMORE,2601,358,7246,10205,0.254875061244488,0.7100440960313572,0.03508084272415483
2020,IDAHO,FRANKLIN,657,162,5845,6664,0.09858943577430973,0.8771008403361344,0.024309723889555823
2020,IDAHO,FREMONT,998,173,5548,6719,0.14853400803691025,0.8257181128144069,0.025747879148682838
2020,IDAHO,GEM,1803,204,7951,9958,0.1810604539064069,0.7984535047198232,0.020486041373769835
2020,IDAHO,GOODING,1256,135,4659,6050,0.20760330578512395,0.7700826446280992,0.02231404958677686
2020,IDAHO,IDAHO,1561,215,7826,9602,0.16257029785461363,0.8150385336388253,0.022391168506561133
2020,IDAHO,JEFFERSON,1661,413,12099,14173,0.11719466591406195,0.8536654201651026,0.02913991392083539
2020,IDAHO,JEROME,1893,185,5734,7812,0.2423195084485407,0.7339989759344598,0.023681515616999486
2020,IDAHO,KOOTENAI,24312,2318,62837,89467,0.27174265371589523,0.7023483519062895,0.025908994377815284
2020,IDAHO,LATAH,10236,862,9472,20570,0.4976178901312591,0.46047642197374816,0.04190568789499271
2020,IDAHO,LEMHI,1032,114,3592,4738,0.2178134233853947,0.7581257914731955,0.024060785141409878
2020,IDAHO,LEWIS,349,32,1489,1870,0.18663101604278076,0.7962566844919786,0.017112299465240642
2020,IDAHO,LINCOLN,414,57,1469,1940,0.2134020618556701,0.7572164948453608,0.029381443298969072
2020,IDAHO,MADISON,2666,887,13559,17112,0.15579710144927536,0.7923679289387564,0.05183496961196821
2020,IDAHO,MINIDOKA,1550,178,6265,7993,0.1939196797197548,0.7838108344801702,0.022269485800075067
2020,IDAHO,NEZ PERCE,6686,543,13738,20967,0.31888205274955883,0.6552201077884294,0.025897839462011733
2020,IDAHO,ONEIDA,249,54,2148,2451,0.10159118727050184,0.8763769889840881,0.022031823745410038
2020,IDAHO,OWYHEE,816,107,3819,4742,0.1720792914382117,0.8053563897089836,0.022564318852804723
2020,IDAHO,PAYETTE,2161,270,8862,11293,0.1913574780837687,0.7847339059594439,0.02390861595678739
2020,IDAHO,POWER,865,93,2116,3074,0.2813923227065712,0.6883539362394274,0.0302537410540013
2020,IDAHO,SHOSHONE,1693,140,4216,6049,0.27988097206149776,0.6969747065630683,0.023144321375433957
2020,IDAHO,TETON,3318,171,2858,6347,0.5227666614148416,0.4502914762880101,0.026941862297148258
2020,IDAHO,TWIN FALLS,9391,1213,25897,36501,0.25728062244870004,0.7094874113037999,0.03323196624750007
2020,IDAHO,VALLEY,2976,140,3947,7063,0.4213507008353391,0.5588276936146114,0.019821605550049554
2020,IDAHO,WASHINGTON,1073,117,4154,5344,0.20078592814371257,0.7773203592814372,0.0218937125748503
2020,ILLINOIS,ADAMS,8633,674,24220,33527,0.25749396009186626,0.7224028395024905,0.02010320040564321
2020,ILLINOIS,ALEXANDER,1114,18,1486,2618,0.4255156608097785,0.5676088617265088,0.006875477463712758
2020,ILLINOIS,BOND,2288,232,5625,8145,0.2809085328422345,0.6906077348066298,0.028483732351135667
2020,ILLINOIS,BOONE,10542,554,13883,24979,0.4220345089875495,0.5557868609632091,0.022178630049241362
2020,ILLINOIS,BROWN,486,104,1931,2521,0.192780642602142,0.7659658865529552,0.041253470844902815
2020,ILLINOIS,BUREAU,6669,354,10411,17434,0.38252839279568657,0.5971664563496616,0.02030515085465183
2020,ILLINOIS,CALHOUN,677,49,2046,2772,0.24422799422799424,0.7380952380952381,0.017676767676767676
2020,ILLINOIS,CARROLL,2748,171,5105,8024,0.3424725822532403,0.6362163509471586,0.021311066799601198
2020,ILLINOIS,CASS,1615,77,3625,5317,0.3037427120556705,0.6817754372766598,0.014481850667669738
2020,ILLINOIS,CHAMPAIGN,57067,2790,35285,95142,0.5998087069853482,0.3708667045048454,0.029324588509806394
2020,ILLINOIS,CHRISTIAN,4335,306,11563,16204,0.2675265366576154,0.7135892372253765,0.018884226117008147
2020,ILLINOIS,CLARK,1993,137,6226,8356,0.23851124940162757,0.7450933460986118,0.016395404499760652
2020,ILLINOIS,CLAY,1129,128,5629,6886,0.163955852454255,0.8174557072320651,0.01858844031367993
2020,ILLINOIS,CLINTON,4493,373,14304,19170,0.23437663015127805,0.7461658841940532,0.019457485654668753
2020,ILLINOIS,COLES,8067,502,14037,22606,0.35685216314252854,0.6209413430062816,0.02220649385118995
2020,ILLINOIS,COOK,1725973,37244,558269,2321486,0.7434776690447412,0.24047915860789168,0.01604317234736716
2020,ILLINOIS,CRAWFORD,2202,180,7043,9425,0.2336339522546419,0.7472679045092838,0.01909814323607427
2020,ILLINOIS,CUMBERLAND,1142,89,4601,5832,0.19581618655692729,0.788923182441701,0.015260631001371741
2020,ILLINOIS,DE WITT,2191,201,5632,8024,0.27305583250249255,0.7018943170488534,0.02504985044865404
2020,ILLINOIS,DEKALB,24643,1277,21905,47825,0.5152744380554104,0.45802404600104546,0.026701515943544172
2020,ILLINOIS,DOUGLAS,2335,176,6227,8738,0.2672236209658961,0.7126344701304647,0.020141908903639278
2020,ILLINOIS,DUPAGE,281222,10271,193611,485104,0.5797148652660048,0.3991123552887628,0.021172779445232364
2020,ILLINOIS,EDGAR,1887,116,6193,8196,0.23023426061493413,0.7556124938994632,0.014153245485602733
2020,ILLINOIS,EDWARDS,488,45,2833,3366,0.14497920380273321,0.8416518122400475,0.013368983957219251
2020,ILLINOIS,EFFINGHAM,3716,327,15006,19049,0.19507585700036748,0.7877578875531523,0.01716625544648013
2020,ILLINOIS,FAYETTE,1826,175,8055,10056,0.18158313444709626,0.8010143198090692,0.017402545743834527
2020,ILLINOIS,FORD,1754,151,5048,6953,0.252265209262189,0.7260175463828563,0.021717244354954694
2020,ILLINOIS,FRANKLIN,4760,244,13622,18626,0.25555674863094596,0.7313432835820896,0.013099967786964458
2020,ILLINOIS,FULTON,6503,308,9867,16678,0.3899148578966303,0.5916176999640245,0.018467442139345244
2020,ILLINOIS,GALLATIN,622,33,2019,2674,0.23261032161555723,0.7550486163051608,0.012341062079281975
2020,ILLINOIS,GREENE,1349,108,4770,6227,0.21663722498795568,0.7660189497350249,0.017343825277019432
2020,ILLINOIS,GRUNDY,9626,542,16523,26691,0.36064591060657153,0.6190476190476191,0.02030647034580945
2020,ILLINOIS,HAMILTON,824,59,3432,4315,0.19096176129779838,0.7953650057937428,0.013673232908458864
2020,ILLINOIS,HANCOCK,2315,162,6906,9383,0.2467227965469466,0.7360119364808697,0.017265266972183738
2020,ILLINOIS,HARDIN,449,22,1691,2162,0.20767807585568918,0.7821461609620721,0.010175763182238668
2020,ILLINOIS,HENDERSON,1187,66,2394,3647,0.3254729914998629,0.6564299424184261,0.018097066081710994
2020,ILLINOIS,HENRY,9797,538,15300,25635,0.38217281061049346,0.5968402574605032,0.020986931929003316
2020,ILLINOIS,IROQUOIS,2908,240,10877,14025,0.2073440285204991,0.7755436720142602,0.017112299465240642
2020,ILLINOIS,JACKSON,11181,572,10890,22643,0.49379499182970454,0.4809433378969218,0.02526167027337367
2020,ILLINOIS,JASPER,1007,75,4494,5576,0.18059540889526543,0.8059540889526542,0.013450502152080344
2020,ILLINOIS,JEFFERSON,4608,320,12476,17404,0.26476672029418524,0.7168467019076075,0.018386577798207307
2020,ILLINOIS,JERSEY,2961,264,8712,11937,0.24805227444081426,0.7298316159839155,0.022116109575270167
2020,ILLINOIS,JO DAVIESS,5109,221,7166,12496,0.40885083226632524,0.5734635083226632,0.017685659411011523
2020,ILLINOIS,JOHNSON,1281,97,5059,6437,0.19900574801926363,0.7859251203977008,0.015069131583035576
2020,ILLINOIS,KANE,130166,4935,96775,231876,0.561360382273284,0.4173566906449999,0.02128292708171609
2020,ILLINOIS,KANKAKEE,20271,1099,28532,49902,0.4062161837200914,0.5717606508757164,0.022023165404192215
2020,ILLINOIS,KENDALL,33168,1314,29492,63974,0.5184606246287554,0.4609997811610967,0.020539594210147873
2020,ILLINOIS,KNOX,10703,431,12009,23143,0.46247245387374153,0.5189042042950353,0.018623341831223265
2020,ILLINOIS,LAKE,204032,6551,123594,334177,0.6105506961879483,0.3698459199765394,0.019603383835512318
2020,ILLINOIS,LASALLE,22442,1036,30113,53591,0.41876434475938124,0.5619040510533485,0.01933160418727025
2020,ILLINOIS,LAWRENCE,1419,106,4886,6411,0.2213383247543285,0.7621275931991889,0.016534082046482608
2020,ILLINOIS,LEE,6407,360,9630,16397,0.39074220894065986,0.58730255534549,0.021955235713850094
2020,ILLINOIS,LIVINGSTON,4615,351,12208,17174,0.2687201583789449,0.710841970420403,0.020437871200652147
2020,ILLINOIS,LOGAN,3840,318,9136,13294,0.2888521137355198,0.6872273205957575,0.02392056566872273
2020,ILLINOIS,MACON,19847,954,28589,49390,0.4018424782344604,0.5788418708240535,0.019315650941486132
2020,ILLINOIS,MACOUPIN,7365,504,16153,24022,0.3065939555407543,0.6724252768295729,0.0209807676296728
2020,ILLINOIS,MADISON,57836,3272,76031,137139,0.421732694565368,0.5544083010668008,0.02385900436783118
2020,ILLINOIS,MARION,4524,256,12678,17458,0.2591362126245847,0.7262000229121319,0.014663764463283309
2020,ILLINOIS,MARSHALL,2005,132,4197,6334,0.31654562677612885,0.6626144616356173,0.02083991158825387
2020,ILLINOIS,MASON,1985,127,4654,6766,0.29337865799586166,0.6878510198049069,0.01877032219923145
2020,ILLINOIS,MASSAC,1725,91,4997,6813,0.2531924262439454,0.7334507559078233,0.013356817848231322
2020,ILLINOIS,MCDONOUGH,4992,266,7027,12285,0.40634920634920635,0.571998371998372,0.021652421652421653
2020,ILLINOIS,MCHENRY,78154,3465,82260,163879,0.47690064010641997,0.5019557112259655,0.02114364866761452
2020,ILLINOIS,MCLEAN,43933,2567,40502,87002,0.5049654030941817,0.4655295280568263,0.029505068848991976
2020,ILLINOIS,MENARD,2022,142,4764,6928,0.2918591224018476,0.6876443418013857,0.020496535796766743
2020,ILLINOIS,MERCER,3280,195,5418,8893,0.36882941639491734,0.6092432250084336,0.02192735859664905
2020,ILLINOIS,MONROE,6569,437,14142,21148,0.31062038963495364,0.6687157177983734,0.020663892566672972
2020,ILLINOIS,MONTGOMERY,3905,278,9544,13727,0.28447585051358637,0.6952720914985066,0.020252057987907045
2020,ILLINOIS,MORGAN,5076,283,9950,15309,0.3315696649029982,0.6499444771049709,0.01848585799203083
2020,ILLINOIS,MOULTRIE,1662,118,4964,6744,0.24644128113879005,0.736061684460261,0.01749703440094899
2020,ILLINOIS,OGLE,9428,596,16248,26272,0.3588611449451888,0.6184531059683313,0.0226857490864799
2020,ILLINOIS,PEORIA,43578,2143,38252,83973,0.5189525204530028,0.4555273718933467,0.02552010765365058
2020,ILLINOIS,PERRY,2612,128,7313,10053,0.2598229384263404,0.7274445439172387,0.012732517656420968
2020,ILLINOIS,PIATT,3329,245,6248,9822,0.3389330075341071,0.6361229892079007,0.024944003257992262
2020,ILLINOIS,PIKE,1484,133,6332,7949,0.18669014970436532,0.7965781859353378,0.016731664360296893
2020,ILLINOIS,POPE,433,20,1722,2175,0.19908045977011493,0.7917241379310345,0.009195402298850575
2020,ILLINOIS,PULASKI,891,34,1699,2624,0.3395579268292683,0.647484756097561,0.012957317073170731
2020,ILLINOIS,PUTNAM,1338,59,1993,3390,0.39469026548672564,0.587905604719764,0.017404129793510324
2020,ILLINOIS,RANDOLPH,3592,223,11076,14891,0.24121952857430662,0.7438049828755624,0.014975488550130952
2020,ILLINOIS,RICHLAND,1830,144,6089,8063,0.22696266898176856,0.7551779734590103,0.017859357559221134
2020,ILLINOIS,ROCK ISLAND,36691,1464,28603,66758,0.5496120315168219,0.4284580125228437,0.02192995596033434
2020,ILLINOIS,SALINE,2789,174,8103,11066,0.2520332550153624,0.7322429061991687,0.015723838785469003
2020,ILLINOIS,SANGAMON,48917,2350,53485,104752,0.4669791507560715,0.5105869100351306,0.022433939208797923
2020,ILLINOIS,SCHUYLER,1068,65,2773,3906,0.27342549923195086,0.7099334357398873,0.016641065028161803
2020,ILLINOIS,SCOTT,572,51,2114,2737,0.20898794300328827,0.7723785166240409,0.018633540372670808
2020,ILLINOIS,SHELBY,2504,167,9426,12097,0.20699346945523683,0.7792014549061751,0.01380507563858808
2020,ILLINOIS,ST. CLAIR,68325,2616,57150,128091,0.5334098414408507,0.44616717802187505,0.02042298053727428
2020,ILLINOIS,STARK,815,64,2004,2883,0.2826916406520985,0.6951092611862643,0.022199098161637183
2020,ILLINOIS,STEPHENSON,9055,472,12521,22048,0.41069484760522496,0.5678973149492017,0.021407837445573296
2020,ILLINOIS,TAZEWELL,24819,1720,42513,69052,0.35942478132421946,0.61566645426635,0.024908764409430573
2020,ILLINOIS,UNION,2579,146,6161,8886,0.29023182534323655,0.6933378347963088,0.016430339860454647
2020,ILLINOIS,VERMILION,10323,536,20725,31584,0.32684270516717323,0.6561866767983789,0.016970618034447823
2020,ILLINOIS,WABASH,1253,103,4237,5593,0.22403003754693368,0.7575540854639728,0.01841587698909351
2020,ILLINOIS,WARREN,3090,143,4676,7909,0.3906941459097231,0.5912251864963965,0.01808066759388039
2020,ILLINOIS,WASHINGTON,1641,146,6115,7902,0.2076689445709947,0.7738547203239686,0.018476335105036698
2020,ILLINOIS,WAYNE,1187,123,7176,8486,0.1398774452038652,0.845628093330191,0.014494461465943907
2020,ILLINOIS,WHITE,1517,113,5791,7421,0.20441988950276244,0.7803530521493061,0.015227058347931546
2020,ILLINOIS,WHITESIDE,12253,595,14527,27375,0.44759817351598175,0.5306666666666666,0.021735159817351597
2020,ILLINOIS,WILL,183915,6074,155116,345105,0.5329247620289477,0.4494747975253908,0.017600440445661465
2020,ILLINOIS,WILLIAMSON,10206,646,22801,33653,0.30327162511514577,0.6775324636733724,0.019195911211481887
2020,ILLINOIS,WINNEBAGO,64056,2792,60861,127709,0.5015778057928572,0.47655999185648623,0.02186220235065657
2020,ILLINOIS,WOODFORD,6160,473,14799,21432,0.2874206793579694,0.6905095184770437,0.022069802164986937
2020,INDIANA,ADAMS,3236,287,10686,14209,0.22774297980153424,0.7520585544373285,0.020198465761137308
2020,INDIANA,ALLEN,73189,3810,92083,169082,0.432860978696727,0.5446055759927136,0.022533445310559373
2020,INDIANA,BARTHOLOMEW,12934,891,22410,36235,0.35694770249758523,0.6184628121981509,0.024589485304263834
2020,INDIANA,BENTON,1009,98,3007,4114,0.2452600875060768,0.7309188138065144,0.023821098687408847
2020,INDIANA,BLACKFORD,1376,134,3841,5351,0.2571481965987666,0.7178097551859466,0.025042048215286862
2020,INDIANA,BOONE,15244,925,22351,38520,0.395742471443406,0.5802440290758047,0.0240134994807892
2020,INDIANA,BROWN,3036,168,5777,8981,0.33804698808595923,0.643246854470549,0.018706157443491817
2020,INDIANA,CARROLL,2224,185,7086,9495,0.2342285413375461,0.7462875197472354,0.019483938915218536
2020,INDIANA,CASS,4304,342,10552,15198,0.2831951572575339,0.6943018818265562,0.02250296091590999
2020,INDIANA,CLARK,23093,1108,33668,57869,0.3990564896576751,0.5817968169486254,0.019146693393699562
2020,INDIANA,CLAY,2552,216,9499,12267,0.20803782505910165,0.7743539577728866,0.01760821716801174
2020,INDIANA,CLINTON,3361,254,9334,12949,0.25955672252683604,0.720827863155456,0.01961541431770793
2020,INDIANA,CRAWFORD,1355,106,3483,4944,0.2740695792880259,0.7044902912621359,0.021440129449838186
2020,INDIANA,DAVIESS,2169,209,9576,11954,0.18144554124142545,0.8010707712899447,0.017483687468629747
2020,INDIANA,DEARBORN,5446,409,19528,25383,0.21455304731513217,0.7693338060906906,0.016113146594177206
2020,INDIANA,DECATUR,2439,273,9575,12287,0.19850248229836412,0.7792789126719297,0.022218605029706195
2020,INDIANA,DEKALB,4966,425,14237,19628,0.25300590992459754,0.7253413490931323,0.021652740982270227
2020,INDIANA,DELAWARE,20474,890,26827,48191,0.42485111327841296,0.5566807080160195,0.01846817870556743
2020,INDIANA,DUBOIS,6292,445,15033,21770,0.28902158934313277,0.6905374368396876,0.020440973817179606
2020,INDIANA,ELKHART,26108,1307,46972,74387,0.35097530482476774,0.6314544207993332,0.017570274375899014
2020,INDIANA,FAYETTE,2237,144,7755,10136,0.22069850039463298,0.7650947119179163,0.014206787687450671
2020,INDIANA,FLOYD,17511,891,23400,41802,0.4189034017511124,0.5597818286206402,0.02131476962824745
2020,INDIANA,FOUNTAIN,1629,203,6154,7986,0.20398196844477837,0.7705985474580516,0.02541948409717005
2020,INDIANA,FRANKLIN,2137,172,9691,12000,0.17808333333333334,0.8075833333333333,0.014333333333333333
2020,INDIANA,FULTON,2280,173,6694,9147,0.24926205313217448,0.7318246419591122,0.01891330490871324
2020,INDIANA,GIBSON,4023,321,11817,16161,0.24893261555596807,0.7312047521811769,0.01986263226285502
2020,INDIANA,GRANT,8015,601,18543,27159,0.295113958540447,0.6827570970948856,0.02212894436466733
2020,INDIANA,GREENE,3389,292,11103,14784,0.22923430735930736,0.7510146103896104,0.019751082251082252
2020,INDIANA,HAMILTON,88390,4022,101587,193999,0.45562090526239823,0.5236470291083974,0.020732065629204273
2020,INDIANA,HANCOCK,12895,1020,28996,42911,0.30050569783971476,0.6757241732889003,0.02377012887138496
2020,INDIANA,HARRISON,5343,328,14565,20236,0.2640343941490413,0.7197568689464321,0.016208736904526587
2020,INDIANA,HENDRICKS,32604,2099,53802,88505,0.36838596689452574,0.6078978588780295,0.023716174227444778
2020,INDIANA,HENRY,5544,443,15043,21030,0.263623395149786,0.7153114598193058,0.021065145030908228
2020,INDIANA,HOWARD,13303,878,26449,40630,0.327418163918287,0.6509721880383953,0.021609648043317744
2020,INDIANA,HUNTINGTON,4255,427,13147,17829,0.23865612204834818,0.7373941331538505,0.023949744797801334
2020,INDIANA,JACKSON,4302,381,14555,19238,0.22361991891048966,0.7565755276016218,0.019804553487888555
2020,INDIANA,JASPER,3798,294,11383,15475,0.2454281098546042,0.7355735056542811,0.0189983844911147
2020,INDIANA,JAY,1926,174,6361,8461,0.22763266753338848,0.7518023874246543,0.020564945041957217
2020,INDIANA,JEFFERSON,4731,303,9663,14697,0.32190242906715655,0.6574811185956317,0.020616452337211676
2020,INDIANA,JENNINGS,2523,238,9490,12251,0.20594237205126112,0.774630642396539,0.01942698555219982
2020,INDIANA,JOHNSON,24736,1663,51219,77618,0.31868896390012624,0.6598855935478883,0.021425442551985363
2020,INDIANA,KNOX,4067,289,11655,16011,0.2540128661545188,0.7279370432827431,0.018050090562738118
2020,INDIANA,KOSCIUSKO,8364,924,26499,35787,0.23371615391063794,0.7404644144521754,0.02581943163718669
2020,INDIANA,LAGRANGE,2355,168,8110,10633,0.22148029718799964,0.7627198344775699,0.015799868334430547
2020,INDIANA,LAKE,124870,3326,91760,219956,0.5677044499809053,0.41717434395970104,0.015121206059393696
2020,INDIANA,LAPORTE,22427,968,25997,49392,0.45406138645934563,0.5263402980239715,0.019598315516682865
2020,INDIANA,LAWRENCE,4961,463,15601,21025,0.23595719381688465,0.7420214030915576,0.02202140309155767
2020,INDIANA,MADISON,19524,1054,31215,51793,0.3769621377406213,0.6026876218794045,0.020350240379974127
2020,INDIANA,MARION,247772,7672,134175,389619,0.6359340791901832,0.34437488931494614,0.01969103149487063
2020,INDIANA,MARSHALL,5712,371,13844,19927,0.28664625884478345,0.6947357856175039,0.01861795553771265
2020,INDIANA,MARTIN,1011,104,4029,5144,0.19653965785381025,0.7832426127527217,0.02021772939346812
2020,INDIANA,MIAMI,3235,313,10925,14473,0.22351965729289022,0.7548538658191114,0.02162647688799834
2020,INDIANA,MONROE,39861,1219,22071,63151,0.6312014061535051,0.3494956532754826,0.019302940571012336
2020,INDIANA,MONTGOMERY,4213,326,12659,17198,0.24497034538899873,0.736073962088615,0.018955692522386325
2020,INDIANA,MORGAN,7781,866,27512,36159,0.21518847313255343,0.7608617494952847,0.02394977737216184
2020,INDIANA,NEWTON,1509,140,4942,6591,0.22894856622667273,0.7498103474434835,0.021241086329843728
2020,INDIANA,NOBLE,4660,335,14195,19190,0.24283480979676916,0.7397081813444503,0.017457008858780616
2020,INDIANA,OHIO,668,353,2054,3075,0.21723577235772357,0.6679674796747967,0.11479674796747967
2020,INDIANA,ORANGE,2224,176,6432,8832,0.25181159420289856,0.7282608695652174,0.019927536231884056
2020,INDIANA,OWEN,2420,198,7286,9904,0.24434571890145396,0.7356623586429726,0.019991922455573505
2020,INDIANA,PARKE,1503,110,5400,7013,0.21431626978468557,0.7699985740767147,0.015685156138599745
2020,INDIANA,PERRY,3203,174,5345,8722,0.3672322861728961,0.6128181609722541,0.019949552854849804
2020,INDIANA,PIKE,1415,113,4692,6220,0.227491961414791,0.7543408360128617,0.018167202572347267
2020,INDIANA,PORTER,39746,1755,45008,86509,0.45944352610711026,0.5202695673282549,0.020286906564634895
2020,INDIANA,POSEY,3811,219,9206,13236,0.2879268661226957,0.695527349652463,0.01654578422484134
2020,INDIANA,PULASKI,1463,97,4246,5806,0.2519807096107475,0.7313124354116431,0.01670685497760937
2020,INDIANA,PUTNAM,3946,373,12278,16597,0.2377538109296861,0.7397722479966259,0.022473941073688015
2020,INDIANA,RANDOLPH,2513,245,8312,11070,0.22700993676603431,0.7508581752484191,0.022131887985546522
2020,INDIANA,RIPLEY,2774,236,11261,14271,0.1943802116179665,0.7890827552378951,0.01653703314413846
2020,INDIANA,RUSH,1754,143,6035,7932,0.2211296016137166,0.7608421583459405,0.018028240040342914
2020,INDIANA,SCOTT,2701,135,7331,10167,0.26566342087144684,0.721058325956526,0.013278253172027146
2020,INDIANA,SHELBY,5023,400,14568,19991,0.25126306838077134,0.7287279275674053,0.02000900405182332
2020,INDIANA,SPENCER,3213,199,7357,10769,0.2983563933512861,0.6831646392422694,0.018478967406444422
2020,INDIANA,ST. JOSEPH,59896,2178,53164,115238,0.5197591072389316,0.4613408771412208,0.01890001561984762
2020,INDIANA,STARKE,2650,174,7466,10290,0.2575315840621963,0.7255587949465501,0.016909620991253645
2020,INDIANA,STEUBEN,4513,322,11327,16162,0.2792352431629749,0.7008414800148497,0.019923276822175474
2020,INDIANA,SULLIVAN,2153,150,6691,8994,0.2393818100956193,0.7439404047142539,0.01667778519012675
2020,INDIANA,SWITZERLAND,964,57,3133,4154,0.23206547905633124,0.7542128069330766,0.0137217140105922
2020,INDIANA,TIPPECANOE,35017,1850,34581,71448,0.4901046915239055,0.48400235136042996,0.025892957115664538
2020,INDIANA,TIPTON,1834,172,6110,8116,0.2259733859043864,0.7528339083292263,0.021192705766387383
2020,INDIANA,UNION,736,59,2688,3483,0.21131208728107953,0.7717484926787253,0.016939420040195233
2020,INDIANA,VANDERBURGH,34415,1403,41844,77662,0.44313821431330636,0.538796322525817,0.018065463160876618
2020,INDIANA,VERMILLION,2145,152,5184,7481,0.2867263734794814,0.692955487234327,0.020318139286191684
2020,INDIANA,VIGO,18123,926,24545,43594,0.4157223471119879,0.5630361976418773,0.02124145524613479
2020,INDIANA,WABASH,3494,320,10762,14576,0.23970911086717892,0.7383369923161361,0.021953896816684963
2020,INDIANA,WARREN,974,97,3401,4472,0.21779964221824688,0.7605098389982111,0.02169051878354204
2020,INDIANA,WARRICK,11923,580,21326,33829,0.3524490821484525,0.6304058647905643,0.01714505306098318
2020,INDIANA,WASHINGTON,2784,241,9114,12139,0.22934343850399538,0.7508031963094159,0.01985336518658868
2020,INDIANA,WAYNE,9524,588,17567,27679,0.3440875754181871,0.6346688825463348,0.02124354203547816
2020,INDIANA,WELLS,2928,267,10855,14050,0.20839857651245552,0.7725978647686833,0.01900355871886121
2020,INDIANA,WHITE,3032,177,7957,11166,0.27153859931936236,0.7126097080422712,0.01585169263836647
2020,INDIANA,WHITLEY,4234,460,12862,17556,0.24117110959216223,0.7326270221007063,0.026201868307131466
2020,KANSAS,ALLEN,1570,104,4218,5892,0.2664630006788866,0.7158859470468432,0.017651052274270197
2020,KANSAS,ANDERSON,782,81,2929,3792,0.20622362869198313,0.772415611814346,0.021360759493670885
2020,KANSAS,ATCHISON,2359,175,4906,7440,0.3170698924731183,0.6594086021505376,0.023521505376344086
2020,KANSAS,BARBER,291,37,2014,2342,0.12425277540563621,0.8599487617421008,0.015798462852263023
2020,KANSAS,BARTON,2340,182,8608,11130,0.21024258760107817,0.7734052111410602,0.016352201257861635
2020,KANSAS,BOURBON,1541,112,5023,6676,0.23082684242061113,0.7523966446974236,0.016776512881965248
2020,KANSAS,BROWN,1104,105,3262,4471,0.24692462536345336,0.7295906955938268,0.02348467904271975
2020,KANSAS,BUTLER,9181,705,22634,32520,0.28231857318573184,0.6960024600246002,0.021678966789667898
2020,KANSAS,CHASE,345,23,1123,1491,0.23138832997987926,0.7531857813547954,0.015425888665325285
2020,KANSAS,CHAUTAUQUA,212,25,1402,1639,0.1293471629042099,0.8553996339231239,0.01525320317266626
2020,KANSAS,CHEROKEE,2194,168,6766,9128,0.24035933391761613,0.7412357581069238,0.018404907975460124
2020,KANSAS,CHEYENNE,224,22,1183,1429,0.15675297410776767,0.827851644506648,0.015395381385584325
2020,KANSAS,CLARK,143,20,904,1067,0.13402061855670103,0.8472352389878163,0.01874414245548266
2020,KANSAS,CLAY,894,111,3177,4182,0.21377331420373027,0.7596843615494978,0.02654232424677188
2020,KANSAS,CLOUD,920,101,3242,4263,0.21581046211588084,0.7604973023692235,0.023692235514895615
2020,KANSAS,COFFEY,964,112,3489,4565,0.21117196056955093,0.7642935377875137,0.02453450164293538
2020,KANSAS,COMANCHE,126,28,762,916,0.13755458515283842,0.8318777292576419,0.03056768558951965
2020,KANSAS,COWLEY,4273,302,9656,14231,0.30025999578385215,0.6785187267233505,0.021221277492797414
2020,KANSAS,CRAWFORD,6179,421,10045,16645,0.371222589366176,0.6034845298888555,0.02529288074496846
2020,KANSAS,DECATUR,218,20,1260,1498,0.14552736982643524,0.8411214953271028,0.01335113484646195
2020,KANSAS,DICKINSON,2060,163,7126,9349,0.2203444218633009,0.7622205583484865,0.017435019788212644
2020,KANSAS,DONIPHAN,686,47,2976,3709,0.18495551361552978,0.8023726071717444,0.012671879212725803
2020,KANSAS,DOUGLAS,40785,1424,17286,59495,0.6855197915791243,0.29054542398520883,0.023934784435666864
2020,KANSAS,EDWARDS,271,19,1141,1431,0.1893780573025856,0.7973445143256463,0.013277428371767994
2020,KANSAS,ELK,195,26,1140,1361,0.14327700220426157,0.8376193975018369,0.019103600293901544
2020,KANSAS,ELLIS,3737,305,9758,13800,0.2707971014492754,0.7071014492753623,0.02210144927536232
2020,KANSAS,ELLSWORTH,648,57,2148,2853,0.22712933753943218,0.7528916929547844,0.019978969505783387
2020,KANSAS,FINNEY,4325,239,7236,11800,0.3665254237288136,0.6132203389830508,0.020254237288135593
2020,KANSAS,FORD,2947,165,5803,8915,0.33056646102075155,0.6509254066180594,0.018508132361189006
2020,KANSAS,FRANKLIN,3690,308,8479,12477,0.29574416927145947,0.6795704095535786,0.02468542117496193
2020,KANSAS,GEARY,3983,297,5323,9603,0.4147662188899302,0.5543059460585233,0.030927835051546393
2020,KANSAS,GOVE,166,14,1291,1471,0.11284840244731476,0.8776342624065262,0.009517335146159076
2020,KANSAS,GRAHAM,228,29,1080,1337,0.1705310396409873,0.8077786088257293,0.02169035153328347
2020,KANSAS,GRANT,518,47,1936,2501,0.20711715313874451,0.7740903638544582,0.01879248300679728
2020,KANSAS,GRAY,341,36,1911,2288,0.14903846153846154,0.8352272727272727,0.015734265734265736
2020,KANSAS,GREELEY,78,14,549,641,0.12168486739469579,0.8564742589703588,0.0218408736349454
2020,KANSAS,GREENWOOD,569,64,2444,3077,0.18492037699057523,0.7942801429964251,0.020799480012999676
2020,KANSAS,HAMILTON,141,20,698,859,0.16414435389988358,0.8125727590221188,0.023282887077997673
2020,KANSAS,HARPER,461,49,2168,2678,0.17214339058999253,0.8095593726661687,0.018297236743838687
2020,KANSAS,HARVEY,6747,380,10182,17309,0.389797215321509,0.588248887861806,0.021953896816684963
2020,KANSAS,HASKELL,268,20,1122,1410,0.1900709219858156,0.7957446808510639,0.014184397163120567
2020,KANSAS,HODGEMAN,154,16,875,1045,0.14736842105263157,0.8373205741626795,0.015311004784688996
2020,KANSAS,JACKSON,1881,186,4517,6584,0.2856925880923451,0.6860571081409478,0.028250303766707167
2020,KANSAS,JEFFERSON,3194,254,6334,9782,0.3265180944592108,0.6475158454303823,0.02596606011040687
2020,KANSAS,JEWELL,212,29,1387,1628,0.13022113022113022,0.851965601965602,0.017813267813267815
2020,KANSAS,JOHNSON,184259,7324,155631,347214,0.5306784864665596,0.4482278940365308,0.021093619496909688
2020,KANSAS,KEARNY,267,24,1164,1455,0.18350515463917524,0.8,0.016494845360824743
2020,KANSAS,KINGMAN,752,67,3130,3949,0.19042795644466953,0.7926057229678399,0.016966320587490504
2020,KANSAS,KIOWA,156,29,980,1165,0.13390557939914163,0.8412017167381974,0.024892703862660945
2020,KANSAS,LABETTE,2655,173,5735,8563,0.31005488730585073,0.6697419128809996,0.020203199813149598
2020,KANSAS,LANE,115,18,762,895,0.12849162011173185,0.8513966480446927,0.02011173184357542
2020,KANSAS,LEAVENWORTH,13886,994,21610,36490,0.3805426144149082,0.5922170457659632,0.027240339819128528
2020,KANSAS,LINCOLN,266,30,1283,1579,0.16846105129829006,0.8125395820139328,0.018999366687777075
2020,KANSAS,LINN,896,102,4048,5046,0.17756638921918352,0.8022195798652398,0.020214030915576695
2020,KANSAS,LOGAN,186,23,1249,1458,0.12757201646090535,0.8566529492455418,0.01577503429355281
2020,KANSAS,LYON,6055,383,7550,13988,0.4328710323134115,0.5397483557334859,0.02738061195310266
2020,KANSAS,MARION,1516,130,4465,6111,0.24807723776795942,0.7306496481754213,0.021273114056619212
2020,KANSAS,MARSHALL,1259,126,3729,5114,0.2461869378177552,0.7291748142354322,0.024638247946812672
2020,KANSAS,MCPHERSON,4134,340,9964,14438,0.28632774622523893,0.6901232857736529,0.023548968001108186
2020,KANSAS,MEADE,263,39,1523,1825,0.1441095890410959,0.8345205479452055,0.021369863013698632
2020,KANSAS,MIAMI,5247,382,12308,17937,0.29252383341695937,0.6861794056977198,0.021296760885320846
2020,KANSAS,MITCHELL,558,39,2504,3101,0.1799419542083199,0.8074814575943244,0.012576588197355692
2020,KANSAS,MONTGOMERY,3228,267,9931,13426,0.24042901832265753,0.7396841948458215,0.01988678683152093
2020,KANSAS,MORRIS,729,46,2124,2899,0.2514660227664712,0.7326664367023111,0.01586754053121766
2020,KANSAS,MORTON,150,14,1034,1198,0.12520868113522537,0.8631051752921536,0.011686143572621035
2020,KANSAS,NEMAHA,927,93,4664,5684,0.1630893736805067,0.8205489092188599,0.016361717100633357
2020,KANSAS,NEOSHO,1796,111,4970,6877,0.26116038970481315,0.7226988512432747,0.01614075905191217
2020,KANSAS,NESS,149,25,1339,1513,0.09847984137475214,0.8849966953073364,0.016523463317911435
2020,KANSAS,NORTON,364,44,2007,2415,0.15072463768115943,0.831055900621118,0.018219461697722567
2020,KANSAS,OSAGE,2136,194,5705,8035,0.2658369632856254,0.7100186683260734,0.024144368388301182
2020,KANSAS,OSBORNE,281,35,1629,1945,0.14447300771208227,0.8375321336760926,0.017994858611825194
2020,KANSAS,OTTAWA,506,75,2610,3191,0.1585709808837355,0.8179254152303354,0.023503603885929175
2020,KANSAS,PAWNEE,643,51,2045,2739,0.2347572106608251,0.74662285505659,0.018619934282584884
2020,KANSAS,PHILLIPS,318,45,2418,2781,0.11434735706580366,0.8694714131607335,0.016181229773462782
2020,KANSAS,POTTAWATOMIE,3313,318,9452,13083,0.25322938164029657,0.7224642666055187,0.02430635175418482
2020,KANSAS,PRATT,933,96,3108,4137,0.22552574329224076,0.751269035532995,0.023205221174764323
2020,KANSAS,RAWLINS,214,29,1261,1504,0.1422872340425532,0.8384308510638298,0.01928191489361702
2020,KANSAS,RENO,8886,612,18443,27941,0.31802727175119,0.6600694320174654,0.02190329623134462
2020,KANSAS,REPUBLIC,424,51,2182,2657,0.15957847196085811,0.8212269476853594,0.01919458035378246
2020,KANSAS,RICE,965,92,3262,4319,0.2234313498495022,0.7552674230145867,0.02130122713591109
2020,KANSAS,RILEY,12765,796,11610,25171,0.5071312224385205,0.4612450836279846,0.031623693933494894
2020,KANSAS,ROOKS,339,35,2325,2699,0.12560207484253427,0.861430159318266,0.012967765839199704
2020,KANSAS,RUSH,295,32,1350,1677,0.1759093619558736,0.8050089445438283,0.01908169350029815
2020,KANSAS,RUSSELL,600,77,2790,3467,0.17306028266512835,0.8047303143928468,0.022209402942024805
2020,KANSAS,SALINE,8214,595,15722,24531,0.334841628959276,0.6409033467856997,0.024255024255024255
2020,KANSAS,SCOTT,299,41,2014,2354,0.127017841971113,0.8555649957519117,0.017417162276975363
2020,KANSAS,SEDGWICK,95870,5402,122416,223688,0.4285880333321412,0.5472622581452737,0.02414970852258503
2020,KANSAS,SEWARD,1833,89,3372,5294,0.34624102757839065,0.6369474877219494,0.01681148469965999
2020,KANSAS,SHAWNEE,43015,2199,40443,85657,0.502177288487806,0.472150553953559,0.02567215755863502
2020,KANSAS,SHERIDAN,147,16,1282,1445,0.10173010380622838,0.8871972318339101,0.011072664359861591
2020,KANSAS,SHERMAN,396,62,2269,2727,0.14521452145214522,0.832049871653832,0.022735606894022736
2020,KANSAS,SMITH,336,30,1763,2129,0.15782057303898545,0.828088304368248,0.014091122592766557
2020,KANSAS,STAFFORD,357,32,1645,2034,0.17551622418879056,0.8087512291052114,0.015732546705998034
2020,KANSAS,STANTON,148,14,614,776,0.19072164948453607,0.7912371134020618,0.01804123711340206
2020,KANSAS,STEVENS,237,34,1760,2031,0.11669128508124077,0.8665681930083703,0.01674052191038897
2020,KANSAS,SUMNER,2591,232,8105,10928,0.237097364568082,0.7416727672035139,0.0212298682284041
2020,KANSAS,THOMAS,625,55,3130,3810,0.16404199475065617,0.821522309711286,0.014435695538057743
2020,KANSAS,TREGO,242,25,1363,1630,0.14846625766871166,0.8361963190184049,0.015337423312883436
2020,KANSAS,WABAUNSEE,964,93,2845,3902,0.24705279343926193,0.7291132752434649,0.023833931317273193
2020,KANSAS,WALLACE,44,11,770,825,0.05333333333333334,0.9333333333333333,0.013333333333333334
2020,KANSAS,WASHINGTON,475,45,2363,2883,0.16475893166840097,0.8196323274366979,0.015608740894901144
2020,KANSAS,WICHITA,149,11,808,968,0.15392561983471073,0.8347107438016529,0.011363636363636364
2020,KANSAS,WILSON,723,78,3153,3954,0.18285280728376327,0.7974203338391502,0.019726858877086494
2020,KANSAS,WOODSON,294,24,1228,1546,0.19016817593790428,0.7943078913324709,0.015523932729624839
2020,KANSAS,WYANDOTTE,36788,1063,18934,56785,0.6478471427313551,0.33343312494496785,0.01871973232367703
2020,LOUISIANA,ACADIA,5443,386,22596,28425,0.19148636763412488,0.794934036939314,0.013579595426561127
2020,LOUISIANA,ALLEN,2108,128,7574,9810,0.2148827726809378,0.7720693170234455,0.013047910295616718
2020,LOUISIANA,ASCENSION,20399,1239,40687,62325,0.32730044123545926,0.6528198957079824,0.019879663056558364
2020,LOUISIANA,ASSUMPTION,3833,131,7271,11235,0.34116599910992434,0.6471740097908322,0.011659991099243436
2020,LOUISIANA,AVOYELLES,4979,285,12028,17292,0.28793661808928983,0.6955817719176498,0.016481609993060375
2020,LOUISIANA,BEAUREGARD,2542,240,13575,16357,0.1554074708076053,0.8299199119642966,0.014672617228098062
2020,LOUISIANA,BIENVILLE,3067,92,3891,7050,0.4350354609929078,0.5519148936170213,0.013049645390070922
2020,LOUISIANA,BOSSIER,15662,919,38074,54655,0.28656115634434176,0.6966242795718598,0.01681456408379837
2020,LOUISIANA,CADDO,55110,1781,48021,104912,0.5252973921000458,0.4577264755223425,0.016976132377611714
2020,LOUISIANA,CALCASIEU,25982,1615,55066,82663,0.3143123283694035,0.6661505147405732,0.019537156890023347
2020,LOUISIANA,CALDWELL,745,41,3976,4762,0.15644687106257874,0.8349433011339773,0.008609827803443932
2020,LOUISIANA,CAMERON,324,44,3671,4039,0.08021787571180986,0.9088883386976975,0.010893785590492696
2020,LOUISIANA,CATAHOULA,1269,48,3541,4858,0.2612186084808563,0.7289007822149033,0.009880609304240428
2020,LOUISIANA,CLAIBORNE,2731,79,3770,6580,0.41504559270516717,0.5729483282674772,0.012006079027355622
2020,LOUISIANA,CONCORDIA,3177,101,5550,8828,0.3598776619845945,0.6286814680561849,0.011440869959220662
2020,LOUISIANA,DE SOTO,5457,167,9112,14736,0.37031758957654726,0.6183496199782845,0.011332790445168295
2020,LOUISIANA,EAST BATON ROUGE,115577,4185,88420,208182,0.5551728775782728,0.424724519891249,0.020102602530478138
2020,LOUISIANA,EAST CARROLL,1900,56,1080,3036,0.6258234519104084,0.3557312252964427,0.01844532279314888
2020,LOUISIANA,EAST FELICIANA,4280,165,6064,10509,0.40726995908269104,0.5770292130554763,0.015700827861832713
2020,LOUISIANA,EVANGELINE,4158,201,11053,15412,0.2697897742019206,0.7171684401764858,0.013041785621593563
2020,LOUISIANA,FRANKLIN,2658,92,6970,9720,0.2734567901234568,0.7170781893004116,0.009465020576131687
2020,LOUISIANA,GRANT,1157,118,8117,9392,0.12318994889267462,0.8642461669505963,0.01256388415672913
2020,LOUISIANA,IBERIA,11027,435,21251,32713,0.33708311680371716,0.649619417357014,0.013297465839268793
2020,LOUISIANA,IBERVILLE,8514,312,7893,16719,0.5092409833123991,0.47209761349363,0.01866140319397093
2020,LOUISIANA,JACKSON,2143,95,5394,7632,0.28079140461215935,0.7067610062893082,0.012447589098532495
2020,LOUISIANA,JEFFERSON,84477,3307,105949,193733,0.43604858232722354,0.5468815328312677,0.017069884841508676
2020,LOUISIANA,JEFFERSON DAVIS,3208,210,11423,14841,0.21615794083956608,0.7696920692675696,0.014149989892864362
2020,LOUISIANA,LA SALLE,638,61,6378,7077,0.09015119400876077,0.9012293344637559,0.008619471527483397
2020,LOUISIANA,LAFAYETTE,39685,2317,72519,114521,0.346530330681709,0.6332375721483396,0.020232097169951363
2020,LOUISIANA,LAFOURCHE,8672,692,36024,45388,0.191063717282101,0.793689962104521,0.015246320613377985
2020,LOUISIANA,LINCOLN,7559,405,11311,19275,0.39216601815823604,0.586822308690013,0.021011673151750974
2020,LOUISIANA,LIVINGSTON,9249,1104,54877,65230,0.1417905871531504,0.8412846849609076,0.016924727885942053
2020,LOUISIANA,MADISON,2654,86,1930,4670,0.5683083511777302,0.4132762312633833,0.01841541755888651
2020,LOUISIANA,MOREHOUSE,4946,118,6510,11574,0.42733713495766373,0.5624675997926387,0.010195265249697598
2020,LOUISIANA,NATCHITOCHES,6896,300,9358,16554,0.41657605412589105,0.5653014377189803,0.01812250815512867
2020,LOUISIANA,ORLEANS,147854,3301,26664,177819,0.8314859491955303,0.14995023029035143,0.018563820514118288
2020,LOUISIANA,OUACHITA,25913,998,42255,69166,0.37464939421102855,0.6109215510510945,0.014429054737876992
2020,LOUISIANA,PLAQUEMINES,3414,188,7412,11014,0.30996913019792993,0.6729616851280189,0.01706918467405121
2020,LOUISIANA,POINTE COUPEE,4683,185,7503,12371,0.37854660092151,0.6064990704065961,0.014954328671893946
2020,LOUISIANA,RAPIDES,19475,1043,38347,58865,0.33084175656162407,0.6514397349868343,0.017718508451541663
2020,LOUISIANA,RED RIVER,1644,75,2413,4132,0.3978702807357212,0.5839787028073572,0.018151016456921586
2020,LOUISIANA,RICHLAND,3225,108,6607,9940,0.3244466800804829,0.6646881287726358,0.010865191146881288
2020,LOUISIANA,SABINE,1731,89,8776,10596,0.16336353340883353,0.8282370705926765,0.008399395998489996
2020,LOUISIANA,ST. BERNARD,6151,320,11179,17650,0.3484985835694051,0.633371104815864,0.018130311614730877
2020,LOUISIANA,ST. CHARLES,9800,484,18233,28517,0.34365466213136026,0.6393730055756216,0.0169723322930182
2020,LOUISIANA,ST. HELENA,3346,98,2714,6158,0.543358233192595,0.4407275089314713,0.015914257875933743
2020,LOUISIANA,ST. JAMES,6510,126,5954,12590,0.517077045274027,0.47291501191421764,0.010007942811755361
2020,LOUISIANA,ST. JOHN THE BAPTIST,13582,312,7538,21432,0.6337252706233669,0.3517170586039567,0.014557670772676373
2020,LOUISIANA,ST. LANDRY,17372,611,23171,41154,0.4221217864606114,0.5630315400690091,0.01484667347037955
2020,LOUISIANA,ST. MARTIN,8439,396,18203,27038,0.31211628078999926,0.6732376655078038,0.014646053702196907
2020,LOUISIANA,ST. MARY,8055,320,14811,23186,0.3474079185715518,0.6387906495298887,0.013801431898559476
2020,LOUISIANA,ST. TAMMANY,37746,2698,99666,140110,0.2694026122332453,0.7113410891442438,0.019256298622510885
2020,LOUISIANA,TANGIPAHOA,18887,968,37806,57661,0.32755241844574323,0.6556598047206951,0.01678777683356168
2020,LOUISIANA,TENSAS,1329,28,1197,2554,0.5203602192638997,0.46867658574784654,0.01096319498825372
2020,LOUISIANA,TERREBONNE,11198,703,34339,46240,0.24217128027681661,0.7426254325259516,0.015203287197231834
2020,LOUISIANA,UNION,2654,140,8407,11201,0.23694313007767165,0.7505579858941166,0.012498884028211766
2020,LOUISIANA,VERMILION,5009,385,21930,27324,0.1833186941882594,0.8025911286780852,0.014090177133655395
2020,LOUISIANA,VERNON,2898,263,14107,17268,0.16782487838776927,0.8169446374797313,0.01523048413249942
2020,LOUISIANA,WASHINGTON,5970,236,13307,19513,0.30594987956746783,0.6819556193307026,0.012094501101829549
2020,LOUISIANA,WEBSTER,6172,214,11830,18216,0.3388230127360562,0.6494290733421169,0.011747913921826966
2020,LOUISIANA,WEST BATON ROUGE,6200,213,7684,14097,0.4398098886287863,0.5450805135844506,0.015109597786763141
2020,LOUISIANA,WEST CARROLL,710,25,4317,5052,0.1405384006334125,0.8545130641330166,0.004948535233570863
2020,LOUISIANA,WEST FELICIANA,2298,107,3863,6268,0.3666241225271219,0.6163050414805361,0.017070835992342055
2020,LOUISIANA,WINN,1543,63,4619,6225,0.2478714859437751,0.7420080321285141,0.010120481927710843
2020,MAINE,ANDROSCOGGIN,27617,2476,29268,59361,0.46523811930392006,0.4930509930762622,0.04171088761981773
2020,MAINE,AROOSTOOK,13956,1174,21080,36210,0.38541839270919637,0.5821596244131455,0.03242198287765811
2020,MAINE,CUMBERLAND,128759,7571,59584,195914,0.6572220464081179,0.30413344630807393,0.0386445072838082
2020,MAINE,FRANKLIN,8069,776,8754,17599,0.4584919597704415,0.49741462583101315,0.044093414398545375
2020,MAINE,HANCOCK,19369,1325,14982,35676,0.5429140038120865,0.4199461823074336,0.03713981388047988
2020,MAINE,KENNEBEC,34902,2992,34721,72615,0.4806444949390622,0.4781518969909798,0.041203608069958
2020,MAINE,KNOX,15110,940,9982,26032,0.580439459127228,0.38345113706207745,0.03610940381069453
2020,MAINE,LINCOLN,12684,917,10256,23857,0.5316678542985287,0.4298947897891604,0.03843735591231085
2020,MAINE,OXFORD,14755,1357,17698,33810,0.43640934634723455,0.5234545992309968,0.04013605442176871
2020,MAINE,PENOBSCOT,37713,3595,44825,86133,0.4378461216955174,0.5204161006815042,0.041737777622978416
2020,MAINE,PISCATAQUIS,3517,336,6143,9996,0.3518407362945178,0.6145458183273309,0.03361344537815126
2020,MAINE,SAGADAHOC,13528,997,9755,24280,0.557166392092257,0.40177100494233936,0.04106260296540362
2020,MAINE,SOMERSET,10199,1030,16644,27873,0.3659096616797618,0.5971370143149284,0.0369533240053098
2020,MAINE,WALDO,12345,1025,11196,24566,0.502523813400635,0.4557518521533827,0.04172433444598225
2020,MAINE,WASHINGTON,6761,615,10194,17570,0.3848036425725669,0.5801935116676152,0.03500284575981787
2020,MAINE,YORK,71189,5036,54817,131042,0.5432533080996932,0.4183162650142702,0.03843042688603654
2020,MASSACHUSETTS,BARNSTABLE,91994,4207,55311,151512,0.6071730291990073,0.36506019325201966,0.02776677754897302
2020,MASSACHUSETTS,BERKSHIRE,51705,2002,18064,71771,0.7204163241420629,0.25168940101155063,0.027894274846386423
2020,MASSACHUSETTS,BRISTOL,153377,8115,119872,281364,0.5451194893447634,0.42603886780114014,0.02884164285409647
2020,MASSACHUSETTS,DUKES,9914,328,2631,12873,0.7701390507263264,0.20438126310883245,0.02547968616484114
2020,MASSACHUSETTS,ESSEX,267198,12564,144837,424599,0.6292949347501996,0.34111479301646963,0.02959027223333074
2020,MASSACHUSETTS,FRANKLIN,30030,1772,11201,43003,0.698323372787945,0.26047019975350555,0.041206427458549404
2020,MASSACHUSETTS,HAMPDEN,125948,7527,87318,220793,0.5704347511017106,0.3954744942095085,0.034090754688780894
2020,MASSACHUSETTS,HAMPSHIRE,63362,2689,22281,88332,0.7173164877960422,0.2522415432685776,0.030441968935380155
2020,MASSACHUSETTS,MIDDLESEX,617196,25195,226956,869347,0.7099535628465964,0.2610649142402286,0.028981522913175062
2020,MASSACHUSETTS,NANTUCKET,5241,183,1914,7338,0.714227309893704,0.2608340147179068,0.024938675388389207
2020,MASSACHUSETTS,NORFOLK,273312,12436,125294,411042,0.664924752215102,0.30482043197532127,0.030254815809576636
2020,MASSACHUSETTS,PLYMOUTH,173630,9013,121227,303870,0.5713956626188831,0.39894362720900384,0.029660710172113074
2020,MASSACHUSETTS,SUFFOLK,270522,8105,58613,337240,0.8021646305301862,0.17380204009014352,0.024033329379670263
2020,MASSACHUSETTS,WORCESTER,248773,14465,171683,434921,0.571995833726125,0.3947452525861018,0.03325891368777318
2020,MICHIGAN,ALCONA,2142,74,4848,7064,0.3032276330690827,0.6862967157417894,0.010475651189127973
2020,MICHIGAN,ALGER,2053,61,3014,5128,0.4003510140405616,0.5877535101404057,0.01189547581903276
2020,MICHIGAN,ALLEGAN,24449,1253,41392,67094,0.3643992011208156,0.6169255074969446,0.018675291382239844
2020,MICHIGAN,ALPENA,6000,283,10686,16969,0.3535859508515528,0.6297365784666156,0.016677470681831574
2020,MICHIGAN,ANTRIM,5960,241,9748,15949,0.37369114051037683,0.6111981942441532,0.015110665245469935
2020,MICHIGAN,ARENAC,2774,129,5928,8831,0.31412071113124224,0.6712716566640244,0.014607632204733326
2020,MICHIGAN,BARAGA,1478,48,2512,4038,0.3660227835562159,0.6220901436354631,0.01188707280832095
2020,MICHIGAN,BARRY,11797,637,23471,35905,0.3285614816877872,0.6536972566494917,0.01774126166272107
2020,MICHIGAN,BAY,26151,979,33125,60255,0.4340054767239233,0.54974690897021,0.016247614305866732
2020,MICHIGAN,BENZIE,5480,181,6601,12262,0.44690915022019245,0.538329799380199,0.014761050399608547
2020,MICHIGAN,BERRIEN,37438,1434,43519,82391,0.45439429063854064,0.5282008957289024,0.017404813632556953
2020,MICHIGAN,BRANCH,6159,313,14064,20536,0.2999123490455785,0.6848461238800155,0.015241527074405922
2020,MICHIGAN,CALHOUN,28877,1183,36221,66281,0.4356753820853638,0.5464763657760142,0.01784825213862193
2020,MICHIGAN,CASS,9130,387,16699,26216,0.3482606042111688,0.6369774183704607,0.01476197741837046
2020,MICHIGAN,CHARLEVOIX,6939,220,9841,17000,0.4081764705882353,0.5788823529411765,0.012941176470588235
2020,MICHIGAN,CHEBOYGAN,5437,245,10186,15868,0.34263927401058736,0.6419208469876481,0.015439879001764557
2020,MICHIGAN,CHIPPEWA,6648,313,10681,17642,0.3768280240335563,0.6054302233306881,0.017741752635755583
2020,MICHIGAN,CLARE,5199,221,10861,16281,0.3193292795282845,0.6670966156869971,0.013574104784718384
2020,MICHIGAN,CLINTON,21968,861,25098,47927,0.4583637615540301,0.5236714169466063,0.017964821499363615
2020,MICHIGAN,CRAWFORD,2672,102,5087,7861,0.339905864393843,0.6471186871899249,0.012975448416232032
2020,MICHIGAN,DELTA,7606,338,13207,21151,0.3596047468204813,0.6244149212803177,0.015980331899200985
2020,MICHIGAN,DICKINSON,4744,228,9617,14589,0.325176502844609,0.6591952841181712,0.015628213037219823
2020,MICHIGAN,EATON,31299,1230,31798,64327,0.4865608531409828,0.4943180934910691,0.01912105336794814
2020,MICHIGAN,EMMET,9662,380,12135,22177,0.43567660188483565,0.5471885286558146,0.017134869459349777
2020,MICHIGAN,GENESEE,119390,3256,98714,221360,0.5393476689555475,0.44594325984821104,0.014709071196241416
2020,MICHIGAN,GLADWIN,4524,186,9893,14603,0.3097993562966514,0.677463534890091,0.01273710881325755
2020,MICHIGAN,GOGEBIC,3570,96,4600,8266,0.43188966852165495,0.5564964916525527,0.011613839825792402
2020,MICHIGAN,GRAND TRAVERSE,28683,1051,30502,60236,0.4761770369878478,0.5063749252938442,0.01744803771830799
2020,MICHIGAN,GRATIOT,6693,332,12102,19127,0.3499241909342814,0.6327181471218696,0.01735766194384901
2020,MICHIGAN,HILLSDALE,5883,382,17037,23302,0.25246759934769547,0.7311389580293537,0.01639344262295082
2020,MICHIGAN,HOUGHTON,7750,373,10378,18501,0.41889627587697964,0.5609426517485542,0.020161072374466245
2020,MICHIGAN,HURON,5490,216,12731,18437,0.29777078700439336,0.6905136410478928,0.011715571947713836
2020,MICHIGAN,INGHAM,94212,2699,47639,144550,0.651760636457973,0.3295676236596333,0.018671739882393637
2020,MICHIGAN,IONIA,10901,651,20657,32209,0.33844577602533454,0.6413424819149927,0.02021174205967276
2020,MICHIGAN,IOSCO,5373,231,9759,15363,0.34973637961335674,0.6352274946299551,0.015036125756688147
2020,MICHIGAN,IRON,2493,80,4216,6789,0.3672116659301812,0.6210045662100456,0.011783767859773163
2020,MICHIGAN,ISABELLA,14072,534,14815,29421,0.4782978144862513,0.5035518847082017,0.018150300805547057
2020,MICHIGAN,JACKSON,31995,1494,47372,80861,0.39567900471178935,0.5858448448572241,0.018476150430986507
2020,MICHIGAN,KALAMAZOO,83686,2905,56823,143414,0.5835274101552149,0.39621654789630023,0.020256041948484807
2020,MICHIGAN,KALKASKA,3002,193,7436,10631,0.28238171385570504,0.6994638321888815,0.018154453955413413
2020,MICHIGAN,KENT,187915,7392,165741,361048,0.5204709623097206,0.45905530566572866,0.020473732024550752
2020,MICHIGAN,KEWEENAW,672,23,862,1557,0.43159922928709055,0.5536287732819525,0.014771997430956968
2020,MICHIGAN,LAKE,2288,89,3946,6323,0.3618535505298118,0.6240708524434604,0.014075597026727818
2020,MICHIGAN,LAPEER,16367,801,35482,52650,0.3108641975308642,0.6739221272554606,0.015213675213675214
2020,MICHIGAN,LEELANAU,8795,189,7916,16900,0.520414201183432,0.46840236686390535,0.011183431952662722
2020,MICHIGAN,LENAWEE,20918,916,31541,53375,0.39190632318501173,0.5909320843091335,0.017161592505854802
2020,MICHIGAN,LIVINGSTON,48220,1995,76982,127197,0.3790969912812409,0.6052186765411134,0.0156843321776457
2020,MICHIGAN,LUCE,842,50,2109,3001,0.2805731422859047,0.7027657447517495,0.016661112962345886
2020,MICHIGAN,MACKINAC,2632,79,4304,7015,0.3751960085531005,0.6135424091233072,0.011261582323592301
2020,MICHIGAN,MACOMB,223952,6441,263863,494256,0.45310931986662784,0.5338589718688291,0.013031708264543071
2020,MICHIGAN,MANISTEE,6107,227,8321,14655,0.4167178437393381,0.5677925622654384,0.015489593995223472
2020,MICHIGAN,MARQUETTE,20465,711,16286,37462,0.5462869040627836,0.43473386364849714,0.018979232288719235
2020,MICHIGAN,MASON,6802,245,10207,17254,0.39422742552451606,0.5915729685869944,0.014199605888489626
2020,MICHIGAN,MECOSTA,7375,407,13267,21049,0.3503729393320348,0.6302912252363533,0.019335835431611954
2020,MICHIGAN,MENOMINEE,4316,174,8117,12607,0.3423494883794717,0.6438486555088443,0.013801856111683984
2020,MICHIGAN,MIDLAND,20493,920,27675,49088,0.417474739243807,0.5637834093872229,0.018741851368970015
2020,MICHIGAN,MISSAUKEE,1967,140,6648,8755,0.22467161621930326,0.7593375214163335,0.01599086236436322
2020,MICHIGAN,MONROE,32975,1463,52710,87148,0.37837930876210585,0.6048331573874328,0.016787533850461285
2020,MICHIGAN,MONTCALM,9703,582,21815,32100,0.30227414330218066,0.679595015576324,0.018130841121495326
2020,MICHIGAN,MONTMORENCY,1628,60,4171,5859,0.277863116572794,0.7118962280252603,0.010240655401945725
2020,MICHIGAN,MUSKEGON,45643,1668,45133,92444,0.4937367487343689,0.4882198952879581,0.01804335597767297
2020,MICHIGAN,NEWAYGO,7873,431,18857,27161,0.2898641434409632,0.6942675159235668,0.015868340635469977
2020,MICHIGAN,OAKLAND,434148,10232,325971,770351,0.56357167057614,0.42314607237480056,0.013282257049059455
2020,MICHIGAN,OCEANA,4944,226,8892,14062,0.35158583416299244,0.6323424832882947,0.016071682548712843
2020,MICHIGAN,OGEMAW,3475,179,8253,11907,0.2918451331149744,0.6931216931216931,0.015033173763332493
2020,MICHIGAN,ONTONAGON,1391,55,2358,3804,0.3656677181913775,0.6198738170347003,0.014458464773922187
2020,MICHIGAN,OSCEOLA,3214,187,8928,12329,0.2606861870386893,0.7241463216805905,0.015167491280720253
2020,MICHIGAN,OSCODA,1342,66,3466,4874,0.275338530980714,0.7111202297907263,0.013541239228559704
2020,MICHIGAN,OTSEGO,4743,235,9779,14757,0.32140678999796707,0.6626685640712882,0.015924645930744732
2020,MICHIGAN,OTTAWA,64705,3095,100913,168713,0.38352112759538387,0.5981341094047288,0.018344762999887382
2020,MICHIGAN,PRESQUE ISLE,2911,91,5342,8344,0.34887344199424736,0.6402205177372963,0.010906040268456376
2020,MICHIGAN,ROSCOMMON,5166,182,9670,15018,0.3439872153415901,0.6438939938740178,0.012118790784392063
2020,MICHIGAN,SAGINAW,51088,1476,50785,103349,0.4943250539434344,0.49139324037968435,0.014281705676881248
2020,MICHIGAN,SANILAC,5966,286,16194,22446,0.26579345985921765,0.7214648489708634,0.012741691169918917
2020,MICHIGAN,SCHOOLCRAFT,1589,66,3090,4745,0.33487881981032663,0.6512118018967334,0.013909378292939936
2020,MICHIGAN,SHIAWASSEE,15347,728,23149,39224,0.39126555170303895,0.5901743830307975,0.018560065266163574
2020,MICHIGAN,ST. CLAIR,31363,1516,59185,92064,0.3406651894334376,0.64286800486618,0.016466805700382343
2020,MICHIGAN,ST. JOSEPH,9262,547,18127,27936,0.3315435280641466,0.6488760022909508,0.019580469644902634
2020,MICHIGAN,TUSCOLA,8712,436,20297,29445,0.29587366276107996,0.6893190694515198,0.014807267787400238
2020,MICHIGAN,VAN BUREN,16803,672,21591,39066,0.43011826140377823,0.5526800798648441,0.01720165873137767
2020,MICHIGAN,WASHTENAW,157136,3041,56241,216418,0.72607638920977,0.2598720993632692,0.014051511426960789
2020,MICHIGAN,WAYNE,597170,10746,264553,872469,0.6844598490032311,0.3032233810026488,0.012316769994120135
2020,MICHIGAN,WEXFORD,5838,325,12102,18265,0.3196277032575965,0.6625787024363536,0.017793594306049824
2020,MINNESOTA,AITKIN,3607,160,6258,10025,0.3598004987531172,0.6242394014962593,0.01596009975062344
2020,MINNESOTA,ANOKA,100893,5337,104902,211132,0.4778669268514484,0.49685504802682684,0.0252780251217248
2020,MINNESOTA,BECKER,6589,374,12438,19401,0.3396216689861347,0.6411009741765888,0.019277356837276428
2020,MINNESOTA,BELTRAMI,11426,575,12188,24189,0.4723634709992145,0.5038653933606184,0.02377113564016702
2020,MINNESOTA,BENTON,7280,598,14382,22260,0.3270440251572327,0.6460916442048518,0.026864330637915542
2020,MINNESOTA,BIG STONE,1053,58,1863,2974,0.35406859448554134,0.6264290517821116,0.019502353732347006
2020,MINNESOTA,BLUE EARTH,18330,990,16731,36051,0.5084463676458351,0.46409253557460267,0.027461096779562287
2020,MINNESOTA,BROWN,4753,330,9552,14635,0.32476938845234027,0.6526819268875982,0.022548684660061498
2020,MINNESOTA,CARLTON,10098,480,9791,20369,0.49575335067995485,0.4806814276596789,0.02356522166036624
2020,MINNESOTA,CARVER,30774,1578,34009,66361,0.4637362306173807,0.5124847425445669,0.02377902683805247
2020,MINNESOTA,CASS,6342,327,11620,18289,0.34676581551752417,0.6353545847230576,0.01787959975941823
2020,MINNESOTA,CHIPPEWA,2226,135,4250,6611,0.3367115413704432,0.6428679473604598,0.02042051126909696
2020,MINNESOTA,CHISAGO,11806,848,21916,34570,0.3415099797512294,0.6339600809950824,0.02452993925368817
2020,MINNESOTA,CLAY,16357,839,15043,32239,0.5073668538106021,0.4666087657805763,0.026024380408821615
2020,MINNESOTA,CLEARWATER,1260,76,3372,4708,0.2676295666949873,0.7162276975361087,0.016142735768903994
2020,MINNESOTA,COOK,2496,107,1203,3806,0.6558066211245402,0.3160798738833421,0.02811350499211771
2020,MINNESOTA,COTTONWOOD,1834,108,4165,6107,0.30031111838873426,0.6820042574095301,0.017684624201735714
2020,MINNESOTA,CROW WING,13726,771,25676,40173,0.3416722674433077,0.6391357379334379,0.019191994623254424
2020,MINNESOTA,DAKOTA,146155,6466,109638,262259,0.5572926000632962,0.418052383330982,0.024655016605721825
2020,MINNESOTA,DODGE,4079,325,7783,12187,0.3347009108065972,0.6386313284647576,0.026667760728645278
2020,MINNESOTA,DOUGLAS,7868,498,15799,24165,0.3255948686116284,0.6537968135733498,0.020608317815021725
2020,MINNESOTA,FARIBAULT,2531,192,5191,7914,0.3198129896386151,0.6559262067222643,0.024260803639120546
2020,MINNESOTA,FILLMORE,4551,289,7301,12141,0.37484556461576474,0.6013507948274442,0.023803640556791038
2020,MINNESOTA,FREEBORN,6889,351,9578,16818,0.4096206445475086,0.5695088595552384,0.020870495897252945
2020,MINNESOTA,GOODHUE,11806,778,16052,28636,0.4122782511523956,0.5605531498812684,0.02716859896633608
2020,MINNESOTA,GRANT,1300,85,2269,3654,0.35577449370552816,0.6209633278598796,0.023262178434592228
2020,MINNESOTA,HENNEPIN,532623,17373,205973,755969,0.7045566683289923,0.2724622305941117,0.02298110107689601
2020,MINNESOTA,HOUSTON,4853,253,6334,11440,0.42421328671328673,0.5536713286713286,0.022115384615384617
2020,MINNESOTA,HUBBARD,4462,301,8202,12965,0.344157346702661,0.63262630158118,0.02321635171615889
2020,MINNESOTA,ISANTI,7138,606,16491,24235,0.2945327006395709,0.6804621415308438,0.02500515782958531
2020,MINNESOTA,ITASCA,10786,536,15239,26561,0.4060841082790558,0.5737359286171454,0.0201799631037988
2020,MINNESOTA,JACKSON,1745,126,3948,5819,0.2998797044165664,0.6784670905653892,0.02165320501804434
2020,MINNESOTA,KANABEC,2774,190,6278,9242,0.3001514823631249,0.679290196927072,0.020558320709803072
2020,MINNESOTA,KANDIYOHI,8440,490,14437,23367,0.36119313561860744,0.6178371207258099,0.02096974365558266
2020,MINNESOTA,KITTSON,1006,87,1546,2639,0.38120500189465706,0.5858279651383099,0.03296703296703297
2020,MINNESOTA,KOOCHICHING,2659,132,4131,6922,0.38413753250505633,0.596792834440913,0.019069633054030626
2020,MINNESOTA,LAC QUI PARLE,1446,66,2528,4040,0.3579207920792079,0.6257425742574257,0.016336633663366337
2020,MINNESOTA,LAKE,3647,162,3393,7202,0.5063871146903638,0.4711191335740072,0.02249375173562899
2020,MINNESOTA,LAKE OF THE WOODS,671,33,1704,2408,0.27865448504983387,0.707641196013289,0.013704318936877076
2020,MINNESOTA,LE SUEUR,5672,371,10775,16818,0.3372577000832441,0.6406826019740754,0.02205969794268046
2020,MINNESOTA,LINCOLN,937,57,2121,3115,0.30080256821829854,0.6808988764044944,0.018298555377207062
2020,MINNESOTA,LYON,4634,280,7979,12893,0.35941984022337703,0.6188629488869929,0.021717210889630034
2020,MINNESOTA,MAHNOMEN,1112,50,1142,2304,0.4826388888888889,0.4956597222222222,0.021701388888888888
2020,MINNESOTA,MARSHALL,1295,97,3721,5113,0.25327596323097984,0.727752787013495,0.01897124975552513
2020,MINNESOTA,MARTIN,3305,224,7480,11009,0.3002089199745663,0.6794440911981107,0.0203469888273231
2020,MINNESOTA,MCLEOD,6413,534,13986,20933,0.3063583815028902,0.6681316581474227,0.025509960349687097
2020,MINNESOTA,MEEKER,3867,303,9359,13529,0.28583043831768795,0.6917732278808485,0.02239633380146352
2020,MINNESOTA,MILLE LACS,4404,333,9952,14689,0.2998161889849547,0.6775137858261284,0.022670025188916875
2020,MINNESOTA,MORRISON,4367,370,14821,19558,0.2232845894263217,0.7577973207894467,0.018918089784231516
2020,MINNESOTA,MOWER,8899,421,10025,19345,0.46001550788317397,0.5182217627293875,0.021762729387438614
2020,MINNESOTA,MURRAY,1449,84,3363,4896,0.2959558823529412,0.6868872549019608,0.01715686274509804
2020,MINNESOTA,NICOLLET,9622,485,9018,19125,0.5031111111111111,0.47152941176470586,0.025359477124183006
2020,MINNESOTA,NOBLES,2933,182,5600,8715,0.3365461847389558,0.642570281124498,0.020883534136546186
2020,MINNESOTA,NORMAN,1404,84,1953,3441,0.4080209241499564,0.5675675675675675,0.024411508282476024
2020,MINNESOTA,OLMSTED,49491,2202,39692,91385,0.5415659025004104,0.4343382393171746,0.024095858182415057
2020,MINNESOTA,OTTER TAIL,11958,641,23800,36399,0.3285255089425534,0.6538641171460754,0.017610373911371192
2020,MINNESOTA,PENNINGTON,2568,177,4532,7277,0.35289267555311254,0.6227841143328294,0.02432321011405799
2020,MINNESOTA,PINE,5419,326,10256,16001,0.33866633335416535,0.6409599400037498,0.02037372664208487
2020,MINNESOTA,PIPESTONE,1306,81,3553,4940,0.26437246963562755,0.7192307692307692,0.01639676113360324
2020,MINNESOTA,POLK,5439,290,9865,15594,0.34878799538283956,0.632615108375016,0.018596896242144414
2020,MINNESOTA,POPE,2477,128,4417,7022,0.3527485046995158,0.6290230703503276,0.01822842495015665
2020,MINNESOTA,RAMSEY,211620,6981,77376,295977,0.7149879889315723,0.2614257188903192,0.023586292178108433
2020,MINNESOTA,RED LAKE,691,51,1454,2196,0.3146630236794171,0.6621129326047359,0.023224043715846996
2020,MINNESOTA,REDWOOD,2355,158,5771,8284,0.2842829550941574,0.6966441332689522,0.019072911636890393
2020,MINNESOTA,RENVILLE,2496,165,5467,8128,0.30708661417322836,0.672613188976378,0.0203001968503937
2020,MINNESOTA,RICE,17402,820,17464,35686,0.48764221263240487,0.4893795886341983,0.022978198733396852
2020,MINNESOTA,ROCK,1556,101,3583,5240,0.2969465648854962,0.6837786259541985,0.019274809160305342
2020,MINNESOTA,ROSEAU,2188,168,6065,8421,0.2598266239163995,0.7202232513953212,0.0199501246882793
2020,MINNESOTA,SAINT LOUIS,67704,2810,49017,119531,0.5664137336757828,0.41007772042399043,0.02350854590022672
2020,MINNESOTA,SCOTT,40040,2053,45872,87965,0.45518103791280623,0.521480134144262,0.023338827942931847
2020,MINNESOTA,SHERBURNE,18065,1325,36222,55612,0.3248399625980004,0.6513342444076818,0.023825792994317772
2020,MINNESOTA,SIBLEY,2417,171,5864,8452,0.2859678182678656,0.69380028395646,0.020231897775674395
2020,MINNESOTA,STEARNS,31879,1997,50959,84835,0.37577650733777335,0.6006836800848706,0.023539812577356045
2020,MINNESOTA,STEELE,7917,555,12656,21128,0.3747160166603559,0.5990155244225672,0.026268458917076864
2020,MINNESOTA,STEVENS,1922,119,3044,5085,0.37797443461160274,0.5986234021632252,0.023402163225172076
2020,MINNESOTA,SWIFT,1784,93,3316,5193,0.34353937993452727,0.6385518967841325,0.017908723281340265
2020,MINNESOTA,TODD,3286,218,9753,13257,0.24786905031304216,0.7356868069699027,0.01644414271705514
2020,MINNESOTA,TRAVERSE,661,31,1172,1864,0.3546137339055794,0.628755364806867,0.016630901287553648
2020,MINNESOTA,WABASHA,4696,274,8153,13123,0.3578450049531357,0.6212756229520688,0.020879372094795397
2020,MINNESOTA,WADENA,2023,134,5520,7677,0.2635143936433503,0.719030871434154,0.017454734922495767
2020,MINNESOTA,WASECA,3496,269,6624,10389,0.3365097699489845,0.6375974588507075,0.02589277120030802
2020,MINNESOTA,WASHINGTON,89165,3857,73764,166786,0.5346072212295996,0.4422673365870037,0.023125442183396686
2020,MINNESOTA,WATONWAN,1987,111,3103,5201,0.382041915016343,0.5966160353778119,0.02134204960584503
2020,MINNESOTA,WILKIN,1026,76,2328,3430,0.2991253644314869,0.6787172011661807,0.022157434402332362
2020,MINNESOTA,WINONA,13333,613,13227,27173,0.4906708865417878,0.48676995547050383,0.022559157987708387
2020,MINNESOTA,WRIGHT,28430,2023,51973,82426,0.3449154393031325,0.6305413340450828,0.02454322665178463
2020,MINNESOTA,YELLOW MEDICINE,1688,106,3734,5528,0.3053545586107091,0.6754703328509407,0.01917510853835022
2020,MISSISSIPPI,ADAMS,7917,146,5696,13759,0.5754051893306199,0.4139835743876735,0.010611236281706519
2020,MISSISSIPPI,ALCORN,2782,193,12818,15793,0.17615399227505857,0.8116254036598493,0.012220604065092129
2020,MISSISSIPPI,AMITE,2620,73,4503,7196,0.3640911617565314,0.6257643135075042,0.010144524735964425
2020,MISSISSIPPI,ATTALA,3542,103,5178,8823,0.4014507537118894,0.5868752125127508,0.011674033775359855
2020,MISSISSIPPI,BENTON,1679,40,2570,4289,0.39146654231755657,0.5992072744229424,0.00932618325950105
2020,MISSISSIPPI,BOLIVAR,8904,169,4671,13744,0.6478463329452853,0.33985739231664724,0.01229627473806752
2020,MISSISSIPPI,CALHOUN,1902,63,4625,6590,0.28861911987860395,0.7018209408194234,0.009559939301972686
2020,MISSISSIPPI,CARROLL,1729,48,3924,5701,0.3032801262936327,0.6883002981932994,0.008419575513067884
2020,MISSISSIPPI,CHICKASAW,3810,156,4175,8141,0.4680014740203906,0.5128362609016092,0.019162265078000246
2020,MISSISSIPPI,CHOCTAW,1185,37,3001,4223,0.28060620412029363,0.7106322519535875,0.008761543926118873
2020,MISSISSIPPI,CLAIBORNE,3772,74,603,4449,0.8478309732524163,0.13553607552258934,0.01663295122499438
2020,MISSISSIPPI,CLARKE,2838,83,5417,8338,0.3403693931398417,0.6496761813384505,0.009954425521707843
2020,MISSISSIPPI,CLAY,5844,164,4181,10189,0.5735597212680341,0.41034448915497107,0.0160957895769948
2020,MISSISSIPPI,COAHOMA,6020,106,2375,8501,0.7081519821197506,0.27937889660039994,0.01246912127984943
2020,MISSISSIPPI,COPIAH,6470,163,6250,12883,0.5022122176511682,0.48513544981758905,0.012652332531242722
2020,MISSISSIPPI,COVINGTON,3416,90,5854,9360,0.36495726495726494,0.6254273504273504,0.009615384615384616
2020,MISSISSIPPI,DESOTO,28265,1397,46462,76124,0.3713020860700962,0.6103462771267931,0.018351636803110714
2020,MISSISSIPPI,FORREST,13755,609,17290,31654,0.4345422379478107,0.5462184873949579,0.019239274657231315
2020,MISSISSIPPI,FRANKLIN,1480,58,2923,4461,0.3317641784353284,0.6552342524097736,0.013001569154898005
2020,MISSISSIPPI,GEORGE,1218,118,9713,11049,0.11023622047244094,0.8790840800072405,0.01067969952031858
2020,MISSISSIPPI,GREENE,966,52,4794,5812,0.16620784583620096,0.8248451479697179,0.008947006194081212
2020,MISSISSIPPI,GRENADA,4734,96,6081,10911,0.4338740720373935,0.5573274676931537,0.008798460269452846
2020,MISSISSIPPI,HANCOCK,4504,321,16132,20957,0.21491625709786707,0.7697666650761082,0.015317077826024717
2020,MISSISSIPPI,HARRISON,27728,1218,46822,75768,0.3659592440080245,0.6179653679653679,0.01607538802660754
2020,MISSISSIPPI,HINDS,73550,1304,25141,99995,0.7355367768388419,0.2514225711285564,0.01304065203260163
2020,MISSISSIPPI,HOLMES,6588,158,1369,8115,0.811829944547135,0.1686999383857055,0.019470117067159582
2020,MISSISSIPPI,HUMPHREYS,3016,55,1118,4189,0.7199809023633326,0.26688947242778704,0.013129625208880401
2020,MISSISSIPPI,ISSAQUENA,355,13,308,676,0.5251479289940828,0.4556213017751479,0.019230769230769232
2020,MISSISSIPPI,ITAWAMBA,1249,132,9438,10819,0.11544505037434144,0.8723541916997875,0.012200757925871152
2020,MISSISSIPPI,JACKSON,17375,873,36295,54543,0.3185560016867426,0.6654382780558459,0.016005720257411583
2020,MISSISSIPPI,JASPER,4341,93,4302,8736,0.49690934065934067,0.49244505494505497,0.010645604395604396
2020,MISSISSIPPI,JEFFERSON,3327,50,531,3908,0.8513306038894575,0.13587512794268167,0.0127942681678608
2020,MISSISSIPPI,JEFFERSON DAVIS,3599,80,2534,6213,0.5792692741026879,0.4078544986319009,0.012876227265411235
2020,MISSISSIPPI,JONES,8517,348,21226,30091,0.283041440962414,0.7053936392941411,0.011564919743444884
2020,MISSISSIPPI,KEMPER,2887,57,1787,4731,0.6102303952652716,0.37772141196364406,0.012048192771084338
2020,MISSISSIPPI,LAFAYETTE,10070,404,12949,23423,0.4299193100798361,0.5528326858216284,0.01724800409853563
2020,MISSISSIPPI,LAMAR,7340,441,20704,28485,0.2576794804282956,0.7268386870282605,0.015481832543443918
2020,MISSISSIPPI,LAUDERDALE,12960,320,17967,31247,0.4147598169424265,0.5749991999231926,0.010240983134380901
2020,MISSISSIPPI,LAWRENCE,2260,68,4285,6613,0.3417510963254196,0.647966127324966,0.010282776349614395
2020,MISSISSIPPI,LEAKE,3897,75,5228,9200,0.4235869565217391,0.5682608695652174,0.008152173913043478
2020,MISSISSIPPI,LEE,12189,558,24207,36954,0.32984250690047084,0.6550576392271472,0.01509985387238188
2020,MISSISSIPPI,LEFLORE,7648,116,3129,10893,0.7021022675112457,0.28724869182043516,0.010649040668319103
2020,MISSISSIPPI,LINCOLN,5040,165,11596,16801,0.2999821439200048,0.6901970120826141,0.009820843997381107
2020,MISSISSIPPI,LOWNDES,13087,354,13800,27241,0.48041555008993797,0.5065893322565251,0.012995117653536947
2020,MISSISSIPPI,MADISON,24440,681,31091,56212,0.43478260869565216,0.5531025403828363,0.012114850921511421
2020,MISSISSIPPI,MARION,3787,117,8273,12177,0.31099614026443295,0.6793955818346062,0.009608277900960829
2020,MISSISSIPPI,MARSHALL,8057,194,7566,15817,0.5093886324840362,0.4783460833280647,0.012265284187899095
2020,MISSISSIPPI,MONROE,5874,208,11177,17259,0.3403441682600382,0.6476041485601715,0.012051683179790254
2020,MISSISSIPPI,MONTGOMERY,2121,37,2917,5075,0.41793103448275865,0.5747783251231527,0.00729064039408867
2020,MISSISSIPPI,NESHOBA,3260,123,8320,11703,0.27856105272152437,0.7109288216696573,0.010510125608818251
2020,MISSISSIPPI,NEWTON,3075,111,6997,10183,0.30197387803201414,0.6871256014926839,0.010900520475301973
2020,MISSISSIPPI,NOXUBEE,4040,59,1240,5339,0.7566960104888556,0.232253230942124,0.011050758569020417
2020,MISSISSIPPI,OKTIBBEHA,10299,454,9004,19757,0.5212835956876044,0.4557372070658501,0.022979197246545527
2020,MISSISSIPPI,PANOLA,7403,164,8060,15627,0.47373136238561464,0.5157739809304409,0.010494656683944455
2020,MISSISSIPPI,PEARL RIVER,4148,290,19595,24033,0.17259601381433862,0.8153372446219781,0.012066741563683269
2020,MISSISSIPPI,PERRY,1362,54,4500,5916,0.2302231237322515,0.7606490872210954,0.009127789046653144
2020,MISSISSIPPI,PIKE,8646,217,8479,17342,0.49855841310114174,0.48892861261676857,0.012512974282089724
2020,MISSISSIPPI,PONTOTOC,2614,197,11550,14361,0.18202075064410556,0.8042615416753708,0.01371770768052364
2020,MISSISSIPPI,PRENTISS,2153,121,8370,10644,0.20227358136039084,0.786358511837655,0.011367906801954153
2020,MISSISSIPPI,QUITMAN,2150,50,1026,3226,0.666460012399256,0.3180409175449473,0.015499070055796652
2020,MISSISSIPPI,RANKIN,18847,913,50895,70655,0.26674686858679497,0.7203311867525299,0.012921944660675111
2020,MISSISSIPPI,SCOTT,4330,118,6285,10733,0.40342867790925185,0.5855771918382559,0.010994130252492313
2020,MISSISSIPPI,SHARKEY,1465,30,688,2183,0.6710948236371965,0.315162620247366,0.013742556115437472
2020,MISSISSIPPI,SIMPSON,4037,143,7635,11815,0.3416842996191282,0.6462124418112569,0.012103258569614896
2020,MISSISSIPPI,SMITH,1791,78,6458,8327,0.21508346343220847,0.7755494175573436,0.009367119010447941
2020,MISSISSIPPI,STONE,1802,112,5964,7878,0.22873825844122875,0.7570449352627571,0.014216806296014217
2020,MISSISSIPPI,SUNFLOWER,6781,101,2799,9681,0.7004441689908067,0.28912302448094207,0.010432806528251213
2020,MISSISSIPPI,TALLAHATCHIE,3105,92,2488,5685,0.5461741424802111,0.4376429199648197,0.016182937554969218
2020,MISSISSIPPI,TATE,4183,203,8707,13093,0.3194836935767204,0.6650118383869243,0.015504468036355305
2020,MISSISSIPPI,TIPPAH,1937,111,8054,10102,0.19174420906751138,0.7972678677489606,0.010987923183528014
2020,MISSISSIPPI,TISHOMINGO,1059,146,7933,9138,0.11588969139855548,0.8681330706938061,0.01597723790763843
2020,MISSISSIPPI,TUNICA,2580,56,926,3562,0.7243121841661988,0.25996631106120155,0.015721504772599662
2020,MISSISSIPPI,UNION,2160,150,10373,12683,0.1703067097689821,0.8178664353859497,0.0118268548450682
2020,MISSISSIPPI,WALTHALL,2835,64,4220,7119,0.39823008849557523,0.5927798848152831,0.008990026689141733
2020,MISSISSIPPI,WARREN,10442,246,10365,21053,0.4959863202393958,0.4923288842445257,0.01168479551607847
2020,MISSISSIPPI,WASHINGTON,12503,205,5300,18008,0.6943025322079076,0.2943136383829409,0.011383829409151489
2020,MISSISSIPPI,WAYNE,3624,125,6307,10056,0.360381861575179,0.6271877486077964,0.012430389817024661
2020,MISSISSIPPI,WEBSTER,1043,61,4291,5395,0.1933271547729379,0.7953660797034291,0.011306765523632993
2020,MISSISSIPPI,WILKINSON,2749,54,1324,4127,0.6661012842258299,0.32081415071480496,0.013084565059365156
2020,MISSISSIPPI,WINSTON,4040,84,5112,9236,0.43741879601559114,0.5534863577306193,0.009094846253789519
2020,MISSISSIPPI,YALOBUSHA,2785,79,3671,6535,0.42616679418515685,0.5617444529456771,0.012088752869166029
2020,MISSISSIPPI,YAZOO,5496,108,4832,10436,0.5266385588348026,0.4630126485243388,0.010348792640858567
2020,MISSOURI,ADAIR,3710,213,6413,10336,0.3589396284829721,0.620452786377709,0.020607585139318884
2020,MISSOURI,ANDREW,2351,146,7255,9752,0.24107875307629203,0.7439499589827727,0.014971287940935192
2020,MISSOURI,ATCHISON,564,51,2199,2814,0.20042643923240938,0.7814498933901919,0.01812366737739872
2020,MISSOURI,AUDRAIN,2704,220,7732,10656,0.25375375375375375,0.7256006006006006,0.020645645645645645
2020,MISSOURI,BARRY,2948,225,12425,15598,0.18899858956276447,0.7965764841646364,0.01442492627259905
2020,MISSOURI,BARTON,844,65,5168,6077,0.13888431792002634,0.850419614941583,0.010696067138390653
2020,MISSOURI,BATES,1672,147,6597,8416,0.19866920152091255,0.7838640684410646,0.017466730038022814
2020,MISSOURI,BENTON,2180,187,8109,10476,0.2080946926307751,0.7740549828178694,0.01785032455135548
2020,MISSOURI,BOLLINGER,750,66,5167,5983,0.12535517299013874,0.863613571786729,0.011031255223132207
2020,MISSOURI,BOONE,50064,2458,38646,91168,0.5491400491400491,0.4238987363987364,0.02696121446121446
2020,MISSOURI,BUCHANAN,13445,703,22450,36598,0.3673698016285043,0.6134214984425378,0.019208699928957868
2020,MISSOURI,BUTLER,3301,238,14602,18141,0.18196350807562978,0.8049170387519983,0.013119453172371976
2020,MISSOURI,CALDWELL,897,60,3725,4682,0.19158479282357968,0.7956001708671507,0.012815036309269542
2020,MISSOURI,CALLAWAY,5870,459,14815,21144,0.27762012864169505,0.7006715853197124,0.021708286038592508
2020,MISSOURI,CAMDEN,5652,310,18850,24812,0.22779300338545866,0.7597130420764147,0.012493954538126713
2020,MISSOURI,CAPE GIRARDEAU,10760,661,28907,40328,0.26681214044832374,0.716797262447927,0.016390597103749256
2020,MISSOURI,CARROLL,786,40,3706,4532,0.1734333627537511,0.8177405119152692,0.0088261253309797
2020,MISSOURI,CARTER,418,28,2451,2897,0.144287193648602,0.8460476354849845,0.009665170866413532
2020,MISSOURI,CASS,19052,1159,37197,57408,0.3318701226309922,0.6479410535117057,0.02018882385730212
2020,MISSOURI,CEDAR,1145,111,5788,7044,0.16254968767745598,0.8216922203293583,0.01575809199318569
2020,MISSOURI,CHARITON,916,50,3111,4077,0.2246750061319598,0.7630610743193524,0.01226391954868776
2020,MISSOURI,CHRISTIAN,11131,788,34920,46839,0.23764384380537587,0.745532569013002,0.016823587181622152
2020,MISSOURI,CLARK,678,44,2672,3394,0.19976428992339423,0.7872716558632882,0.01296405421331762
2020,MISSOURI,CLAY,59400,2564,64605,126569,0.46930923053828344,0.5104330444263603,0.02025772503535621
2020,MISSOURI,CLINTON,2896,193,7799,10888,0.2659808963997061,0.7162931667891257,0.01772593681116826
2020,MISSOURI,COLE,12694,749,26086,39529,0.3211313213084065,0.6599205646487389,0.018948114042854614
2020,MISSOURI,COOPER,2249,172,6272,8693,0.25871390774186126,0.7215000575175429,0.01978603474059588
2020,MISSOURI,CRAWFORD,2113,135,8725,10973,0.19256356511437164,0.7951335095233756,0.012302925362252802
2020,MISSOURI,DADE,656,49,3414,4119,0.15926195678562757,0.8288419519300801,0.011896091284292304
2020,MISSOURI,DALLAS,1380,105,6619,8104,0.1702862783810464,0.8167571569595261,0.012956564659427443
2020,MISSOURI,DAVIESS,746,63,3102,3911,0.19074405522884172,0.793147532600358,0.016108412170800307
2020,MISSOURI,DEKALB,930,85,3828,4843,0.19202973363617593,0.7904191616766467,0.01755110468717737
2020,MISSOURI,DENT,1056,99,5987,7142,0.1478577429291515,0.8382805936712405,0.013861663399607952
2020,MISSOURI,DOUGLAS,1016,86,5898,7000,0.14514285714285713,0.8425714285714285,0.012285714285714285
2020,MISSOURI,DUNKLIN,2200,84,8135,10419,0.21115270179479798,0.7807851041366733,0.00806219406852865
2020,MISSOURI,FRANKLIN,14569,1058,38058,53685,0.2713793424606501,0.7089131042190556,0.01970755332029431
2020,MISSOURI,GASCONADE,1601,100,6222,7923,0.20206992300896126,0.7853085952290799,0.012621481761958854
2020,MISSOURI,GENTRY,613,43,2581,3237,0.18937287611986406,0.797343219029966,0.013283904850169911
2020,MISSOURI,GREENE,55068,3102,83630,141800,0.38834978843441464,0.5897743300423132,0.021875881523272214
2020,MISSOURI,GRUNDY,799,53,3585,4437,0.18007662835249041,0.8079783637592968,0.011945007888212756
2020,MISSOURI,HARRISON,597,31,3198,3826,0.1560376372190277,0.8358599059069525,0.008102456874019864
2020,MISSOURI,HENRY,2619,142,8027,10788,0.24276974416017796,0.7440674823878384,0.013162773451983686
2020,MISSOURI,HICKORY,1056,58,3966,5080,0.2078740157480315,0.7807086614173229,0.01141732283464567
2020,MISSOURI,HOLT,338,29,1976,2343,0.14425949637217242,0.8433632095603927,0.012377294067434912
2020,MISSOURI,HOWARD,1413,126,3553,5092,0.2774941084053417,0.6977611940298507,0.02474469756480754
2020,MISSOURI,HOWELL,3218,251,15181,18650,0.17254691689008042,0.8139946380697051,0.013458445040214477
2020,MISSOURI,IRON,945,51,3596,4592,0.20579268292682926,0.7831010452961672,0.011106271777003485
2020,MISSOURI,JACKSON,92182,4094,100142,196418,0.4693154395218361,0.509841256911281,0.02084330356688287
2020,MISSOURI,JASPER,13549,1075,37728,52352,0.25880577628361856,0.7206601466992665,0.020534077017114915
2020,MISSOURI,JEFFERSON,37523,2119,77046,116688,0.32156691347867816,0.6602735499794323,0.01815953654188948
2020,MISSOURI,JOHNSON,6974,660,15489,23123,0.30160446308869954,0.6698525277861869,0.028543009125113525
2020,MISSOURI,KANSAS CITY,107660,2592,26393,136645,0.7878810055252662,0.19315013355775915,0.018968860916974643
2020,MISSOURI,KNOX,340,28,1486,1854,0.18338727076591155,0.8015102481121898,0.015102481121898598
2020,MISSOURI,LACLEDE,2780,251,13762,16793,0.16554516762936938,0.8195081283868278,0.014946703983802776
2020,MISSOURI,LAFAYETTE,4472,310,12273,17055,0.26221049545587805,0.719613016710642,0.01817648783347992
2020,MISSOURI,LAWRENCE,3214,265,14426,17905,0.1795029321418598,0.8056967327562133,0.014800335101926836
2020,MISSOURI,LEWIS,984,72,3553,4609,0.2134953352137123,0.7708830548926014,0.015621609893686265
2020,MISSOURI,LINCOLN,6607,563,21848,29018,0.2276862636983941,0.7529119856640706,0.019401750637535322
2020,MISSOURI,LINN,1275,88,4363,5726,0.22266852951449528,0.7619629758994062,0.015368494586098498
2020,MISSOURI,LIVINGSTON,1410,81,5267,6758,0.20864160994377035,0.7793725954424386,0.011985794613791062
2020,MISSOURI,MACON,1662,98,6076,7836,0.2120980091883614,0.7753956100051046,0.012506380806533947
2020,MISSOURI,MADISON,1019,73,4584,5676,0.17952783650458068,0.8076109936575053,0.012861169837914023
2020,MISSOURI,MARIES,814,65,3892,4771,0.17061412701739678,0.8157618947809684,0.013623978201634877
2020,MISSOURI,MARION,3202,231,9915,13348,0.23988612526221156,0.7428079112975726,0.017305963440215764
2020,MISSOURI,MCDONALD,1439,149,7465,9053,0.15895283331492324,0.8245885341875622,0.016458632497514634
2020,MISSOURI,MERCER,222,16,1541,1779,0.12478920741989882,0.8662169758291175,0.008993816750983699
2020,MISSOURI,MILLER,2038,168,10176,12382,0.16459376514294943,0.821838152156356,0.013568082700694557
2020,MISSOURI,MISSISSIPPI,1178,41,3537,4756,0.24768713204373424,0.7436921783010934,0.008620689655172414
2020,MISSOURI,MONITEAU,1308,105,5744,7157,0.1827581388850077,0.802570909598994,0.014670951515998324
2020,MISSOURI,MONROE,936,70,3477,4483,0.20878875752844078,0.775596698639304,0.015614543832255186
2020,MISSOURI,MONTGOMERY,1208,99,4465,5772,0.20928620928620928,0.7735620235620235,0.017151767151767153
2020,MISSOURI,MORGAN,1924,121,7442,9487,0.2028038368293454,0.784441867819121,0.012754295351533678
2020,MISSOURI,NEW MADRID,1748,55,5447,7250,0.24110344827586208,0.7513103448275862,0.007586206896551724
2020,MISSOURI,NEWTON,5818,467,22120,28405,0.20482309452561168,0.7787361380038725,0.016440767470515753
2020,MISSOURI,NODAWAY,2853,175,6865,9893,0.2883857272819165,0.6939249974729607,0.017689275245122815
2020,MISSOURI,OREGON,823,69,3847,4739,0.17366533023844694,0.8117746359991559,0.01456003376239713
2020,MISSOURI,OSAGE,1037,77,6425,7539,0.1375513993898395,0.8522350444356015,0.01021355617455896
2020,MISSOURI,OZARK,752,48,4064,4864,0.15460526315789475,0.8355263157894737,0.009868421052631578
2020,MISSOURI,PEMISCOT,1560,55,4120,5735,0.27201394943330426,0.7183958151700087,0.00959023539668701
2020,MISSOURI,PERRY,1664,126,7657,9447,0.17614057372710915,0.8105218587911507,0.013337567481740234
2020,MISSOURI,PETTIS,4783,460,13854,19097,0.2504581871498141,0.7254542598313871,0.024087553018798766
2020,MISSOURI,PHELPS,5637,451,13480,19568,0.28807236304170075,0.6888798037612428,0.02304783319705642
2020,MISSOURI,PIKE,1717,115,5863,7695,0.22313190383365822,0.7619233268356075,0.014944769330734242
2020,MISSOURI,PLATTE,27179,1174,28917,57270,0.4745765671381177,0.5049240440020953,0.020499388859786975
2020,MISSOURI,POLK,2885,329,11850,15064,0.19151619755708976,0.7866436537440255,0.02184014869888476
2020,MISSOURI,PULASKI,3740,345,10329,14414,0.2594699597613431,0.7165949771055918,0.023935063133065076
2020,MISSOURI,PUTNAM,361,16,1984,2361,0.15290131300296483,0.8403218975010589,0.006776789495976281
2020,MISSOURI,RALLS,1205,61,4396,5662,0.21282232426704345,0.7764040974920523,0.010773578240904275
2020,MISSOURI,RANDOLPH,2485,241,8018,10744,0.23129188384214444,0.746276991809382,0.022431124348473566
2020,MISSOURI,RAY,3109,195,8345,11649,0.26688986179071167,0.7163705039059147,0.01673963430337368
2020,MISSOURI,REYNOLDS,529,36,2733,3298,0.16040024257125532,0.8286840509399637,0.010915706488781079
2020,MISSOURI,RIPLEY,833,45,4839,5717,0.1457057897498688,0.8464229490991779,0.007871261150953298
2020,MISSOURI,SALINE,2904,164,6451,9519,0.30507406240151275,0.6776972371047378,0.017228700493749343
2020,MISSOURI,SCHUYLER,373,24,1606,2003,0.18622066899650525,0.8017973040439341,0.011982026959560658
2020,MISSOURI,SCOTLAND,388,36,1560,1984,0.19556451612903225,0.7862903225806451,0.018145161290322582
2020,MISSOURI,SCOTT,3753,197,13769,17719,0.21180653535752583,0.7770754557254924,0.01111800891698177
2020,MISSOURI,SHANNON,706,35,3165,3906,0.18074756784434204,0.8102918586789555,0.008960573476702509
2020,MISSOURI,SHELBY,592,58,2700,3350,0.17671641791044776,0.8059701492537313,0.017313432835820895
2020,MISSOURI,ST. CHARLES,89530,4098,128389,222017,0.4032574082164879,0.578284545778026,0.018458046005486065
2020,MISSOURI,ST. CLAIR,988,54,3932,4974,0.19863289103337353,0.7905106554081223,0.010856453558504222
2020,MISSOURI,ST. FRANCOIS,7044,446,20511,28001,0.2515624441984215,0.7325095532302418,0.01592800257133674
2020,MISSOURI,ST. LOUIS CITY,110089,2304,21474,133867,0.8223759402989534,0.16041294717891638,0.017211112522130173
2020,MISSOURI,ST. LOUIS COUNTY,328151,8802,199493,536446,0.6117130149166925,0.37187899620837883,0.016407988874928697
2020,MISSOURI,STE. GENEVIEVE,2713,141,6630,9484,0.2860607338675664,0.6990721214677351,0.01486714466469844
2020,MISSOURI,STODDARD,1819,123,11484,13426,0.13548339043646657,0.8553552807984508,0.009161328765082676
2020,MISSOURI,STONE,3506,177,14800,18483,0.1896878212411405,0.8007358112860467,0.009576367472812855
2020,MISSOURI,SULLIVAN,478,19,1974,2471,0.19344394981788748,0.7988668555240793,0.007689194658033185
2020,MISSOURI,TANEY,5339,441,20508,26288,0.20309646987218502,0.7801278149726111,0.016775715155203895
2020,MISSOURI,TEXAS,1716,121,9478,11315,0.1516570923552806,0.8376491383119753,0.010693769332744145
2020,MISSOURI,VERNON,1903,127,7155,9185,0.20718562874251498,0.778987479586282,0.013826891671203049
2020,MISSOURI,WARREN,4769,384,13222,18375,0.25953741496598637,0.7195646258503401,0.02089795918367347
2020,MISSOURI,WASHINGTON,1804,125,8047,9976,0.18083400160384924,0.806635926222935,0.012530072173215718
2020,MISSOURI,WAYNE,845,46,4987,5878,0.14375637972099353,0.8484178291936033,0.007825791085403199
2020,MISSOURI,WEBSTER,3573,326,14880,18779,0.19026572234943287,0.7923744608339102,0.017359816816656905
2020,MISSOURI,WORTH,215,15,877,1107,0.1942186088527552,0.7922312556458898,0.013550135501355014
2020,MISSOURI,WRIGHT,1168,118,7453,8739,0.1336537361254148,0.8528435747797231,0.013502689094862113
2020,MONTANA,BEAVERHEAD,1608,130,3923,5661,0.2840487546369899,0.6929871047518106,0.022964140611199436
2020,MONTANA,BIG HORN,2491,86,2207,4784,0.5206939799331104,0.4613294314381271,0.01797658862876254
2020,MONTANA,BLAINE,1589,59,1469,3117,0.5097850497273019,0.4712864934231633,0.01892845684953481
2020,MONTANA,BROADWATER,835,89,3173,4097,0.20380766414449597,0.7744691237490847,0.02172321210641933
2020,MONTANA,CARBON,2421,163,4468,7052,0.34330686330119115,0.6335791264889393,0.02311401020986954
2020,MONTANA,CARTER,74,15,775,864,0.08564814814814815,0.8969907407407407,0.017361111111111112
2020,MONTANA,CASCADE,15456,1114,23315,39885,0.387514103046258,0.5845555973423593,0.027930299611382724
2020,MONTANA,CHOUTEAU,991,83,1891,2965,0.3342327150084317,0.6377740303541315,0.027993254637436762
2020,MONTANA,CUSTER,1514,141,4205,5860,0.25836177474402733,0.7175767918088737,0.024061433447098976
2020,MONTANA,DANIELS,195,20,799,1014,0.19230769230769232,0.7879684418145957,0.01972386587771203
2020,MONTANA,DAWSON,962,105,3758,4825,0.1993782383419689,0.778860103626943,0.021761658031088083
2020,MONTANA,DEER LODGE,2562,143,2186,4891,0.5238192598650583,0.44694336536495605,0.029237374769985686
2020,MONTANA,FALLON,172,28,1375,1575,0.10920634920634921,0.873015873015873,0.017777777777777778
2020,MONTANA,FERGUS,1496,142,4869,6507,0.22990625480252036,0.7482710926694329,0.02182265252804672
2020,MONTANA,FLATHEAD,20274,1341,38321,59936,0.33826081153230114,0.639365323011212,0.02237386545648692
2020,MONTANA,GALLATIN,37044,2239,31696,70979,0.5219008439115794,0.4465546147452063,0.03154454134321419
2020,MONTANA,GARFIELD,41,8,764,813,0.05043050430504305,0.939729397293973,0.00984009840098401
2020,MONTANA,GLACIER,3610,123,1884,5617,0.6426918283781378,0.3354103614028841,0.021897810218978103
2020,MONTANA,GOLDEN VALLEY,78,11,414,503,0.1550695825049702,0.8230616302186878,0.02186878727634195
2020,MONTANA,GRANITE,638,45,1419,2102,0.30352045670789723,0.6750713606089439,0.021408182683158895
2020,MONTANA,HILL,2981,244,3957,7182,0.41506544138123086,0.5509607351712615,0.033973823447507656
2020,MONTANA,JEFFERSON,2625,181,5345,8151,0.3220463746779536,0.6557477610109189,0.02220586431112747
2020,MONTANA,JUDITH BASIN,275,29,1040,1344,0.20461309523809523,0.7738095238095238,0.021577380952380952
2020,MONTANA,LAKE,6916,388,9322,16626,0.41597497894863467,0.5606880789125466,0.023336942138818716
2020,MONTANA,LEWIS AND CLARK,19743,1113,21409,42265,0.46712409795338933,0.5065420560747663,0.026333845971844315
2020,MONTANA,LIBERTY,249,13,821,1083,0.2299168975069252,0.7580794090489381,0.012003693444136657
2020,MONTANA,LINCOLN,2835,240,8672,11747,0.2413382140120882,0.7382310377117562,0.020430748276155614
2020,MONTANA,MADISON,1771,125,4191,6087,0.29094792180055856,0.6885165105963529,0.02053556760308855
2020,MONTANA,MCCONE,155,17,956,1128,0.1374113475177305,0.8475177304964538,0.015070921985815602
2020,MONTANA,MEAGHER,258,19,833,1110,0.23243243243243245,0.7504504504504504,0.017117117117117116
2020,MONTANA,MINERAL,686,49,1828,2563,0.26765509168942647,0.7132266874756145,0.01911822083495903
2020,MONTANA,MISSOULA,43357,1791,26347,71495,0.6064340163647808,0.36851528078886636,0.02505070284635289
2020,MONTANA,MUSSELSHELL,413,45,2423,2881,0.1433530024297119,0.8410274210343631,0.015619576535925026
2020,MONTANA,PARK,5280,261,6025,11566,0.45651046169808057,0.520923396161162,0.022566142140757393
2020,MONTANA,PETROLEUM,39,11,298,348,0.11206896551724138,0.8563218390804598,0.031609195402298854
2020,MONTANA,PHILLIPS,416,30,1936,2382,0.1746431570109152,0.8127623845507976,0.012594458438287154
2020,MONTANA,PONDERA,903,61,2031,2995,0.30150250417362273,0.6781302170283806,0.02036727879799666
2020,MONTANA,POWDER RIVER,154,12,970,1136,0.13556338028169015,0.8538732394366197,0.01056338028169014
2020,MONTANA,POWELL,752,72,2355,3179,0.23655237496067946,0.7407989933941491,0.022648631645171436
2020,MONTANA,PRAIRIE,126,15,603,744,0.1693548387096774,0.8104838709677419,0.020161290322580645
2020,MONTANA,RAVALLI,8763,630,19114,28507,0.307398182902445,0.6705019819693409,0.02209983512821412
2020,MONTANA,RICHLAND,875,123,4800,5798,0.15091410831321145,0.8278716798896171,0.02121421179717144
2020,MONTANA,ROOSEVELT,1910,111,1996,4017,0.475479213343291,0.49688822504356484,0.027632561613144136
2020,MONTANA,ROSEBUD,1199,88,2486,3773,0.3177842565597668,0.6588921282798834,0.023323615160349854
2020,MONTANA,SANDERS,1820,142,5660,7622,0.23878247179218054,0.7425872474416164,0.018630280766203097
2020,MONTANA,SHERIDAN,574,53,1403,2030,0.2827586206896552,0.6911330049261084,0.026108374384236452
2020,MONTANA,SILVER BOW,10392,521,7745,18658,0.5569728802658377,0.4151034408832672,0.02792367885089506
2020,MONTANA,STILLWATER,1156,106,4462,5724,0.20195667365478687,0.7795248078266946,0.018518518518518517
2020,MONTANA,SWEET GRASS,549,57,1840,2446,0.22444807849550286,0.7522485690923958,0.02330335241210139
2020,MONTANA,TETON,1007,64,2608,3679,0.2737156836096765,0.7088882848600163,0.017396031530307148
2020,MONTANA,TOOLE,467,56,1596,2119,0.22038697498820198,0.7531854648419065,0.026427560169891458
2020,MONTANA,TREASURE,78,9,373,460,0.16956521739130434,0.8108695652173913,0.01956521739130435
2020,MONTANA,VALLEY,1030,96,3135,4261,0.24172729406242666,0.7357427833841821,0.022529922553391223
2020,MONTANA,WHEATLAND,225,20,823,1068,0.21067415730337077,0.7705992509363296,0.018726591760299626
2020,MONTANA,WIBAUX,77,5,516,598,0.12876254180602006,0.862876254180602,0.008361204013377926
2020,MONTANA,YELLOWSTONE,30679,2370,50772,83821,0.3660061321148638,0.6057193304780425,0.028274537407093688
2020,NEBRASKA,ADAMS,4213,304,10085,14602,0.28852212025749896,0.6906588138611149,0.02081906588138611
2020,NEBRASKA,ANTELOPE,452,38,3093,3583,0.12615126988557074,0.8632430923806865,0.010605637733742674
2020,NEBRASKA,ARTHUR,21,3,260,284,0.07394366197183098,0.9154929577464789,0.01056338028169014
2020,NEBRASKA,BANNER,43,5,362,410,0.1048780487804878,0.8829268292682927,0.012195121951219513
2020,NEBRASKA,BLAINE,35,2,280,317,0.11041009463722397,0.8832807570977917,0.006309148264984227
2020,NEBRASKA,BOONE,499,65,2653,3217,0.15511345974510413,0.8246813801678583,0.020205160087037613
2020,NEBRASKA,BOX BUTTE,1051,128,4002,5181,0.20285659139162324,0.7724377533294731,0.024705655278903685
2020,NEBRASKA,BOYD,135,8,1010,1153,0.1170858629661752,0.8759757155247181,0.006938421509106678
2020,NEBRASKA,BROWN,191,18,1470,1679,0.11375818939845146,0.8755211435378202,0.01072066706372841
2020,NEBRASKA,BUFFALO,6350,599,16640,23589,0.2691932680486668,0.7054135402094196,0.025393191741913602
2020,NEBRASKA,BURT,1063,88,2580,3731,0.28491021173948006,0.6915036183328866,0.023586169927633342
2020,NEBRASKA,BUTLER,873,83,3542,4498,0.194086260560249,0.7874610938194754,0.018452645620275678
2020,NEBRASKA,CASS,4737,426,10121,15284,0.3099319549856059,0.6621957602721801,0.02787228474221408
2020,NEBRASKA,CEDAR,725,97,4174,4996,0.14511609287429944,0.8354683746997598,0.019415532425940754
2020,NEBRASKA,CHASE,226,27,1740,1993,0.11339688911189162,0.8730556949322629,0.013547415955845458
2020,NEBRASKA,CHERRY,373,48,2844,3265,0.11424196018376723,0.8710566615620214,0.014701378254211332
2020,NEBRASKA,CHEYENNE,855,97,3813,4765,0.1794333683105981,0.8002098635886674,0.020356768100734522
2020,NEBRASKA,CLAY,632,78,2848,3558,0.17762788083192804,0.8004496908375491,0.021922428330522766
2020,NEBRASKA,COLFAX,1025,56,2636,3717,0.2757600215227334,0.7091740651062685,0.015065913370998116
2020,NEBRASKA,CUMING,870,74,3507,4451,0.19546169400134802,0.7879128285778477,0.016625477420804315
2020,NEBRASKA,CUSTER,786,117,5090,5993,0.13115301184715503,0.8493242115801769,0.019522776572668113
2020,NEBRASKA,DAKOTA,2744,124,3926,6794,0.4038857815719753,0.5778628201354136,0.01825139829261113
2020,NEBRASKA,DAWES,1082,108,2931,4121,0.26255763164280516,0.711235137102645,0.02620723125454987
2020,NEBRASKA,DAWSON,2497,157,6524,9178,0.2720636304205709,0.7108302462410111,0.017106123338417958
2020,NEBRASKA,DEUEL,141,20,871,1032,0.13662790697674418,0.8439922480620154,0.01937984496124031
2020,NEBRASKA,DIXON,651,97,2335,3083,0.21115796302302953,0.7573791761271489,0.031462860849821604
2020,NEBRASKA,DODGE,5544,348,10984,16876,0.328513865844987,0.6508651339179901,0.020621000237022992
2020,NEBRASKA,DOUGLAS,150350,5442,119159,274951,0.5468247069477834,0.43338267545853626,0.01979261759368033
2020,NEBRASKA,DUNDY,105,11,883,999,0.10510510510510511,0.8838838838838838,0.011011011011011011
2020,NEBRASKA,FILLMORE,693,82,2359,3134,0.22112316528398213,0.7527121888959796,0.02616464582003829
2020,NEBRASKA,FRANKLIN,276,11,1437,1724,0.16009280742459397,0.8335266821345708,0.0063805104408352666
2020,NEBRASKA,FRONTIER,189,22,1229,1440,0.13125,0.8534722222222222,0.015277777777777777
2020,NEBRASKA,FURNAS,399,39,2163,2601,0.15340253748558247,0.831603229527105,0.014994232987312572
2020,NEBRASKA,GAGE,3385,238,7445,11068,0.30583664618720635,0.672659920491507,0.021503433321286593
2020,NEBRASKA,GARDEN,161,18,1016,1195,0.13472803347280335,0.8502092050209205,0.01506276150627615
2020,NEBRASKA,GARFIELD,133,9,933,1075,0.12372093023255815,0.867906976744186,0.008372093023255815
2020,NEBRASKA,GOSPER,215,10,893,1118,0.19230769230769232,0.7987477638640429,0.008944543828264758
2020,NEBRASKA,GRANT,20,7,375,402,0.04975124378109453,0.9328358208955224,0.017412935323383085
2020,NEBRASKA,GREELEY,229,13,1016,1258,0.1820349761526232,0.8076311605723371,0.010333863275039745
2020,NEBRASKA,HALL,7681,504,16189,24374,0.31513087716419136,0.664191351440059,0.02067777139574957
2020,NEBRASKA,HAMILTON,1118,106,4309,5533,0.20206036508223388,0.778781854328574,0.01915778058919212
2020,NEBRASKA,HARLAN,282,31,1615,1928,0.1462655601659751,0.8376556016597511,0.016078838174273857
2020,NEBRASKA,HAYES,34,6,494,534,0.06367041198501873,0.9250936329588015,0.011235955056179775
2020,NEBRASKA,HITCHCOCK,175,30,1264,1469,0.1191286589516678,0.8604492852280463,0.02042205582028591
2020,NEBRASKA,HOLT,686,82,4769,5537,0.12389380530973451,0.8612967310818133,0.01480946360845223
2020,NEBRASKA,HOOKER,59,7,376,442,0.1334841628959276,0.8506787330316742,0.01583710407239819
2020,NEBRASKA,HOWARD,648,67,2786,3501,0.18508997429305912,0.7957726363896029,0.019137389317337904
2020,NEBRASKA,JEFFERSON,1016,84,2616,3716,0.27341227125941875,0.7039827771797632,0.022604951560818085
2020,NEBRASKA,JOHNSON,647,64,1518,2229,0.2902646926873037,0.6810228802153432,0.028712427097353072
2020,NEBRASKA,KEARNEY,701,81,2822,3604,0.19450610432852386,0.7830188679245284,0.022475027746947835
2020,NEBRASKA,KEITH,763,57,3544,4364,0.174839596700275,0.8120989917506874,0.01306141154903758
2020,NEBRASKA,KEYA PAHA,49,4,476,529,0.09262759924385633,0.8998109640831758,0.007561436672967864
2020,NEBRASKA,KIMBALL,268,43,1563,1874,0.14300960512273211,0.8340448239060833,0.02294557097118463
2020,NEBRASKA,KNOX,905,71,3721,4697,0.19267617628273365,0.7922077922077922,0.015116031509474133
2020,NEBRASKA,LANCASTER,82293,3706,70092,156091,0.5272116906163712,0.44904574895413574,0.02374256042949305
2020,NEBRASKA,LINCOLN,3692,344,13071,17107,0.21581808616355877,0.7640731864149178,0.020108727421523354
2020,NEBRASKA,LOGAN,38,5,407,450,0.08444444444444445,0.9044444444444445,0.011111111111111112
2020,NEBRASKA,LOUP,75,9,370,454,0.16519823788546256,0.8149779735682819,0.019823788546255508
2020,NEBRASKA,MADISON,3478,347,11940,15765,0.22061528702822708,0.7573739295908658,0.022010783380907072
2020,NEBRASKA,MCPHERSON,17,10,275,302,0.056291390728476824,0.9105960264900662,0.033112582781456956
2020,NEBRASKA,MERRICK,743,95,3419,4257,0.17453605825698848,0.8031477566361287,0.022316185106882783
2020,NEBRASKA,MORRILL,386,58,2113,2557,0.1509581540868205,0.8263590144700821,0.02268283144309738
2020,NEBRASKA,NANCE,359,32,1437,1828,0.1963894967177243,0.7861050328227571,0.0175054704595186
2020,NEBRASKA,NEMAHA,921,74,2428,3423,0.26906222611744085,0.7093193105463044,0.021618463336254747
2020,NEBRASKA,NUCKOLLS,409,37,1857,2303,0.177594442032132,0.8063395570994355,0.01606600086843248
2020,NEBRASKA,OTOE,2490,176,5649,8315,0.2994588093806374,0.679374624173181,0.0211665664461816
2020,NEBRASKA,PAWNEE,322,36,1071,1429,0.22533240027991602,0.7494751574527642,0.025192442267319804
2020,NEBRASKA,PERKINS,199,24,1321,1544,0.12888601036269431,0.8555699481865285,0.015544041450777202
2020,NEBRASKA,PHELPS,752,100,4157,5009,0.1501297664204432,0.8299061688959872,0.019964064683569576
2020,NEBRASKA,PIERCE,480,64,3462,4006,0.11982026959560658,0.8642036944583126,0.01597603594608088
2020,NEBRASKA,PLATTE,3260,227,12186,15673,0.2080010208639061,0.7775154724685766,0.014483506667517387
2020,NEBRASKA,POLK,530,58,2291,2879,0.18409169850642584,0.7957624175060785,0.020145883987495658
2020,NEBRASKA,RED WILLOW,811,116,4525,5452,0.1487527512839325,0.8299706529713866,0.02127659574468085
2020,NEBRASKA,RICHARDSON,996,57,3073,4126,0.24139602520601067,0.7447891420261755,0.013814832767813864
2020,NEBRASKA,ROCK,84,13,744,841,0.09988109393579073,0.8846611177170036,0.015457788347205707
2020,NEBRASKA,SALINE,1986,153,3631,5770,0.3441941074523397,0.6292894280762565,0.026516464471403812
2020,NEBRASKA,SARPY,41206,2488,51979,95673,0.4306962256854076,0.5432985272751978,0.026005247039394604
2020,NEBRASKA,SAUNDERS,3331,296,9108,12735,0.2615626226933647,0.7151943462897526,0.023243031016882607
2020,NEBRASKA,SCOTTS BLUFF,4196,321,10952,15469,0.27125218178292065,0.7079966384381666,0.020751179778912665
2020,NEBRASKA,SEWARD,2438,214,6490,9142,0.2666812513673157,0.7099103040910085,0.02340844454167578
2020,NEBRASKA,SHERIDAN,340,40,2292,2672,0.12724550898203593,0.8577844311377245,0.014970059880239521
2020,NEBRASKA,SHERMAN,343,33,1322,1698,0.20200235571260305,0.7785630153121319,0.019434628975265017
2020,NEBRASKA,SIOUX,72,15,642,729,0.09876543209876543,0.8806584362139918,0.0205761316872428
2020,NEBRASKA,STANTON,532,68,2561,3161,0.1683011705156596,0.8101866497943688,0.021512179689971527
2020,NEBRASKA,THAYER,624,48,2308,2980,0.20939597315436242,0.774496644295302,0.016107382550335572
2020,NEBRASKA,THOMAS,45,5,377,427,0.1053864168618267,0.882903981264637,0.0117096018735363
2020,NEBRASKA,THURSTON,1122,23,1180,2325,0.48258064516129034,0.5075268817204301,0.00989247311827957
2020,NEBRASKA,VALLEY,412,27,1901,2340,0.17606837606837608,0.8123931623931624,0.011538461538461539
2020,NEBRASKA,WASHINGTON,3554,276,8583,12413,0.2863127366470636,0.6914525094658825,0.022234753887053895
2020,NEBRASKA,WAYNE,1022,123,3055,4200,0.24333333333333335,0.7273809523809524,0.029285714285714286
2020,NEBRASKA,WEBSTER,335,30,1511,1876,0.17857142857142858,0.8054371002132196,0.015991471215351813
2020,NEBRASKA,WHEELER,59,5,438,502,0.11752988047808766,0.8725099601593626,0.0099601593625498
2020,NEBRASKA,YORK,1630,176,5337,7143,0.22819543609127818,0.747165056698866,0.024639507209855804
2020,NEVADA,CARSON CITY,12735,891,16113,29739,0.4282255623928175,0.5418137798849995,0.029960657722182992
2020,NEVADA,CHURCHILL,3048,466,9367,12881,0.23662759102554148,0.7271950935486375,0.03617731542582098
2020,NEVADA,CLARK,521777,19722,430809,972308,0.5366375675197571,0.4430787363674885,0.020283696112754393
2020,NEVADA,DOUGLAS,11570,924,21623,34117,0.3391271213764399,0.6337896063546032,0.027083272268956824
2020,NEVADA,ELKO,4555,668,16734,21957,0.20745092681149518,0.7621259734936466,0.03042309969485813
2020,NEVADA,ESMERALDA,72,13,395,480,0.15,0.8229166666666666,0.027083333333333334
2020,NEVADA,EUREKA,104,17,887,1008,0.10317460317460317,0.8799603174603174,0.016865079365079364
2020,NEVADA,HUMBOLDT,1689,205,5877,7771,0.21734654484622315,0.7562733238965385,0.02638013125723845
2020,NEVADA,LANDER,496,71,2198,2765,0.17938517179023508,0.7949367088607595,0.025678119349005425
2020,NEVADA,LINCOLN,330,49,2067,2446,0.1349141455437449,0.8450531479967294,0.020032706459525755
2020,NEVADA,LYON,8472,851,20906,30229,0.28026067683350425,0.691587548380694,0.028151774785801713
2020,NEVADA,MINERAL,824,83,1420,2327,0.3541039965620971,0.6102277610657499,0.035668242372152985
2020,NEVADA,NYE,7287,562,17527,25376,0.2871610970996217,0.6906919924337958,0.022146910466582598
2020,NEVADA,PERSHING,547,42,1731,2320,0.23577586206896553,0.7461206896551724,0.01810344827586207
2020,NEVADA,STOREY,900,67,1901,2868,0.3138075313807531,0.6628312412831241,0.023361227336122732
2020,NEVADA,WASHOE,128052,7251,116653,251956,0.5082315959929512,0.4629895696073918,0.02877883439965708
2020,NEVADA,WHITE PINE,856,107,3400,4363,0.19619527847811138,0.7792803117121246,0.024524409809763923
2020,NEW HAMPSHIRE,BELKNAP,16894,598,20899,38391,0.44005105363236174,0.5443723789429814,0.015576567424656821
2020,NEW HAMPSHIRE,CARROLL,16649,422,16150,33221,0.501158905511574,0.4861382860239005,0.01270280846452545
2020,NEW HAMPSHIRE,CHESHIRE,25522,800,17898,44220,0.5771596562641339,0.40474898236092266,0.018091361374943465
2020,NEW HAMPSHIRE,COOS,7640,258,8617,16515,0.46260974871329097,0.521768089615501,0.015622161671207993
2020,NEW HAMPSHIRE,GRAFTON,33180,881,19905,53966,0.6148315606122373,0.368843345810325,0.016325093577437645
2020,NEW HAMPSHIRE,HILLSBOROUGH,122344,3972,104625,230941,0.5297630130639427,0.4530377888724826,0.01719919806357468
2020,NEW HAMPSHIRE,MERRIMACK,48533,1561,39711,89805,0.5404264795946774,0.44219141473191914,0.017382105673403484
2020,NEW HAMPSHIRE,ROCKINGHAM,100064,2876,95858,198798,0.5033451040754937,0.48218794957695754,0.014466946347548769
2020,NEW HAMPSHIRE,STRAFFORD,41721,1386,30489,73596,0.5668922224033915,0.41427523234958424,0.018832545247024296
2020,NEW HAMPSHIRE,SULLIVAN,12390,482,11508,24380,0.5082034454470877,0.47202625102543067,0.01977030352748154
2020,NEW JERSEY,ATLANTIC,73808,1785,64438,140031,0.5270832887003593,0.4601695338889246,0.012747177410716199
2020,NEW JERSEY,BERGEN,285967,5465,204417,495849,0.5767219455923074,0.41225655391056554,0.01102150049712715
2020,NEW JERSEY,BURLINGTON,154595,3557,103345,261497,0.5911922507715194,0.39520529872235627,0.013602450506124353
2020,NEW JERSEY,CAMDEN,175065,3344,86207,264616,0.6615813102760226,0.3257815098104423,0.012637179913535085
2020,NEW JERSEY,CAPE MAY,23941,615,33158,57714,0.41482136050178464,0.5745226461517137,0.010655993346501715
2020,NEW JERSEY,CUMBERLAND,32742,714,28952,62408,0.5246442763748237,0.4639148827073452,0.011440840917831048
2020,NEW JERSEY,ESSEX,266820,3016,75475,345311,0.7726947592170537,0.2185710851956642,0.008734155587282189
2020,NEW JERSEY,GLOUCESTER,86702,2612,83340,172654,0.5021719740058151,0.4826995030523475,0.015128522941837433
2020,NEW JERSEY,HUDSON,181452,2700,65698,249850,0.7262437462477487,0.26294976986191715,0.010806483890334201
2020,NEW JERSEY,HUNTERDON,39457,1632,43153,84242,0.4683768191638375,0.5122504214049999,0.019372759431162602
2020,NEW JERSEY,MERCER,122532,2431,51641,176604,0.6938234694570904,0.29241127041290116,0.01376526013000838
2020,NEW JERSEY,MIDDLESEX,226250,4645,143467,374362,0.6043615537901817,0.3832306697795182,0.012407776430300084
2020,NEW JERSEY,MONMOUTH,181291,5052,191808,378151,0.47941430804096774,0.5072259494223207,0.013359742536711525
2020,NEW JERSEY,MORRIS,153881,4307,141134,299322,0.5140985293429818,0.4715122844294773,0.01438918622754091
2020,NEW JERSEY,OCEAN,119456,4320,217740,341516,0.3497815622108481,0.6375689572377282,0.012649480551423653
2020,NEW JERSEY,PASSAIC,129097,2601,92009,223707,0.5770807350686389,0.4112924494986746,0.011626815432686505
2020,NEW JERSEY,SALEM,14479,616,18827,33922,0.42683214433111255,0.555008549024232,0.018159306644655385
2020,NEW JERSEY,SOMERSET,111173,2690,71996,185859,0.5981577432354634,0.3873689194496904,0.0144733373148462
2020,NEW JERSEY,SUSSEX,34481,1781,51698,87960,0.39200773078672124,0.5877444292860391,0.020247839927239653
2020,NEW JERSEY,UNION,170245,2744,80002,252991,0.672929076528414,0.3162246878347451,0.010846235636840836
2020,NEW JERSEY,WARREN,24901,1117,34769,60787,0.40964350930297594,0.5719808511688355,0.018375639528188593
2020,NEW MEXICO,BERNALILLO,193757,7698,116135,317590,0.6100853301426368,0.3656758714065304,0.024238798450832835
2020,NEW MEXICO,CATRON,595,33,1698,2326,0.25580395528804817,0.7300085984522786,0.014187446259673258
2020,NEW MEXICO,CHAVES,6381,406,15656,22443,0.2843202780376955,0.6975894488259146,0.018090273136389966
2020,NEW MEXICO,CIBOLA,4745,183,3975,8903,0.5329664158148939,0.4464787150398742,0.020554869145231944
2020,NEW MEXICO,COLFAX,2611,134,3271,6016,0.4340093085106383,0.543716755319149,0.022273936170212765
2020,NEW MEXICO,CURRY,4307,350,10444,15101,0.2852128998079597,0.691609827163764,0.023177273028276272
2020,NEW MEXICO,DE BACA,231,14,656,901,0.2563817980022198,0.7280799112097669,0.01553829078801332
2020,NEW MEXICO,DONA ANA,47957,1882,32802,82641,0.5803051753972,0.3969216248593313,0.02277319974346874
2020,NEW MEXICO,EDDY,5424,344,17454,23222,0.23357161312548447,0.7516148479889759,0.014813538885539575
2020,NEW MEXICO,GRANT,7590,292,6553,14435,0.5258053342570143,0.45396605472809143,0.020228611014894354
2020,NEW MEXICO,GUADALUPE,1234,38,917,2189,0.5637277295568753,0.4189127455459114,0.01735952489721334
2020,NEW MEXICO,HARDING,179,7,319,505,0.35445544554455444,0.6316831683168317,0.013861386138613862
2020,NEW MEXICO,HIDALGO,823,31,1120,1974,0.41691995947315097,0.5673758865248227,0.015704154002026342
2020,NEW MEXICO,LEA,4061,326,16531,20918,0.1941390190266756,0.7902763170475189,0.015584663925805526
2020,NEW MEXICO,LINCOLN,3194,170,6942,10306,0.30991655346400154,0.6735882010479333,0.016495245488065205
2020,NEW MEXICO,LOS ALAMOS,7554,461,4278,12293,0.6144960546652567,0.348002928495892,0.037501016838851375
2020,NEW MEXICO,LUNA,3563,132,4408,8103,0.43971368628902874,0.543996050845366,0.01629026286560533
2020,NEW MEXICO,MCKINLEY,18029,656,7801,26486,0.6806992373329306,0.29453296080948427,0.02476780185758514
2020,NEW MEXICO,MORA,1745,38,903,2686,0.6496649292628444,0.3361876396128071,0.014147431124348473
2020,NEW MEXICO,OTERO,8485,565,14521,23571,0.3599762419922786,0.6160536252174282,0.023970132790293155
2020,NEW MEXICO,QUAY,1170,69,2634,3873,0.3020914020139427,0.6800929512006196,0.017815646785437646
2020,NEW MEXICO,RIO ARRIBA,10990,230,5408,16628,0.6609333654077459,0.3252345441424104,0.013832090449843638
2020,NEW MEXICO,ROOSEVELT,1802,172,4634,6608,0.2726997578692494,0.701271186440678,0.02602905569007264
2020,NEW MEXICO,SAN JUAN,18083,1337,32874,52294,0.34579492867250544,0.6286380846751062,0.02556698665238842
2020,NEW MEXICO,SAN MIGUEL,7888,222,3421,11531,0.6840690313069118,0.2966785187754748,0.01925244991761339
2020,NEW MEXICO,SANDOVAL,40588,1800,34174,76562,0.5301324416812518,0.4463572007000862,0.023510357618662
2020,NEW MEXICO,SANTA FE,62530,1368,18329,82227,0.7604558113515025,0.2229073175477641,0.016636871100733336
2020,NEW MEXICO,SIERRA,2265,138,3542,5945,0.3809924306139613,0.5957947855340623,0.023212783851976452
2020,NEW MEXICO,SOCORRO,3722,183,3255,7160,0.5198324022346369,0.454608938547486,0.025558659217877096
2020,NEW MEXICO,TAOS,13121,345,3715,17181,0.7636924509632734,0.21622722775158607,0.020080321285140562
2020,NEW MEXICO,TORRANCE,2344,165,4772,7281,0.3219338003021563,0.6554044774069496,0.02266172229089411
2020,NEW MEXICO,UNION,383,18,1388,1789,0.21408608160983789,0.7758524315259921,0.010061486864169928
2020,NEW MEXICO,VALENCIA,14263,650,17364,32277,0.4418936084518388,0.537968212659169,0.02013817888899216
2020,NEW YORK,ALBANY,99474,4172,51081,154727,0.6429000756170545,0.33013630458808096,0.026963619794864502
2020,NEW YORK,ALLEGANY,6048,712,14135,20895,0.2894472361809045,0.67647762622637,0.034075137592725534
2020,NEW YORK,BRONX,355374,9285,67740,432399,0.8218659155085928,0.15666086184288122,0.021473222648526014
2020,NEW YORK,BROOME,47010,2684,43800,93494,0.5028130147389137,0.4684792607012215,0.028707724559864804
2020,NEW YORK,CATTARAUGUS,11879,984,22155,35018,0.3392255411502656,0.6326746244788395,0.028099834370894968
2020,NEW YORK,CAYUGA,16149,1099,19512,36760,0.4393090315560392,0.5307943416757345,0.029896626768226332
2020,NEW YORK,CHAUTAUQUA,23087,1830,34853,59770,0.386264012046177,0.5831186213819642,0.030617366571858793
2020,NEW YORK,CHEMUNG,16636,1153,21922,39711,0.41892674573795674,0.5520384780035759,0.029034776258467426
2020,NEW YORK,CHENANGO,8290,645,13482,22417,0.3698086273810055,0.6014185662666726,0.0287728063523219
2020,NEW YORK,CLINTON,18364,759,16514,35637,0.5153071246176727,0.4633947863175913,0.021298089064736087
2020,NEW YORK,COLUMBIA,20386,931,14464,35781,0.569743718733406,0.40423688549788994,0.02601939576870406
2020,NEW YORK,CORTLAND,10369,734,10789,21892,0.4736433400328887,0.4928284304768865,0.03352822949022474
2020,NEW YORK,DELAWARE,9143,544,13387,23074,0.3962468579353385,0.5801768223975037,0.02357631966715784
2020,NEW YORK,DUTCHESS,81443,3574,66872,151889,0.5362007781998697,0.44026888056409613,0.02353034123603421
2020,NEW YORK,ERIE,267174,12086,197527,476787,0.5603634327278219,0.41428772177093753,0.025348845501240596
2020,NEW YORK,ESSEX,9947,547,8976,19470,0.5108885464817668,0.4610169491525424,0.028094504365690807
2020,NEW YORK,FRANKLIN,9253,499,9668,19420,0.4764675592173018,0.49783728115345005,0.025695159629248197
2020,NEW YORK,FULTON,7931,763,15378,24072,0.3294699235626454,0.6388334995014955,0.03169657693585909
2020,NEW YORK,GENESEE,9625,930,18876,29431,0.32703611837858043,0.6413645475858788,0.03159933403554076
2020,NEW YORK,GREENE,10346,703,14271,25320,0.40860979462875197,0.5636255924170616,0.027764612954186415
2020,NEW YORK,HAMILTON,1178,86,2225,3489,0.33763255947262827,0.6377185439954142,0.024648896531957582
2020,NEW YORK,HERKIMER,9937,753,18870,29560,0.3361637347767253,0.6383626522327469,0.02547361299052774
2020,NEW YORK,JEFFERSON,17307,1193,25629,44129,0.39219107616306736,0.5807745473498153,0.027034376487117314
2020,NEW YORK,KINGS,703310,14298,202772,920380,0.764151763402073,0.2203133488341772,0.015534887763749755
2020,NEW YORK,LEWIS,3824,318,8894,13036,0.29334151580239337,0.6822644983123658,0.02439398588524087
2020,NEW YORK,LIVINGSTON,12477,997,18182,31656,0.39414329037149354,0.5743618903209502,0.03149481930755623
2020,NEW YORK,MADISON,14807,1051,18408,34266,0.4321193019319442,0.5372088951146909,0.03067180295336485
2020,NEW YORK,MONROE,225746,12092,145661,383499,0.5886482102952029,0.37982106863381654,0.03153072107098063
2020,NEW YORK,MONTGOMERY,7977,524,12745,21246,0.3754589099124541,0.5998776240233455,0.02466346606420032
2020,NEW YORK,NASSAU,396504,15149,326716,738369,0.5369997927865335,0.4424833653633888,0.020516841850077672
2020,NEW YORK,NEW YORK,603040,13180,85185,701405,0.8597600530364055,0.12144909146641385,0.01879085549718066
2020,NEW YORK,NIAGARA,46029,2769,56068,104866,0.4389315888848626,0.5346632845726927,0.026405126542444642
2020,NEW YORK,ONEIDA,41567,2949,57180,101696,0.4087378067967275,0.5622640025173065,0.028998190685966017
2020,NEW YORK,ONONDAGA,138894,6173,90619,235686,0.5893179908861791,0.3844903812699948,0.026191627843826108
2020,NEW YORK,ONTARIO,29025,2021,29039,60085,0.48306565698593656,0.48329866023133894,0.033635682782724476
2020,NEW YORK,ORANGE,84684,3625,84996,173305,0.48864141253858806,0.4904417068174605,0.020916880643951415
2020,NEW YORK,ORLEANS,5587,601,12126,18314,0.3050671617341924,0.6621164136726002,0.03281642459320738
2020,NEW YORK,OSWEGO,21143,1571,32138,54852,0.3854554072777656,0.585903886822723,0.028640705899511412
2020,NEW YORK,OTSEGO,12975,866,14382,28223,0.45973142472451545,0.5095843815327924,0.030684193742692132
2020,NEW YORK,PUTNAM,24953,1082,29283,55318,0.45108283018185763,0.5293575328102968,0.01955963700784555
2020,NEW YORK,QUEENS,569038,12795,212665,794498,0.7162233259240426,0.26767216531696747,0.016104508758989954
2020,NEW YORK,RENSSELAER,40969,2493,36500,79962,0.512355869037793,0.45646682174032666,0.031177309221880393
2020,NEW YORK,RICHMOND,90997,3582,123320,217899,0.4176109114773358,0.5659502797167495,0.016438808805914668
2020,NEW YORK,ROCKLAND,75802,2393,73186,151381,0.5007365521432676,0.4834556516339567,0.015807796222775644
2020,NEW YORK,SARATOGA,68471,3780,61305,133556,0.5126763305280182,0.45902093503848573,0.02830273443349606
2020,NEW YORK,SCHENECTADY,42465,2175,30741,75381,0.5633382417320014,0.40780833366498187,0.028853424603016674
2020,NEW YORK,SCHOHARIE,5345,562,9903,15810,0.33807716635041113,0.6263757115749525,0.035547122074636305
2020,NEW YORK,SCHUYLER,3903,275,5621,9799,0.3983059495866925,0.573629962241045,0.028064088172262476
2020,NEW YORK,SENECA,6914,475,8329,15718,0.43987784705433264,0.5299020231581626,0.03022012978750477
2020,NEW YORK,ST. LAWRENCE,19361,1298,24608,45267,0.4277067179181302,0.5436189718779685,0.028674310203901297
2020,NEW YORK,STEUBEN,15790,1252,29474,46516,0.3394530914094075,0.6336314386447673,0.026915469945825093
2020,NEW YORK,SUFFOLK,368000,14056,375821,757877,0.4855669191702611,0.49588653567795304,0.018546545151785845
2020,NEW YORK,SULLIVAN,15489,978,18665,35132,0.4408801093020608,0.5312820220881248,0.027837868609814412
2020,NEW YORK,TIOGA,9634,745,14791,25170,0.38275725069527217,0.5876440206595153,0.029598728645212555
2020,NEW YORK,TOMPKINS,33619,1333,11096,46048,0.7300859972202919,0.24096594857539957,0.028948054204308547
2020,NEW YORK,ULSTER,57970,2600,37590,98160,0.5905664221678891,0.38294621026894865,0.026487367563162185
2020,NEW YORK,WARREN,17642,1053,17699,36394,0.4847502335549816,0.48631642578447,0.02893334066054844
2020,NEW YORK,WASHINGTON,11565,750,15941,28256,0.4092936013590034,0.5641633635334088,0.026543035107587768
2020,NEW YORK,WAYNE,17456,1371,26204,45031,0.3876440674202216,0.5819102396127113,0.03044569296706713
2020,NEW YORK,WESTCHESTER,312371,5181,144713,462265,0.6757401057834792,0.31305203725136016,0.011207856965160676
2020,NEW YORK,WYOMING,5073,512,13898,19483,0.26038084483909046,0.7133398347277113,0.026279320433198174
2020,NEW YORK,YATES,4219,361,6208,10788,0.3910826844642195,0.5754542083796811,0.03346310715609937
2020,NORTH DAKOTA,ADAMS,258,30,981,1269,0.2033096926713948,0.7730496453900709,0.02364066193853428
2020,NORTH DAKOTA,BARNES,1820,177,3568,5565,0.3270440251572327,0.6411500449236298,0.031805929919137464
2020,NORTH DAKOTA,BENSON,822,45,1094,1961,0.4191738908720041,0.5578786333503315,0.022947475777664456
2020,NORTH DAKOTA,BILLINGS,72,22,541,635,0.11338582677165354,0.8519685039370078,0.03464566929133858
2020,NORTH DAKOTA,BOTTINEAU,821,75,2575,3471,0.23653125900316913,0.7418611351195621,0.021607605877268798
2020,NORTH DAKOTA,BOWMAN,228,34,1395,1657,0.1375980687990344,0.8418829209414604,0.02051901025950513
2020,NORTH DAKOTA,BURKE,137,24,994,1155,0.11861471861471862,0.8606060606060606,0.02077922077922078
2020,NORTH DAKOTA,BURLEIGH,14348,1661,34744,50753,0.2827025003448072,0.6845703702244202,0.032727129430772564
2020,NORTH DAKOTA,CASS,40311,3123,42619,86053,0.46844386598956456,0.49526454626799765,0.0362915877424378
2020,NORTH DAKOTA,CAVALIER,474,47,1499,2020,0.23465346534653464,0.7420792079207921,0.023267326732673267
2020,NORTH DAKOTA,DICKEY,608,74,1742,2424,0.2508250825082508,0.7186468646864687,0.03052805280528053
2020,NORTH DAKOTA,DIVIDE,265,33,904,1202,0.22046589018302828,0.7520798668885191,0.02745424292845258
2020,NORTH DAKOTA,DUNN,342,45,1951,2338,0.14627887082976904,0.8344739093242087,0.01924721984602224
2020,NORTH DAKOTA,EDDY,383,24,854,1261,0.3037272006344171,0.6772402854877082,0.0190325138778747
2020,NORTH DAKOTA,EMMONS,237,34,1738,2009,0.11796913887506222,0.8651070184171229,0.016923842707814832
2020,NORTH DAKOTA,FOSTER,373,43,1362,1778,0.20978627671541059,0.766029246344207,0.024184476940382452
2020,NORTH DAKOTA,GOLDEN VALLEY,137,18,871,1026,0.13352826510721247,0.8489278752436648,0.017543859649122806
2020,NORTH DAKOTA,GRAND FORKS,12880,1103,16987,30970,0.41588634162092347,0.5484985469809494,0.03561511139812722
2020,NORTH DAKOTA,GRANT,207,29,1145,1381,0.1498913830557567,0.8291093410572049,0.020999275887038378
2020,NORTH DAKOTA,GRIGGS,308,35,907,1250,0.2464,0.7256,0.028
2020,NORTH DAKOTA,HETTINGER,196,25,1091,1312,0.14939024390243902,0.8315548780487805,0.019054878048780487
2020,NORTH DAKOTA,KIDDER,221,24,1215,1460,0.15136986301369862,0.8321917808219178,0.01643835616438356
2020,NORTH DAKOTA,LAMOURE,527,47,1645,2219,0.23749436683190625,0.7413249211356467,0.02118071203244705
2020,NORTH DAKOTA,LOGAN,128,18,930,1076,0.11895910780669144,0.8643122676579925,0.016728624535315983
2020,NORTH DAKOTA,MCHENRY,564,75,2364,3003,0.1878121878121878,0.7872127872127872,0.024975024975024976
2020,NORTH DAKOTA,MCINTOSH,261,41,1153,1455,0.17938144329896907,0.7924398625429553,0.028178694158075602
2020,NORTH DAKOTA,MCKENZIE,814,123,4482,5419,0.1502122162760657,0.8270898689795165,0.02269791474441779
2020,NORTH DAKOTA,MCLEAN,1230,108,4198,5536,0.2221820809248555,0.7583092485549133,0.019508670520231215
2020,NORTH DAKOTA,MERCER,704,115,3856,4675,0.15058823529411763,0.824812834224599,0.02459893048128342
2020,NORTH DAKOTA,MORTON,3872,504,12243,16619,0.2329863409350743,0.7366869246043685,0.030326734460557194
2020,NORTH DAKOTA,MOUNTRAIL,1256,85,2824,4165,0.30156062424969987,0.678031212484994,0.02040816326530612
2020,NORTH DAKOTA,NELSON,586,50,1141,1777,0.3297692740574001,0.6420934158694429,0.028137310073157007
2020,NORTH DAKOTA,OLIVER,129,19,918,1066,0.12101313320825516,0.8611632270168855,0.017823639774859287
2020,NORTH DAKOTA,PEMBINA,786,85,2460,3331,0.23596517562293606,0.7385169618733113,0.025517862503752625
2020,NORTH DAKOTA,PIERCE,497,46,1585,2128,0.23355263157894737,0.7448308270676691,0.021616541353383457
2020,NORTH DAKOTA,RAMSEY,1639,156,3577,5372,0.30510052122114667,0.6658600148920327,0.029039463886820552
2020,NORTH DAKOTA,RANSOM,945,91,1418,2454,0.38508557457212717,0.5778321108394459,0.037082314588427055
2020,NORTH DAKOTA,RENVILLE,220,34,1065,1319,0.16679302501895377,0.8074298711144806,0.02577710386656558
2020,NORTH DAKOTA,RICHLAND,2510,230,5072,7812,0.3213005632360471,0.6492575524833589,0.02944188428059396
2020,NORTH DAKOTA,ROLETTE,2482,65,1257,3804,0.6524710830704522,0.3304416403785489,0.01708727655099895
2020,NORTH DAKOTA,SARGENT,738,66,1266,2070,0.3565217391304348,0.6115942028985507,0.03188405797101449
2020,NORTH DAKOTA,SHERIDAN,104,20,688,812,0.12807881773399016,0.8472906403940886,0.024630541871921183
2020,NORTH DAKOTA,SIOUX,804,124,258,1186,0.6779089376053963,0.2175379426644182,0.1045531197301855
2020,NORTH DAKOTA,SLOPE,44,3,380,427,0.10304449648711944,0.8899297423887588,0.00702576112412178
2020,NORTH DAKOTA,STARK,2499,441,12110,15050,0.16604651162790698,0.8046511627906977,0.02930232558139535
2020,NORTH DAKOTA,STEELE,392,44,652,1088,0.3602941176470588,0.5992647058823529,0.04044117647058824
2020,NORTH DAKOTA,STUTSMAN,2676,289,6994,9959,0.26870167687518826,0.7022793453157947,0.02901897780901697
2020,NORTH DAKOTA,TOWNER,317,27,830,1174,0.27001703577512776,0.706984667802385,0.022998296422487224
2020,NORTH DAKOTA,TRAILL,1493,121,2522,4136,0.3609767891682785,0.6097678916827853,0.02925531914893617
2020,NORTH DAKOTA,WALSH,1333,126,3324,4783,0.27869537946895256,0.6949613213464353,0.026343299184612166
2020,NORTH DAKOTA,WARD,7293,979,19974,28246,0.2581958507399278,0.7071443744246974,0.03465977483537492
2020,NORTH DAKOTA,WELLS,442,39,1893,2374,0.18618365627632688,0.7973883740522325,0.016427969671440605
2020,NORTH DAKOTA,WILLIAMS,2169,426,11739,14334,0.15131854332356634,0.8189619087484303,0.02971954792800335
2020,OHIO,ADAMS,2156,119,9870,12145,0.17752161383285303,0.8126801152737753,0.009798270893371758
2020,OHIO,ALLEN,14149,741,33116,48006,0.2947339915843853,0.6898304378619339,0.01543557055368079
2020,OHIO,ASHLAND,6541,457,19407,26405,0.24771823518273053,0.7349744366597235,0.01730732815754592
2020,OHIO,ASHTABULA,16497,760,26890,44147,0.3736833759938388,0.6091014111944186,0.017215212811742587
2020,OHIO,ATHENS,14772,425,10862,26059,0.5668674929966614,0.4168233623700065,0.016309144633332055
2020,OHIO,AUGLAIZE,4651,328,20798,25777,0.18043216821197192,0.8068433099274547,0.012724521860573379
2020,OHIO,BELMONT,9138,390,23560,33088,0.27617263056092844,0.7120406189555126,0.011786750483558994
2020,OHIO,BROWN,4380,236,16480,21096,0.20762229806598406,0.7811907470610542,0.011186954872961698
2020,OHIO,BUTLER,69613,2732,114392,186737,0.37278632515248716,0.612583473012847,0.014630201834665867
2020,OHIO,CARROLL,3251,216,10745,14212,0.2287503518153673,0.7560512243174782,0.015198423867154517
2020,OHIO,CHAMPAIGN,5062,321,14589,19972,0.25345483677148006,0.730472661726417,0.016072501502102945
2020,OHIO,CLARK,24076,1104,39032,64212,0.3749454930542578,0.6078614589173363,0.017193048028405905
2020,OHIO,CLERMONT,34092,1818,74570,110480,0.30858073859522084,0.6749637943519189,0.016455467052860245
2020,OHIO,CLINTON,4697,342,15488,20527,0.2288205777756126,0.7545184391289521,0.016660983095435282
2020,OHIO,COLUMBIANA,13359,775,35726,49860,0.26793020457280387,0.7165262735659848,0.015543521861211392
2020,OHIO,COSHOCTON,4125,289,12325,16739,0.24643049166616882,0.7363044387358862,0.01726506959794492
2020,OHIO,CRAWFORD,4916,334,15436,20686,0.2376486512617229,0.7462051629121145,0.01614618582616262
2020,OHIO,CUYAHOGA,416176,6795,202699,625670,0.6651685393258427,0.323971102977608,0.010860357696549298
2020,OHIO,DARKE,4731,399,22004,27134,0.17435689540797522,0.8109383061841232,0.014704798407901527
2020,OHIO,DEFIANCE,5981,362,13038,19381,0.30860120736804086,0.6727207058459316,0.018678086786027552
2020,OHIO,DELAWARE,57735,1979,66356,126070,0.4579598635678591,0.5263425081304037,0.01569762830173713
2020,OHIO,ERIE,17493,682,22160,40335,0.4336928226106359,0.5493987851741664,0.01690839221519772
2020,OHIO,FAIRFIELD,31224,1290,50797,83311,0.37478844330280514,0.6097274069450612,0.015484149752133572
2020,OHIO,FAYETTE,2975,164,9473,12612,0.23588645734221375,0.7511100539169046,0.0130034887408817
2020,OHIO,FRANKLIN,409144,10196,211237,630577,0.648840664978266,0.33499001707959536,0.016169317942138706
2020,OHIO,FULTON,6664,375,15731,22770,0.29266578831796225,0.6908651734738691,0.016469038208168644
2020,OHIO,GALLIA,2990,164,10645,13799,0.21668236828755708,0.7714327125153997,0.011884919197043264
2020,OHIO,GEAUGA,21201,677,34143,56021,0.37844736795130396,0.6094678781171347,0.012084753931561379
2020,OHIO,GREENE,34798,1773,52072,88643,0.39256342858432136,0.5874349920467493,0.020001579368929302
2020,OHIO,GUERNSEY,4577,246,13407,18230,0.2510696653867252,0.7354360943499726,0.01349424026330225
2020,OHIO,HAMILTON,246266,6777,177886,430929,0.5714769718445498,0.41279653956916335,0.015726488586286835
2020,OHIO,HANCOCK,11757,704,26310,38771,0.30324211395114903,0.6785999845245158,0.018157901524335197
2020,OHIO,HARDIN,3062,236,9949,13247,0.23114667471880426,0.7510379708613271,0.01781535441986865
2020,OHIO,HARRISON,1768,95,5792,7655,0.2309601567602874,0.756629653821032,0.012410189418680601
2020,OHIO,HENRY,4062,223,10479,14764,0.2751286914115416,0.7097670008127879,0.01510430777567055
2020,OHIO,HIGHLAND,3799,199,15678,19676,0.19307786135393373,0.7968082943687741,0.010113844277292132
2020,OHIO,HOCKING,3880,207,9737,13824,0.2806712962962963,0.7043547453703703,0.014973958333333334
2020,OHIO,HOLMES,1994,157,10796,12947,0.15401251255117016,0.8338611261296053,0.012126361319224531
2020,OHIO,HURON,7759,475,18956,27190,0.285362265538801,0.6971680764987127,0.01746965796248621
2020,OHIO,JACKSON,3311,174,11309,14794,0.22380694876301202,0.7644315262944437,0.011761524942544274
2020,OHIO,JEFFERSON,10018,516,22828,33362,0.300281757688388,0.6842515436724417,0.015466698639170313
2020,OHIO,KNOX,8589,469,22340,31398,0.2735524555704185,0.7115102872794445,0.014937257150136952
2020,OHIO,LAKE,55514,1717,73278,130509,0.4253653004773617,0.5614785187228467,0.013156180799791585
2020,OHIO,LAWRENCE,7489,332,20306,28127,0.2662566217513421,0.7219397731716856,0.011803605076972304
2020,OHIO,LICKING,33055,1641,59514,94210,0.35086508863178006,0.6317163783037895,0.017418533064430527
2020,OHIO,LOGAN,5055,349,17964,23368,0.21632146525162615,0.7687435809654228,0.014934953782951043
2020,OHIO,LORAIN,75667,2250,79520,157437,0.48061764388295003,0.5050909252589925,0.01429143085805751
2020,OHIO,LUCAS,115411,3449,81763,200623,0.5752630555818625,0.4075454957806433,0.017191448637494205
2020,OHIO,MADISON,5698,322,13835,19855,0.2869806094182826,0.6968018131453034,0.016217577436414003
2020,OHIO,MAHONING,57641,1422,59903,118966,0.48451658457038144,0.5035304204562648,0.01195299497335373
2020,OHIO,MARION,8269,526,19023,27818,0.29725357682076353,0.6838378028614566,0.018908620317779855
2020,OHIO,MEDINA,39800,1427,64598,105825,0.3760926057169856,0.6104228679423577,0.013484526340656744
2020,OHIO,MEIGS,2492,143,8316,10951,0.22755912702036343,0.7593827047758196,0.013058168203817003
2020,OHIO,MERCER,4030,279,19452,23761,0.16960565632759564,0.8186524136189555,0.011741930053448929
2020,OHIO,MIAMI,15663,938,41371,57972,0.27018215690333264,0.7136376181604913,0.016180224936176085
2020,OHIO,MONROE,1605,80,5463,7148,0.2245383324006715,0.7642697257974258,0.01119194180190263
2020,OHIO,MONTGOMERY,135064,4407,129034,268505,0.5030222900877078,0.4805646077354239,0.016413102176868213
2020,OHIO,MORGAN,1725,81,5041,6847,0.2519351540820797,0.7362348473784139,0.011829998539506352
2020,OHIO,MORROW,4048,332,14077,18457,0.21932058297664841,0.762691661700168,0.017987755323183616
2020,OHIO,MUSKINGUM,11971,627,27867,40465,0.29583590757444705,0.6886692203138515,0.01549487211170147
2020,OHIO,NOBLE,1170,38,5135,6343,0.18445530506069682,0.8095538388775028,0.0059908560618004095
2020,OHIO,OTTAWA,9008,371,14628,24007,0.37522389303119924,0.6093222810013746,0.015453825967426168
2020,OHIO,PAULDING,2213,168,7086,9467,0.23375937466990598,0.7484947713108694,0.017745854019224676
2020,OHIO,PERRY,4098,220,12357,16675,0.24575712143928036,0.7410494752623689,0.013193403298350824
2020,OHIO,PICKAWAY,7304,374,20593,28271,0.25835661985780484,0.7284142761133316,0.0132291040288635
2020,OHIO,PIKE,3110,145,9157,12412,0.250563970351273,0.7377537866580728,0.011682242990654205
2020,OHIO,PORTAGE,35661,1221,45990,82872,0.43031421951925863,0.5549522154648132,0.014733565015928178
2020,OHIO,PREBLE,4493,294,17022,21809,0.20601586500985833,0.7805034618735385,0.013480673116603238
2020,OHIO,PUTNAM,3195,314,16412,19921,0.16038351488379096,0.8238542241855329,0.01576226093067617
2020,OHIO,RICHLAND,17640,863,41472,59975,0.2941225510629429,0.6914881200500208,0.014389328887036265
2020,OHIO,ROSS,10557,464,22278,33299,0.3170365476440734,0.6690290999729721,0.013934352382954443
2020,OHIO,SANDUSKY,10596,582,18896,30074,0.3523309170712243,0.6283168185143313,0.019352264414444372
2020,OHIO,SCIOTO,9080,358,22609,32047,0.28333385340281464,0.705495054139233,0.011171092457952383
2020,OHIO,SENECA,8266,458,17086,25810,0.3202634637737311,0.6619914761720264,0.01774506005424254
2020,OHIO,SHELBY,4465,371,20422,25258,0.1767756750336527,0.8085359094148389,0.014688415551508432
2020,OHIO,STARK,75904,2878,111097,189879,0.399749314036834,0.5850936649129183,0.01515702105024779
2020,OHIO,SUMMIT,151668,3972,124833,280473,0.5407579339187729,0.4450802751066948,0.014161790974532308
2020,OHIO,TRUMBULL,44519,1288,55194,101001,0.4407778140810487,0.5464698369323076,0.012752348986643697
2020,OHIO,TUSCARAWAS,12889,668,30458,44015,0.2928319890946268,0.6919913665795752,0.015176644325798024
2020,OHIO,UNION,11141,635,21669,33445,0.3331140678726267,0.647899536552549,0.018986395574824337
2020,OHIO,VAN WERT,3067,248,11650,14965,0.2049448713665219,0.7784831272970264,0.01657200133645172
2020,OHIO,VINTON,1331,67,4632,6030,0.2207296849087894,0.7681592039800995,0.011111111111111112
2020,OHIO,WARREN,46069,2043,87988,136100,0.3384937545922116,0.6464952240999265,0.015011021307861866
2020,OHIO,WASHINGTON,9243,481,22307,32031,0.2885642034279292,0.6964190940026849,0.015016702569385908
2020,OHIO,WAYNE,16660,864,36759,54283,0.3069100823462226,0.6771733323508281,0.015916585302949357
2020,OHIO,WILLIAMS,4842,357,13452,18651,0.2596107447321859,0.7212481904455526,0.01914106482226154
2020,OHIO,WOOD,30617,1223,35757,67597,0.45293430181812805,0.5289731792831043,0.018092518898767698
2020,OHIO,WYANDOT,2733,195,8462,11390,0.2399473222124671,0.7429323968393328,0.017120280948200176
2020,OREGON,BAKER,2346,234,7352,9932,0.23620620217478855,0.7402335884011276,0.02356020942408377
2020,OREGON,BENTON,35827,2094,14878,52799,0.6785545180779939,0.2817856398795432,0.03965984204246292
2020,OREGON,CLACKAMAS,139043,8127,110509,257679,0.5395977165387944,0.42886304277803006,0.03153924068317558
2020,OREGON,CLATSOP,12916,776,10218,23910,0.5401923881221247,0.4273525721455458,0.03245503973232957
2020,OREGON,COLUMBIA,13835,1236,17150,32221,0.42937835573073463,0.532261568542255,0.038360075727010334
2020,OREGON,COOS,14243,1003,21829,37075,0.3841672285906945,0.5887795010114633,0.02705327039784221
2020,OREGON,CROOK,3801,360,11287,15448,0.24605126877265665,0.7306447436561367,0.02330398757120663
2020,OREGON,CURRY,6058,383,8484,14925,0.40589614740368507,0.5684422110552764,0.025661641541038525
2020,OREGON,DESCHUTES,65962,3626,55646,125234,0.5267099988820927,0.4443362026286791,0.028953798489228164
2020,OREGON,DOUGLAS,19160,1891,43298,64349,0.2977513248069123,0.6728620491382927,0.029386626054794945
2020,OREGON,GILLIAM,324,20,834,1178,0.27504244482173174,0.7079796264855688,0.01697792869269949
2020,OREGON,GRANT,929,122,3545,4596,0.20213228894691035,0.7713228894691035,0.026544821583986074
2020,OREGON,HARNEY,894,112,3475,4481,0.19950903816112475,0.7754965409506807,0.0249944208881946
2020,OREGON,HOOD RIVER,8764,371,3955,13090,0.6695187165775401,0.30213903743315507,0.028342245989304814
2020,OREGON,JACKSON,59478,3818,63869,127165,0.4677230369991743,0.5022529784138717,0.030023984586953958
2020,OREGON,JEFFERSON,4393,331,7189,11913,0.368756820280366,0.6034584067825065,0.027784772937127507
2020,OREGON,JOSEPHINE,18451,1439,31751,51641,0.35729362328382486,0.614840920973645,0.02786545574253016
2020,OREGON,KLAMATH,10388,1030,25308,36726,0.2828513859391167,0.6891030877307629,0.028045526330120352
2020,OREGON,LAKE,792,101,3470,4363,0.18152647261058905,0.7953243181297273,0.023149209259683706
2020,OREGON,LANE,134366,7551,80336,222253,0.6045632679873838,0.36146193752165323,0.033974794490963
2020,OREGON,LINCOLN,17385,881,12460,30726,0.5658074594805702,0.4055197552561349,0.02867278526329493
2020,OREGON,LINN,26512,2642,43486,72640,0.36497797356828193,0.5986508810572687,0.03637114537444934
2020,OREGON,MALHEUR,3260,357,8187,11804,0.2761775669264656,0.6935784479837344,0.030243985089800068
2020,OREGON,MARION,80872,5660,79002,165534,0.4885522007563401,0.47725542788792635,0.03419237135573357
2020,OREGON,MORROW,1371,161,3586,5118,0.26787807737397423,0.7006643220007815,0.031457600625244234
2020,OREGON,MULTNOMAH,367249,13415,82995,463659,0.7920670147673182,0.17900008411354035,0.028932901119141437
2020,OREGON,POLK,22917,1642,23732,48291,0.47456047710753557,0.49143732786647615,0.03400219502598828
2020,OREGON,SHERMAN,260,27,921,1208,0.2152317880794702,0.7624172185430463,0.022350993377483443
2020,OREGON,TILLAMOOK,8066,468,8354,16888,0.4776172430127901,0.49467077214590244,0.02771198484130744
2020,OREGON,UMATILLA,10707,1061,21270,33038,0.32408136085719474,0.643804104364671,0.03211453477813427
2020,OREGON,UNION,4254,392,10298,14944,0.2846627408993576,0.6891059957173448,0.026231263383297645
2020,OREGON,WALLOWA,1625,120,3404,5149,0.31559526121577003,0.6610992425713731,0.023305496212856866
2020,OREGON,WASCO,6604,491,7035,14130,0.46737438075017695,0.4978768577494692,0.03474876150035386
2020,OREGON,WASHINGTON,209940,11313,99073,320326,0.6553948165306593,0.30928803781147957,0.03531714565786105
2020,OREGON,WHEELER,217,37,711,965,0.22487046632124352,0.7367875647668394,0.0383419689119171
2020,OREGON,YAMHILL,27174,2198,29551,58923,0.4611781477521511,0.5015189314868558,0.03730292076099316
2020,PENNSYLVANIA,ADAMS,18207,810,37523,56540,0.32201980898478955,0.6636540502299257,0.014326140785284755
2020,PENNSYLVANIA,ALLEGHENY,429065,8344,282324,719733,0.5961446814304749,0.3922621305400753,0.01159318802944981
2020,PENNSYLVANIA,ARMSTRONG,8457,424,27489,36370,0.2325268078086335,0.7558152323343414,0.011657959857025021
2020,PENNSYLVANIA,BEAVER,38122,1241,54759,94122,0.4050275174773167,0.581787467329636,0.01318501519304732
2020,PENNSYLVANIA,BEDFORD,4367,182,23025,27574,0.15837383041996084,0.8350257488938856,0.006600420686153623
2020,PENNSYLVANIA,BERKS,92895,2909,109736,205540,0.4519558236839545,0.5338912133891214,0.0141529629269242
2020,PENNSYLVANIA,BLAIR,17636,653,45306,63595,0.27731739916660114,0.7124144979951254,0.010268102838273448
2020,PENNSYLVANIA,BRADFORD,8046,513,21600,30159,0.26678603401969564,0.7162041181736795,0.017009847806624886
2020,PENNSYLVANIA,BUCKS,204712,4155,187367,396234,0.5166442051918816,0.47286956697305127,0.010486227835067157
2020,PENNSYLVANIA,BUTLER,37508,1438,74359,113305,0.33103570010149597,0.6562728917523498,0.012691408146154185
2020,PENNSYLVANIA,CAMBRIA,21730,759,48085,70574,0.3079037605917193,0.681341570550061,0.01075466885821974
2020,PENNSYLVANIA,CAMERON,634,29,1771,2434,0.26047658175842237,0.727608874281019,0.01191454396055875
2020,PENNSYLVANIA,CARBON,11212,433,21984,33629,0.33340271789229536,0.6537214903803265,0.012875791727378155
2020,PENNSYLVANIA,CENTRE,40055,1066,36372,77493,0.5168853961002929,0.4693585227052766,0.013756081194430465
2020,PENNSYLVANIA,CHESTER,182372,3565,128565,314502,0.5798754856884852,0.4087891332964496,0.011335381015065087
2020,PENNSYLVANIA,CLARION,4678,237,14578,19493,0.23998358385061305,0.7478582055096702,0.012158210639716822
2020,PENNSYLVANIA,CLEARFIELD,9673,546,29203,39422,0.24537060524580184,0.7407792603115012,0.013850134442696971
2020,PENNSYLVANIA,CLINTON,5502,221,11902,17625,0.31217021276595747,0.675290780141844,0.012539007092198582
2020,PENNSYLVANIA,COLUMBIA,10532,541,20098,31171,0.33787815597831317,0.6447659683680343,0.017355875653652434
2020,PENNSYLVANIA,CRAWFORD,12924,521,28559,42004,0.3076849823826302,0.6799114370059994,0.012403580611370346
2020,PENNSYLVANIA,CUMBERLAND,62245,2138,77212,141595,0.4395988558918041,0.5453017408806808,0.015099403227515096
2020,PENNSYLVANIA,DAUPHIN,78983,1977,66408,147368,0.5359576027360078,0.45062700179143367,0.013415395472558492
2020,PENNSYLVANIA,DELAWARE,206423,2976,118532,327931,0.6294708338034526,0.3614540863779271,0.009075079818620381
2020,PENNSYLVANIA,ELK,4522,244,12140,16906,0.26747900153791554,0.7180882526913522,0.014432745770732284
2020,PENNSYLVANIA,ERIE,68286,1928,66869,137083,0.49813616568064606,0.4877993624300606,0.014064471889293348
2020,PENNSYLVANIA,FAYETTE,20444,468,41227,62139,0.329004329004329,0.6634641690403772,0.007531501955293777
2020,PENNSYLVANIA,FOREST,728,36,1882,2646,0.2751322751322751,0.7112622826908541,0.013605442176870748
2020,PENNSYLVANIA,FRANKLIN,22422,1116,57245,80783,0.27755839718752706,0.7086268150477204,0.013814787764752486
2020,PENNSYLVANIA,FULTON,1085,68,6824,7977,0.13601604613263132,0.8554594459069825,0.00852450796038611
2020,PENNSYLVANIA,GREENE,4911,179,12579,17669,0.27794442243477274,0.7119248401154564,0.010130737449770786
2020,PENNSYLVANIA,HUNTINGDON,5445,286,17061,22792,0.2388996138996139,0.7485521235521235,0.012548262548262547
2020,PENNSYLVANIA,INDIANA,12634,475,28089,41198,0.30666537210544204,0.6818049419874751,0.011529685907082868
2020,PENNSYLVANIA,JEFFERSON,4527,337,17960,22824,0.19834384858044163,0.7868909919383106,0.014765159481247809
2020,PENNSYLVANIA,JUNIATA,2253,141,9649,12043,0.1870796313210994,0.8012123225110023,0.011708046167898363
2020,PENNSYLVANIA,LACKAWANNA,61991,1085,52334,115410,0.5371371631574386,0.4534615717875401,0.009401265055021228
2020,PENNSYLVANIA,LANCASTER,115847,4183,160209,280239,0.41338643086793775,0.5716870242899811,0.014926544842081224
2020,PENNSYLVANIA,LAWRENCE,15978,501,29597,46076,0.346774893653963,0.6423517666464102,0.010873339699626703
2020,PENNSYLVANIA,LEBANON,23932,989,46731,71652,0.3340032378719366,0.6521939373639256,0.013802824764137777
2020,PENNSYLVANIA,LEHIGH,98288,2166,84259,184713,0.5321119791243714,0.45616172115660514,0.011726299719023565
2020,PENNSYLVANIA,LUZERNE,64873,1519,86929,153321,0.42311881607868457,0.5669738652891646,0.009907318632150847
2020,PENNSYLVANIA,LYCOMING,16971,821,41462,59254,0.2864110439801532,0.699733351334931,0.013855604684915786
2020,PENNSYLVANIA,MCKEAN,5098,285,14083,19466,0.2618925305661153,0.7234665570738724,0.01464091236001233
2020,PENNSYLVANIA,MERCER,21067,744,36143,57954,0.36351244090140455,0.6236497912137212,0.01283776788487421
2020,PENNSYLVANIA,MIFFLIN,4603,229,16670,21502,0.21407310947818808,0.7752767184447958,0.01065017207701609
2020,PENNSYLVANIA,MONROE,44060,1043,38726,83829,0.5255937682663517,0.4619642367199895,0.012441995013658757
2020,PENNSYLVANIA,MONTGOMERY,319511,5186,185460,510157,0.6262993549044706,0.3635351470233673,0.0101654980721621
2020,PENNSYLVANIA,MONTOUR,3771,156,5844,9771,0.38593797973595334,0.5980964077371814,0.01596561252686521
2020,PENNSYLVANIA,NORTHAMPTON,85087,2001,83854,170942,0.4977536240362228,0.490540651215032,0.011705724748745188
2020,PENNSYLVANIA,NORTHUMBERLAND,12677,654,28952,42283,0.299813163682804,0.6847196272733723,0.01546720904382376
2020,PENNSYLVANIA,PERRY,5950,409,18293,24652,0.24135972740548434,0.7420493266266429,0.016590945967872788
2020,PENNSYLVANIA,PHILADELPHIA,603790,4847,132740,741377,0.814416956555167,0.17904520911762842,0.006537834327204647
2020,PENNSYLVANIA,PIKE,13019,322,19213,32554,0.3999201327025865,0.5901886096946611,0.00989125760275235
2020,PENNSYLVANIA,POTTER,1726,99,7239,9064,0.19042365401588704,0.7986540158870256,0.010922330097087379
2020,PENNSYLVANIA,SCHUYLKILL,20727,1005,48871,70603,0.2935710947126893,0.6921943826749571,0.014234522612353582
2020,PENNSYLVANIA,SNYDER,4910,247,13983,19140,0.25653082549634276,0.730564263322884,0.01290491118077325
2020,PENNSYLVANIA,SOMERSET,8654,423,31466,40543,0.21345238388871074,0.7761142490688898,0.010433367042399428
2020,PENNSYLVANIA,SULLIVAN,921,55,2619,3595,0.25618915159944367,0.7285118219749652,0.015299026425591099
2020,PENNSYLVANIA,SUSQUEHANNA,6236,309,15207,21752,0.286686281721221,0.699108127988231,0.014205590290547996
2020,PENNSYLVANIA,TIOGA,4955,378,15742,21075,0.2351126927639383,0.7469513641755635,0.01793594306049822
2020,PENNSYLVANIA,UNION,7475,284,12356,20115,0.37161322396221724,0.6142679592344021,0.014118816803380561
2020,PENNSYLVANIA,VENANGO,7585,374,18569,26528,0.2859243063932449,0.6999773823884198,0.014098311218335343
2020,PENNSYLVANIA,WARREN,6066,347,14237,20650,0.2937530266343826,0.6894430992736077,0.016803874092009684
2020,PENNSYLVANIA,WASHINGTON,45088,1310,72080,118478,0.38056010398555007,0.6083829909350259,0.011056905079424029
2020,PENNSYLVANIA,WAYNE,9191,261,18637,28089,0.32720993983409874,0.6634981665420627,0.009291893623838513
2020,PENNSYLVANIA,WESTMORELAND,72129,2350,130218,204697,0.352369599945285,0.6361500168541796,0.011480383200535425
2020,PENNSYLVANIA,WYOMING,4704,218,9936,14858,0.3165971193969579,0.6687306501547987,0.014672230448243371
2020,PENNSYLVANIA,YORK,88114,3624,146733,238471,0.36949566194631633,0.6153075216693015,0.015196816384382169
2020,RHODE ISLAND,BRISTOL,18050,620,9745,28415,0.6352278726024987,0.34295266584550416,0.021819461551997186
2020,RHODE ISLAND,FEDERAL PRECINCT,1276,13,85,1374,0.9286754002911208,0.06186317321688501,0.009461426491994178
2020,RHODE ISLAND,KENT,49113,1979,42001,93093,0.5275692049885599,0.45117248343054794,0.021258311580892225
2020,RHODE ISLAND,NEWPORT,29486,940,15722,46148,0.638944266273728,0.3406864869550143,0.020369246771257694
2020,RHODE ISLAND,PROVIDENCE,165012,5104,102551,272667,0.6051777442814862,0.37610345219626873,0.018718803522245083
2020,RHODE ISLAND,WASHINGTON,44549,1693,29818,76060,0.5857086510649487,0.3920326058374967,0.022258743097554563
2020,SOUTH DAKOTA,AURORA,317,36,1052,1405,0.22562277580071174,0.7487544483985765,0.025622775800711744
2020,SOUTH DAKOTA,BEADLE,2107,166,4808,7081,0.29755684225391893,0.6790001412229911,0.023443016523089957
2020,SOUTH DAKOTA,BENNETT,466,23,694,1183,0.39391377852916315,0.5866441251056635,0.01944209636517329
2020,SOUTH DAKOTA,BON HOMME,721,45,2235,3001,0.24025324891702765,0.7447517494168611,0.014995001666111295
2020,SOUTH DAKOTA,BROOKINGS,6110,457,8000,14567,0.41944120271847324,0.5491865174709961,0.03137227981053065
2020,SOUTH DAKOTA,BROWN,6538,429,10580,17547,0.37259930472445435,0.6029520715791873,0.024448623696358352
2020,SOUTH DAKOTA,BRULE,673,67,1750,2490,0.27028112449799196,0.7028112449799196,0.026907630522088354
2020,SOUTH DAKOTA,BUFFALO,352,14,183,549,0.6411657559198543,0.3333333333333333,0.025500910746812388
2020,SOUTH DAKOTA,BUTTE,939,132,3731,4802,0.19554352353186172,0.7769679300291545,0.027488546438983758
2020,SOUTH DAKOTA,CAMPBELL,117,9,747,873,0.13402061855670103,0.8556701030927835,0.010309278350515464
2020,SOUTH DAKOTA,CHARLES MIX,1177,54,2552,3783,0.3111287338091462,0.6745968807824478,0.014274385408406027
2020,SOUTH DAKOTA,CLARK,437,40,1373,1850,0.23621621621621622,0.7421621621621621,0.021621621621621623
2020,SOUTH DAKOTA,CLAY,3083,159,2456,5698,0.5410670410670411,0.431028431028431,0.027904527904527906
2020,SOUTH DAKOTA,CODINGTON,3837,366,8958,13161,0.29154319580578986,0.6806473672213358,0.027809436972874402
2020,SOUTH DAKOTA,CORSON,622,14,647,1283,0.4848012470771629,0.5042868277474669,0.010911925175370226
2020,SOUTH DAKOTA,CUSTER,1522,120,3852,5494,0.27702948671277755,0.7011285038223517,0.02184200946487077
2020,SOUTH DAKOTA,DAVISON,2648,193,5613,8454,0.3132245091081145,0.6639460610361959,0.022829429855689615
2020,SOUTH DAKOTA,DAY,1052,43,1869,2964,0.3549257759784076,0.6305668016194332,0.014507422402159244
2020,SOUTH DAKOTA,DEUEL,609,42,1699,2350,0.2591489361702128,0.7229787234042553,0.017872340425531916
2020,SOUTH DAKOTA,DEWEY,1131,45,790,1966,0.5752797558494405,0.40183112919633773,0.02288911495422177
2020,SOUTH DAKOTA,DOUGLAS,216,23,1468,1707,0.1265377855887522,0.8599882835383714,0.013473930872876391
2020,SOUTH DAKOTA,EDMUNDS,417,30,1538,1985,0.21007556675062972,0.7748110831234257,0.015113350125944584
2020,SOUTH DAKOTA,FALL RIVER,1053,111,2878,4042,0.26051459673428995,0.7120237506185056,0.027461652647204356
2020,SOUTH DAKOTA,FAULK,198,20,964,1182,0.16751269035532995,0.8155668358714044,0.01692047377326565
2020,SOUTH DAKOTA,GRANT,1056,71,2618,3745,0.28197596795727636,0.6990654205607477,0.018958611481975966
2020,SOUTH DAKOTA,GREGORY,455,32,1771,2258,0.20150575730735165,0.7843224092116917,0.0141718334809566
2020,SOUTH DAKOTA,HAAKON,105,6,1026,1137,0.09234828496042216,0.9023746701846965,0.005277044854881266
2020,SOUTH DAKOTA,HAMLIN,647,64,2372,3083,0.20986052546221212,0.7693804735647097,0.02075900097307817
2020,SOUTH DAKOTA,HAND,373,30,1433,1836,0.20315904139433552,0.7805010893246187,0.016339869281045753
2020,SOUTH DAKOTA,HANSON,557,38,1793,2388,0.233249581239531,0.7508375209380235,0.015912897822445562
2020,SOUTH DAKOTA,HARDING,49,16,748,813,0.06027060270602706,0.9200492004920049,0.01968019680196802
2020,SOUTH DAKOTA,HUGHES,2953,248,5522,8723,0.3385303221368795,0.6330390920554855,0.028430585807634988
2020,SOUTH DAKOTA,HUTCHINSON,762,61,2944,3767,0.20228298380674276,0.7815237589593841,0.016193257233873107
2020,SOUTH DAKOTA,HYDE,136,10,564,710,0.19154929577464788,0.7943661971830986,0.014084507042253521
2020,SOUTH DAKOTA,JACKSON,359,18,738,1115,0.3219730941704036,0.6618834080717488,0.016143497757847534
2020,SOUTH DAKOTA,JERAULD,270,15,721,1006,0.268389662027833,0.7166998011928429,0.014910536779324055
2020,SOUTH DAKOTA,JONES,90,11,498,599,0.15025041736227046,0.8313856427378965,0.018363939899833055
2020,SOUTH DAKOTA,KINGSBURY,819,56,1904,2779,0.2947103274559194,0.6851385390428212,0.020151133501259445
2020,SOUTH DAKOTA,LAKE,2068,124,3681,5873,0.3521198705942449,0.6267665588285374,0.021113570577217775
2020,SOUTH DAKOTA,LAWRENCE,4537,538,8753,13828,0.32810240092565807,0.6329910326873012,0.038906566387040785
2020,SOUTH DAKOTA,LINCOLN,11981,798,19617,32396,0.36982960859365355,0.60553772070626,0.024632670700086432
2020,SOUTH DAKOTA,LYMAN,525,30,1042,1597,0.3287413901064496,0.6524733876017533,0.01878522229179712
2020,SOUTH DAKOTA,MARSHALL,858,33,1287,2178,0.3939393939393939,0.5909090909090909,0.015151515151515152
2020,SOUTH DAKOTA,MCCOOK,769,63,2068,2900,0.26517241379310347,0.713103448275862,0.021724137931034483
2020,SOUTH DAKOTA,MCPHERSON,222,27,1075,1324,0.16767371601208458,0.8119335347432024,0.02039274924471299
2020,SOUTH DAKOTA,MEADE,3285,510,9875,13670,0.2403072421360644,0.7223847841989759,0.03730797366495977
2020,SOUTH DAKOTA,MELLETTE,298,22,449,769,0.38751625487646296,0.5838751625487646,0.02860858257477243
2020,SOUTH DAKOTA,MINER,320,31,787,1138,0.281195079086116,0.6915641476274165,0.027240773286467488
2020,SOUTH DAKOTA,MINNEHAHA,40482,2595,49249,92326,0.43846803717262745,0.5334250373675887,0.02810692545978381
2020,SOUTH DAKOTA,MOODY,1179,76,1951,3206,0.367747972551466,0.6085464753587024,0.023705552089831567
2020,SOUTH DAKOTA,OGLALA LAKOTA,2829,74,297,3200,0.8840625,0.0928125,0.023125
2020,SOUTH DAKOTA,PENNINGTON,20606,1849,35063,57518,0.35825306860461076,0.6096004728954414,0.03214645849994784
2020,SOUTH DAKOTA,PERKINS,239,29,1401,1669,0.1431995206710605,0.8394248052726183,0.01737567405632115
2020,SOUTH DAKOTA,POTTER,227,14,1139,1380,0.1644927536231884,0.8253623188405798,0.010144927536231883
2020,SOUTH DAKOTA,ROBERTS,1828,75,2404,4307,0.424425354074762,0.5581611330392384,0.017413512885999537
2020,SOUTH DAKOTA,SANBORN,257,23,905,1185,0.2168776371308017,0.7637130801687764,0.019409282700421943
2020,SOUTH DAKOTA,SPINK,998,61,2104,3163,0.31552323743281696,0.6651912741068606,0.019285488460322478
2020,SOUTH DAKOTA,STANLEY,421,28,1203,1652,0.25484261501210653,0.7282082324455206,0.01694915254237288
2020,SOUTH DAKOTA,SULLY,185,19,726,930,0.1989247311827957,0.7806451612903226,0.02043010752688172
2020,SOUTH DAKOTA,TODD,1963,44,532,2539,0.773139031114612,0.20953131153997637,0.01732965734541158
2020,SOUTH DAKOTA,TRIPP,495,40,2161,2696,0.1836053412462908,0.8015578635014837,0.01483679525222552
2020,SOUTH DAKOTA,TURNER,1139,119,3290,4548,0.2504397537379068,0.7233948988566403,0.026165347405452948
2020,SOUTH DAKOTA,UNION,2725,186,5944,8855,0.30773574251835123,0.6712591756070017,0.021005081874647093
2020,SOUTH DAKOTA,WALWORTH,565,49,1966,2580,0.2189922480620155,0.762015503875969,0.018992248062015504
2020,SOUTH DAKOTA,YANKTON,4016,303,6581,10900,0.36844036697247706,0.6037614678899083,0.02779816513761468
2020,SOUTH DAKOTA,ZIEBACH,481,21,404,906,0.5309050772626932,0.445916114790287,0.023178807947019868
2020,TENNESSEE,ANDERSON,11741,645,23184,35570,0.3300815293786899,0.6517852122575204,0.01813325836378971
2020,TENNESSEE,BEDFORD,4453,281,14354,19088,0.23328792958927075,0.7519907795473596,0.014721290863369657
2020,TENNESSEE,BENTON,1529,63,5668,7260,0.2106060606060606,0.7807162534435261,0.008677685950413223
2020,TENNESSEE,BLEDSOE,971,62,4725,5758,0.1686349426884335,0.8205974296630775,0.01076762764848906
2020,TENNESSEE,BLOUNT,17932,1308,47369,66609,0.269212869131799,0.7111501448753171,0.019636985992883844
2020,TENNESSEE,BRADLEY,9851,810,35204,45865,0.21478251389948763,0.7675569606453723,0.017660525455140085
2020,TENNESSEE,CAMPBELL,2441,161,12331,14933,0.16346347016674478,0.8257550391749816,0.010781490658273623
2020,TENNESSEE,CANNON,1261,106,5190,6557,0.1923135580295867,0.7915205124294646,0.016165929540948604
2020,TENNESSEE,CARROLL,2559,141,9205,11905,0.21495170096598068,0.7732045359092818,0.011843763124737505
2020,TENNESSEE,CARTER,4529,379,19584,24492,0.1849175240894986,0.7996080352768251,0.015474440633676303
2020,TENNESSEE,CHEATHAM,5514,308,14438,20260,0.2721618953603159,0.7126357354392893,0.015202369200394866
2020,TENNESSEE,CHESTER,1412,220,5952,7584,0.18618143459915612,0.7848101265822784,0.0290084388185654
2020,TENNESSEE,CLAIBORNE,2202,139,10604,12945,0.17010428736964078,0.8191579760525299,0.010737736577829277
2020,TENNESSEE,CLAY,735,38,2733,3506,0.2096406160867085,0.7795208214489446,0.010838562464346835
2020,TENNESSEE,COCKE,2533,164,12162,14859,0.170469075980887,0.8184938421158894,0.011037081903223635
2020,TENNESSEE,COFFEE,5705,694,17883,24282,0.23494769788320566,0.7364714603409933,0.028580841775801006
2020,TENNESSEE,CROCKETT,1382,59,4673,6114,0.2260385999345764,0.764311416421328,0.009649983644095519
2020,TENNESSEE,CUMBERLAND,6728,383,25168,32279,0.2084327271600731,0.779701973419251,0.011865299420675981
2020,TENNESSEE,DAVIDSON,199703,9737,100218,309658,0.6449147123600876,0.32364091998269057,0.03144436765722184
2020,TENNESSEE,DECATUR,904,108,4229,5241,0.17248616676206832,0.8069070788017554,0.0206067544361763
2020,TENNESSEE,DEKALB,1750,91,6672,8513,0.20556795489251733,0.7837425114530717,0.010689533654410902
2020,TENNESSEE,DICKSON,6106,574,17643,24323,0.25103811207499077,0.7253628253093779,0.023599062615631296
2020,TENNESSEE,DYER,3158,153,11768,15079,0.20943033357649712,0.7804231049804363,0.010146561443066516
2020,TENNESSEE,FAYETTE,7027,267,15690,22984,0.3057344239470936,0.6826487991646363,0.0116167768882701
2020,TENNESSEE,FENTRESS,1214,74,7441,8729,0.13907664108145262,0.8524458700882117,0.008477488830335663
2020,TENNESSEE,FRANKLIN,4864,281,13987,19132,0.2542337445118127,0.7310788208237508,0.014687434664436547
2020,TENNESSEE,GIBSON,5771,305,16259,22335,0.2583837027087531,0.7279605999552272,0.0136556973360197
2020,TENNESSEE,GILES,3298,121,9784,13203,0.24979171400439293,0.7410437021888965,0.009164583806710596
2020,TENNESSEE,GRAINGER,1467,102,8565,10134,0.1447602131438721,0.8451746595618709,0.010065127294256957
2020,TENNESSEE,GREENE,5199,629,22259,28087,0.18510342863246343,0.7925018691921529,0.02239470217538363
2020,TENNESSEE,GRUNDY,988,65,4802,5855,0.16874466268146884,0.8201537147736977,0.011101622544833475
2020,TENNESSEE,HAMBLEN,5500,320,18811,24631,0.22329584669725144,0.763712394949454,0.012991758353294629
2020,TENNESSEE,HAMILTON,75522,3483,92108,171113,0.44135746553447136,0.5382875643580558,0.02035497010747284
2020,TENNESSEE,HANCOCK,362,10,2372,2744,0.13192419825072887,0.8644314868804664,0.0036443148688046646
2020,TENNESSEE,HARDEMAN,4180,123,5760,10063,0.41538308655470535,0.5723939183146179,0.012222995130676737
2020,TENNESSEE,HARDIN,1775,204,9559,11538,0.15383948691280985,0.828479805858901,0.01768070722828913
2020,TENNESSEE,HAWKINS,4083,336,20405,24824,0.16447792458910732,0.8219867869803416,0.01353528843055108
2020,TENNESSEE,HAYWOOD,4012,84,3343,7439,0.5393198010485281,0.44938835865035626,0.011291840301115741
2020,TENNESSEE,HENDERSON,2092,131,9797,12020,0.1740432612312812,0.8150582362728785,0.010898502495840266
2020,TENNESSEE,HENRY,3548,260,11239,15047,0.23579451053366118,0.7469262976008507,0.01727919186548814
2020,TENNESSEE,HICKMAN,2130,125,7577,9832,0.21663954434499594,0.7706468673718471,0.012713588283157039
2020,TENNESSEE,HOUSTON,871,97,2718,3686,0.23629951166576235,0.7373846988605535,0.02631578947368421
2020,TENNESSEE,HUMPHREYS,2017,99,6120,8236,0.24490043710539097,0.7430791646430306,0.012020398251578437
2020,TENNESSEE,JACKSON,1135,70,4118,5323,0.21322562464775502,0.7736238962990795,0.013150479053165508
2020,TENNESSEE,JEFFERSON,4654,311,18651,23616,0.19706978319783197,0.7897611788617886,0.013169037940379404
2020,TENNESSEE,JOHNSON,1246,87,6468,7801,0.15972311242148443,0.8291244712216382,0.011152416356877323
2020,TENNESSEE,KNOX,91422,4594,124540,220556,0.41450697328569613,0.56466384954388,0.02082917717042384
2020,TENNESSEE,LAKE,526,16,1492,2034,0.2586037364798427,0.7335299901671584,0.007866273352999017
2020,TENNESSEE,LAUDERDALE,3193,98,5674,8965,0.3561628555493586,0.6329057445621863,0.010931399888455103
2020,TENNESSEE,LAWRENCE,3195,189,15334,18718,0.17069131317448447,0.8192114542151939,0.010097232610321616
2020,TENNESSEE,LEWIS,1072,63,4474,5609,0.1911214120164022,0.7976466393296487,0.01123194865394901
2020,TENNESSEE,LINCOLN,2919,408,12281,15608,0.187019477191184,0.7868400820092261,0.026140440799589954
2020,TENNESSEE,LOUDON,6948,686,21713,29347,0.23675333083449757,0.7398711963744165,0.023375472791085972
2020,TENNESSEE,MACON,1307,84,8096,9487,0.13776747127648362,0.8533783071571625,0.008854221566353957
2020,TENNESSEE,MADISON,18390,617,23943,42950,0.4281722933643772,0.5574621653084982,0.014365541327124563
2020,TENNESSEE,MARION,3177,168,9911,13256,0.23966505733252866,0.7476614363307181,0.012673506336753168
2020,TENNESSEE,MARSHALL,3605,230,11043,14878,0.24230407312810862,0.7422368597929829,0.015459067078908456
2020,TENNESSEE,MAURY,14418,775,31464,46657,0.30902115438197914,0.674368261997128,0.016610583620892898
2020,TENNESSEE,MCMINN,4361,285,18198,22844,0.19090351952372614,0.7966205568201716,0.01247592365610226
2020,TENNESSEE,MCNAIRY,1943,239,9093,11275,0.17232815964523282,0.8064745011086475,0.021197339246119735
2020,TENNESSEE,MEIGS,1008,57,4467,5532,0.1822125813449024,0.8074837310195228,0.010303687635574838
2020,TENNESSEE,MONROE,3764,250,16783,20797,0.18098764244843007,0.8069913929893735,0.01202096456219647
2020,TENNESSEE,MONTGOMERY,32472,2099,42187,76758,0.4230438521066208,0.5496104640558639,0.027345683837515306
2020,TENNESSEE,MOORE,573,78,2888,3539,0.16191014410850524,0.8160497315625883,0.02204012432890647
2020,TENNESSEE,MORGAN,1167,131,6930,8228,0.14183276616431698,0.8422459893048129,0.0159212445308702
2020,TENNESSEE,OBION,2589,142,10790,13521,0.19147992012425116,0.7980178980844612,0.010502181791287627
2020,TENNESSEE,OVERTON,2033,86,7918,10037,0.20255056291720633,0.7888811397828036,0.008568297299990037
2020,TENNESSEE,PERRY,615,38,2775,3428,0.1794049008168028,0.80950991831972,0.011085180863477246
2020,TENNESSEE,PICKETT,525,25,2381,2931,0.17911975435005117,0.8123507335380417,0.008529512111907198
2020,TENNESSEE,POLK,1492,76,6792,8360,0.1784688995215311,0.8124401913875599,0.00909090909090909
2020,TENNESSEE,PUTNAM,9185,649,23759,33593,0.2734200577501265,0.7072604411633376,0.019319501086535885
2020,TENNESSEE,RHEA,2369,218,11050,13637,0.17371855980054265,0.8102955195424214,0.015985920657036006
2020,TENNESSEE,ROANE,6043,644,19230,25917,0.23316741906856503,0.741984025928927,0.024848555002508006
2020,TENNESSEE,ROBERTSON,8692,489,24536,33717,0.25779280481656136,0.7277041255153187,0.01450306966811994
2020,TENNESSEE,RUTHERFORD,59341,3057,81480,143878,0.4124397058619108,0.5663131263987545,0.021247167739334716
2020,TENNESSEE,SCOTT,986,62,8004,9052,0.10892620415377817,0.8842244807777286,0.00684931506849315
2020,TENNESSEE,SEQUATCHIE,1298,99,5855,7252,0.17898510755653613,0.8073634859349145,0.013651406508549365
2020,TENNESSEE,SEVIER,8721,1031,33783,43535,0.20032158033765934,0.775996324796141,0.02368209486619961
2020,TENNESSEE,SHELBY,246105,6135,129815,382055,0.6441611809817959,0.3397809215950583,0.01605789742314588
2020,TENNESSEE,SMITH,1802,113,7136,9051,0.19909402275991603,0.7884211689316097,0.012484808308474201
2020,TENNESSEE,STEWART,1232,114,4950,6296,0.19567979669631513,0.7862134688691232,0.018106734434561626
2020,TENNESSEE,SULLIVAN,17272,1225,55860,74357,0.23228478825127427,0.751240636389311,0.016474575359414715
2020,TENNESSEE,SUMNER,27680,1496,63454,92630,0.2988232753967397,0.685026449314477,0.016150275288783333
2020,TENNESSEE,TIPTON,6837,401,20070,27308,0.25036619305697966,0.7349494653581368,0.014684341584883551
2020,TENNESSEE,TROUSDALE,1012,50,2936,3998,0.2531265632816408,0.7343671835917959,0.01250625312656328
2020,TENNESSEE,UNICOI,1615,93,6599,8307,0.19441434934392682,0.7943902732635127,0.01119537739256049
2020,TENNESSEE,UNION,1249,71,6803,8123,0.15376092576634248,0.8374984611596701,0.008740613073987442
2020,TENNESSEE,VAN BUREN,544,35,2342,2921,0.1862375898664841,0.8017802122560767,0.011982197877439232
2020,TENNESSEE,WARREN,3924,235,11850,16009,0.24511212443000813,0.7402086326441377,0.014679242925854208
2020,TENNESSEE,WASHINGTON,18638,1121,40444,60203,0.30958590103483213,0.671793764430344,0.018620334534823847
2020,TENNESSEE,WAYNE,820,54,5795,6669,0.12295696506222822,0.8689458689458689,0.008097165991902834
2020,TENNESSEE,WEAKLEY,3020,319,10396,13735,0.2198762286130324,0.7568984346559884,0.02322533673097925
2020,TENNESSEE,WHITE,2143,146,9606,11895,0.1801597309794031,0.8075662042875158,0.012274064733081127
2020,TENNESSEE,WILLIAMSON,50161,2386,86469,139016,0.36082896932727165,0.6220075387005812,0.01716349197214709
2020,TENNESSEE,WILSON,22254,1780,50296,74330,0.2993945916857258,0.6766581461052065,0.02394726220906767
2020,TEXAS,ANDERSON,3955,162,15110,19227,0.20570031726218338,0.7858740313101368,0.008425651427679825
2020,TEXAS,ANDREWS,850,70,4943,5863,0.14497697424526693,0.8430837455227699,0.011939280231963159
2020,TEXAS,ANGELINA,9143,355,25076,34574,0.26444727251692024,0.7252848961647481,0.010267831318331694
2020,TEXAS,ARANSAS,2916,135,9239,12290,0.2372660699755899,0.7517493897477624,0.010984540276647681
2020,TEXAS,ARCHER,446,50,4300,4796,0.09299416180150125,0.896580483736447,0.010425354462051709
2020,TEXAS,ARMSTRONG,75,2,1035,1112,0.06744604316546762,0.9307553956834532,0.0017985611510791368
2020,TEXAS,ATASCOSA,5876,203,12039,18118,0.3243183574345954,0.6644773153769732,0.011204327188431394
2020,TEXAS,AUSTIN,2951,156,11447,14554,0.20276212725024048,0.7865191699876323,0.01071870276212725
2020,TEXAS,BAILEY,409,17,1434,1860,0.21989247311827956,0.7709677419354839,0.00913978494623656
2020,TEXAS,BANDERA,2505,153,10057,12715,0.19701140385371607,0.7909555642941408,0.012033031852143139
2020,TEXAS,BASTROP,15474,675,20516,36665,0.4220373653347879,0.5595527069412246,0.018409927723987453
2020,TEXAS,BAYLOR,183,25,1494,1702,0.10752056404230317,0.8777908343125734,0.014688601645123384
2020,TEXAS,BEE,3288,126,6006,9420,0.3490445859872611,0.6375796178343949,0.01337579617834395
2020,TEXAS,BELL,57014,2468,67893,127375,0.4476074582924436,0.5330166830225711,0.01937585868498528
2020,TEXAS,BEXAR,448452,13748,308618,770818,0.5817871404144688,0.4003772615585002,0.017835598027031024
2020,TEXAS,BLANCO,1911,87,5443,7441,0.2568203198494826,0.7314877032656901,0.011691976884827308
2020,TEXAS,BORDEN,16,3,397,416,0.038461538461538464,0.9543269230769231,0.007211538461538462
2020,TEXAS,BOSQUE,1561,96,7469,9126,0.1710497479728249,0.8184308568923954,0.01051939513477975
2020,TEXAS,BOWIE,10747,398,27116,38261,0.2808865424322417,0.7087112203026581,0.010402237265100233
2020,TEXAS,BRAZORIA,62228,2323,90433,154984,0.40151241418469,0.5834989418262531,0.014988643989056935
2020,TEXAS,BRAZOS,35349,2182,47530,85061,0.41557235395774794,0.5587754670177872,0.025652179024464795
2020,TEXAS,BREWSTER,2258,103,2461,4822,0.4682704272086271,0.5103691414350892,0.0213604313562837
2020,TEXAS,BRISCOE,78,8,639,725,0.10758620689655173,0.8813793103448276,0.011034482758620689
2020,TEXAS,BROOKS,1470,16,998,2484,0.5917874396135265,0.40177133655394526,0.00644122383252818
2020,TEXAS,BROWN,2107,164,13698,15969,0.13194313983342726,0.8577869622393387,0.010269897927234015
2020,TEXAS,BURLESON,1788,78,6743,8609,0.20768962713439423,0.7832500871181322,0.009060285747473574
2020,TEXAS,BURNET,5639,311,18767,24717,0.22814257393696646,0.7592749929198528,0.012582433143180806
2020,TEXAS,CALDWELL,6672,270,8031,14973,0.44560208375075133,0.5363654578240834,0.018032458425165297
2020,TEXAS,CALHOUN,2148,67,5641,7856,0.27342158859470467,0.7180498981670062,0.008528513238289206
2020,TEXAS,CALLAHAN,734,86,6012,6832,0.10743559718969554,0.879976580796253,0.012587822014051522
2020,TEXAS,CAMERON,64063,1079,49032,114174,0.5610997249811691,0.4294497871669557,0.009450487851875208
2020,TEXAS,CAMP,1394,40,3626,5060,0.2754940711462451,0.716600790513834,0.007905138339920948
2020,TEXAS,CARSON,297,46,2779,3122,0.09513132607303011,0.8901345291479821,0.014734144778987828
2020,TEXAS,CASS,2795,99,11033,13927,0.20068930853737343,0.7922021971709629,0.007108494291663675
2020,TEXAS,CASTRO,466,15,1602,2083,0.22371579452712434,0.7690830532885262,0.007201152184349496
2020,TEXAS,CHAMBERS,3997,302,17353,21652,0.18460188435248476,0.8014502124515056,0.013947903196009607
2020,TEXAS,CHEROKEE,4210,197,15101,19508,0.21580889891326635,0.7740926799261841,0.010098421160549518
2020,TEXAS,CHILDRESS,310,26,1943,2279,0.13602457218078104,0.8525669153137341,0.011408512505484861
2020,TEXAS,CLAY,614,61,5069,5744,0.1068941504178273,0.8824860724233984,0.010619777158774373
2020,TEXAS,COCHRAN,177,14,809,1000,0.177,0.809,0.014
2020,TEXAS,COKE,178,15,1586,1779,0.10005621135469364,0.8915120854412592,0.008431703204047217
2020,TEXAS,COLEMAN,451,32,3641,4124,0.10935984481086324,0.8828806983511154,0.007759456838021339
2020,TEXAS,COLLIN,230945,7593,252318,490856,0.4704944016167674,0.5140367032286455,0.01546889515458709
2020,TEXAS,COLLINGSWORTH,155,15,1048,1218,0.1272577996715928,0.8604269293924466,0.012315270935960592
2020,TEXAS,COLORADO,2420,83,7472,9975,0.24260651629072683,0.7490726817042607,0.00832080200501253
2020,TEXAS,COMAL,24826,1326,62740,88892,0.2792827251046213,0.7058002969896053,0.014916977905773298
2020,TEXAS,COMANCHE,853,56,5177,6086,0.14015773907328294,0.8506408149852119,0.009201445941505093
2020,TEXAS,CONCHO,197,13,1058,1268,0.1553627760252366,0.8343848580441641,0.01025236593059937
2020,TEXAS,COOKE,3210,190,15596,18996,0.1689829437776374,0.8210149505158981,0.01000210570646452
2020,TEXAS,CORYELL,7565,490,15438,23493,0.322010811731154,0.6571319116332525,0.020857276635593582
2020,TEXAS,COTTLE,113,9,540,662,0.17069486404833836,0.8157099697885196,0.013595166163141994
2020,TEXAS,CRANE,241,15,1247,1503,0.1603459747172322,0.8296739853626082,0.00998003992015968
2020,TEXAS,CROCKETT,344,10,1220,1574,0.21855146124523506,0.7750952986022872,0.0063532401524777635
2020,TEXAS,CROSBY,527,30,1396,1953,0.2698412698412698,0.7147977470558116,0.015360983102918587
2020,TEXAS,CULBERSON,438,11,415,864,0.5069444444444444,0.48032407407407407,0.01273148148148148
2020,TEXAS,DALLAM,197,23,1389,1609,0.12243629583592293,0.8632691112492231,0.014294592914853946
2020,TEXAS,DALLAS,598576,13852,307076,919504,0.6509770484957107,0.3339583079573335,0.01506464354695575
2020,TEXAS,DAWSON,808,30,2951,3789,0.21324887833201372,0.7788334652942729,0.00791765637371338
2020,TEXAS,DEAF SMITH,1264,52,3294,4610,0.2741865509761388,0.7145336225596529,0.011279826464208243
2020,TEXAS,DELTA,403,27,2162,2592,0.1554783950617284,0.8341049382716049,0.010416666666666666
2020,TEXAS,DENTON,188695,6789,222480,417964,0.45146232689896737,0.5322946473858993,0.01624302571513336
2020,TEXAS,DEWITT,1494,57,6567,8118,0.18403547671840353,0.8089430894308943,0.007021433850702144
2020,TEXAS,DICKENS,130,5,853,988,0.13157894736842105,0.8633603238866396,0.005060728744939271
2020,TEXAS,DIMMIT,2264,18,1384,3666,0.6175668303327878,0.37752318603382434,0.004909983633387889
2020,TEXAS,DONLEY,198,12,1438,1648,0.12014563106796117,0.8725728155339806,0.007281553398058253
2020,TEXAS,DUVAL,2575,35,2443,5053,0.5095982584603206,0.4834751632693449,0.0069265782703344545
2020,TEXAS,EASTLAND,983,73,7237,8293,0.11853370312311588,0.8726636922705897,0.008802604606294465
2020,TEXAS,ECTOR,11367,527,32697,44591,0.2549169114843803,0.7332645601130273,0.01181852840259245
2020,TEXAS,EDWARDS,168,5,893,1066,0.1575984990619137,0.8377110694183865,0.004690431519699813
2020,TEXAS,EL PASO,178126,4272,84331,266729,0.6678163979169869,0.31616734588289985,0.016016256200113224
2020,TEXAS,ELLIS,27565,1211,56717,85493,0.32242405811002073,0.66341103950031,0.01416490238966933
2020,TEXAS,ERATH,2916,256,13684,16856,0.17299477930707166,0.8118177503559564,0.015187470336971999
2020,TEXAS,FALLS,1899,57,4177,6133,0.3096363932822436,0.681069623349095,0.00929398336866134
2020,TEXAS,FANNIN,2655,181,12171,15007,0.1769174385286866,0.8110215232891317,0.012061038182181648
2020,TEXAS,FAYETTE,2661,109,10171,12941,0.20562553125724442,0.7859516266130901,0.008422842129665405
2020,TEXAS,FISHER,352,26,1448,1826,0.1927710843373494,0.7929901423877328,0.014238773274917854
2020,TEXAS,FLOYD,438,17,1584,2039,0.2148111819519372,0.7768513977439921,0.008337420304070623
2020,TEXAS,FOARD,99,7,445,551,0.17967332123411978,0.8076225045372051,0.012704174228675136
2020,TEXAS,FORT BEND,195552,4244,157718,357514,0.5469771813131793,0.4411519548884799,0.011870863798340764
2020,TEXAS,FRANKLIN,804,44,4161,5009,0.16051108005589937,0.83070473148333,0.008784188460770613
2020,TEXAS,FREESTONE,1635,85,6991,8711,0.18769372058317071,0.8025485018941568,0.009757777522672484
2020,TEXAS,FRIO,2422,34,2823,5279,0.4587990149649555,0.5347603712824398,0.0064406137526046596
2020,TEXAS,GAINES,576,65,5355,5996,0.09606404269513008,0.8930953969312875,0.010840560373582388
2020,TEXAS,GALVESTON,58842,2307,93911,155060,0.3794789113891397,0.6056429769121631,0.014878111698697278
2020,TEXAS,GARZA,231,9,1413,1653,0.1397459165154265,0.8548094373865699,0.0054446460980036296
2020,TEXAS,GILLESPIE,3176,160,12514,15850,0.20037854889589907,0.7895268138801261,0.010094637223974764
2020,TEXAS,GLASSCOCK,39,3,611,653,0.05972434915773354,0.9356814701378254,0.004594180704441042
2020,TEXAS,GOLIAD,877,33,3085,3995,0.2195244055068836,0.772215269086358,0.008260325406758449
2020,TEXAS,GONZALES,1948,73,5627,7648,0.2547071129707113,0.7357479079497908,0.009544979079497909
2020,TEXAS,GRAY,829,113,6840,7782,0.10652788486250321,0.8789514263685428,0.014520688768953996
2020,TEXAS,GRAYSON,14506,805,44163,59474,0.24390489962000203,0.742559774018899,0.013535326361098967
2020,TEXAS,GREGG,14796,693,32493,47982,0.30836563711391773,0.6771914467925472,0.014442916093535076
2020,TEXAS,GRIMES,2833,149,9432,12414,0.22821008538746576,0.7597873368777187,0.01200257773481553
2020,TEXAS,GUADALUPE,28805,1261,47553,77619,0.37110758963655804,0.6126463881266185,0.01624602223682346
2020,TEXAS,HALE,2279,130,7177,9586,0.2377425412059253,0.748696015021907,0.013561443772167744
2020,TEXAS,HALL,168,6,995,1169,0.1437125748502994,0.8511548331907614,0.0051325919589392645
2020,TEXAS,HAMILTON,641,94,3616,4351,0.14732245460813606,0.8310733164789703,0.021604228912893587
2020,TEXAS,HANSFORD,166,32,1849,2047,0.0810942843185149,0.9032730825598436,0.015632633121641426
2020,TEXAS,HARDEMAN,241,9,1330,1580,0.15253164556962026,0.8417721518987342,0.00569620253164557
2020,TEXAS,HARDIN,3474,303,23858,27635,0.12571015017188347,0.8633254930341958,0.010964356793920752
2020,TEXAS,HARRIS,918193,21995,700630,1640818,0.5595946655875301,0.4270004351488099,0.013404899263659955
2020,TEXAS,HARRISON,7908,343,21466,29717,0.266110307231551,0.7223474778746172,0.011542214893831813
2020,TEXAS,HARTLEY,195,15,1868,2078,0.09384023099133783,0.8989412897016362,0.007218479307025986
2020,TEXAS,HASKELL,353,21,1840,2214,0.15943992773261065,0.8310749774164409,0.009485094850948509
2020,TEXAS,HAYS,59524,2191,47680,109395,0.5441199323552265,0.43585172996937704,0.0200283376753965
2020,TEXAS,HEMPHILL,206,28,1486,1720,0.11976744186046512,0.8639534883720931,0.01627906976744186
2020,TEXAS,HENDERSON,7060,346,28911,36317,0.1943993171242118,0.7960734642178594,0.009527218657928794
2020,TEXAS,HIDALGO,128199,2158,90527,220884,0.5803906122670723,0.40983955379294107,0.0097698339399866
2020,TEXAS,HILL,2860,145,11926,14931,0.19154778648449536,0.7987408746902418,0.009711338825262875
2020,TEXAS,HOCKLEY,1482,82,6536,8100,0.18296296296296297,0.8069135802469136,0.010123456790123457
2020,TEXAS,HOOD,5648,397,26496,32541,0.1735656556344304,0.8142343505116623,0.012199993853907378
2020,TEXAS,HOPKINS,3046,176,12719,15941,0.19107960604729943,0.7978796813248855,0.011040712627815068
2020,TEXAS,HOUSTON,2314,64,7060,9438,0.24517906336088155,0.7480398389489299,0.0067810976901886
2020,TEXAS,HOWARD,2069,118,8054,10241,0.20203105165511182,0.7864466360706962,0.011522312274191973
2020,TEXAS,HUDSPETH,371,15,779,1165,0.3184549356223176,0.6686695278969957,0.012875536480686695
2020,TEXAS,HUNT,8906,528,29163,38597,0.2307433220198461,0.7555768583050496,0.013679819675104283
2020,TEXAS,HUTCHINSON,965,127,7681,8773,0.1099965804171891,0.8755271856833466,0.014476233899464265
2020,TEXAS,IRION,120,10,759,889,0.13498312710911137,0.8537682789651294,0.01124859392575928
2020,TEXAS,JACK,331,33,3418,3782,0.08751983077736647,0.9037546271813856,0.008725542041248016
2020,TEXAS,JACKSON,1033,89,5231,6353,0.1626003462930899,0.8233905241618134,0.014009129545096805
2020,TEXAS,JASPER,2954,115,12542,15611,0.189225546089296,0.8034078534366793,0.007366600474024726
2020,TEXAS,JEFF DAVIS,501,20,784,1305,0.3839080459770115,0.6007662835249042,0.01532567049808429
2020,TEXAS,JEFFERSON,46073,1116,47570,94759,0.48621239143511435,0.5020103631317342,0.011777245433151468
2020,TEXAS,JIM HOGG,1197,6,833,2036,0.5879174852652259,0.40913555992141454,0.0029469548133595285
2020,TEXAS,JIM WELLS,6119,97,7453,13669,0.44765527836710806,0.5452483722291316,0.007096349403760333
2020,TEXAS,JOHNSON,16464,928,54628,72020,0.22860316578728132,0.7585115245765065,0.012885309636212164
2020,TEXAS,JONES,999,82,5660,6741,0.14819759679572764,0.8396380358997182,0.012164367304554221
2020,TEXAS,KARNES,1234,50,3968,5252,0.23495811119573495,0.7555217060167555,0.00952018278750952
2020,TEXAS,KAUFMAN,18405,689,37624,56718,0.3245001586797842,0.6633520222856941,0.01214781903452167
2020,TEXAS,KENDALL,6020,349,20083,26452,0.22758203538484803,0.7592242552548012,0.013193709360350823
2020,TEXAS,KENEDY,65,2,127,194,0.33505154639175255,0.654639175257732,0.010309278350515464
2020,TEXAS,KENT,47,4,411,462,0.10173160173160173,0.8896103896103896,0.008658008658008658
2020,TEXAS,KERR,6524,342,20879,27745,0.23514146693097857,0.7525319877455398,0.012326545323481708
2020,TEXAS,KIMBLE,284,21,1987,2292,0.12390924956369982,0.8669284467713787,0.009162303664921465
2020,TEXAS,KING,8,0,151,159,0.050314465408805034,0.949685534591195,0.0
2020,TEXAS,KINNEY,446,13,1144,1603,0.27822832189644414,0.7136618839675608,0.008109794135995009
2020,TEXAS,KLEBERG,5314,126,5504,10944,0.485562865497076,0.5029239766081871,0.011513157894736841
2020,TEXAS,KNOX,265,11,1180,1456,0.1820054945054945,0.8104395604395604,0.007554945054945055
2020,TEXAS,LA SALLE,1052,19,1335,2406,0.4372402327514547,0.5548628428927681,0.007896924355777223
2020,TEXAS,LAMAR,4458,224,16760,21442,0.20790970991511987,0.7816435034045331,0.010446786680346983
2020,TEXAS,LAMB,840,49,3521,4410,0.19047619047619047,0.7984126984126985,0.011111111111111112
2020,TEXAS,LAMPASAS,2144,169,8086,10399,0.20617367054524474,0.7775747668045004,0.016251562650254833
2020,TEXAS,LAVACA,1333,60,8804,10197,0.13072472295773266,0.8633911934882809,0.005884083553986467
2020,TEXAS,LEE,1750,82,6255,8087,0.21639668603932236,0.7734635835291208,0.01013973043155682
2020,TEXAS,LEON,1072,79,7523,8674,0.1235877334563062,0.8673045884251787,0.009107678118515103
2020,TEXAS,LIBERTY,5785,247,23302,29334,0.19721142701302244,0.7943683098111407,0.008420263175836913
2020,TEXAS,LIMESTONE,2213,93,6789,9095,0.2433205057724024,0.7464540956569544,0.01022539857064321
2020,TEXAS,LIPSCOMB,131,17,1205,1353,0.09682187730968218,0.8906134515890614,0.012564671101256468
2020,TEXAS,LIVE OAK,819,36,4199,5054,0.16204986149584488,0.8308270676691729,0.007123070834982192
2020,TEXAS,LLANO,2465,116,10079,12660,0.19470774091627172,0.796129541864139,0.009162717219589257
2020,TEXAS,LOVING,4,2,60,66,0.06060606060606061,0.9090909090909091,0.030303030303030304
2020,TEXAS,LUBBOCK,40017,1939,78861,120817,0.3312199442131488,0.6527309898441445,0.016049065942706737
2020,TEXAS,LYNN,428,12,1853,2293,0.18665503706934147,0.8081116441343218,0.005233318796336677
2020,TEXAS,MADISON,1088,41,4169,5298,0.2053605134012835,0.7869007172517931,0.007738769346923367
2020,TEXAS,MARION,1339,55,3470,4864,0.2752878289473684,0.7134046052631579,0.011307565789473685
2020,TEXAS,MARTIN,288,15,1857,2160,0.13333333333333333,0.8597222222222223,0.006944444444444444
2020,TEXAS,MASON,457,26,1991,2474,0.1847210994341148,0.8047696038803557,0.010509296685529508
2020,TEXAS,MATAGORDA,3733,149,9845,13727,0.27194580024768705,0.7171996794638305,0.010854520288482553
2020,TEXAS,MAVERICK,8332,133,6881,15346,0.5429427863938485,0.44839046005473737,0.008666753551414049
2020,TEXAS,MCCULLOCH,490,42,2904,3436,0.14260768335273574,0.8451688009313155,0.012223515715948778
2020,TEXAS,MCLENNAN,36688,1641,59543,97872,0.3748569560241949,0.6083762465260749,0.01676679744973026
2020,TEXAS,MCMULLEN,53,3,460,516,0.10271317829457365,0.8914728682170543,0.005813953488372093
2020,TEXAS,MEDINA,6773,242,15642,22657,0.29893631107384033,0.6903826631945977,0.01068102573156199
2020,TEXAS,MENARD,197,8,823,1028,0.1916342412451362,0.8005836575875487,0.007782101167315175
2020,TEXAS,MIDLAND,12329,906,45624,58859,0.20946669158497427,0.7751405902240949,0.015392718190930868
2020,TEXAS,MILAM,2496,98,7984,10578,0.23596142938173567,0.7547740593685006,0.00926451124976366
2020,TEXAS,MILLS,271,17,2217,2505,0.10818363273453094,0.8850299401197604,0.006786427145708583
2020,TEXAS,MITCHELL,397,12,2170,2579,0.15393563396665375,0.8414113997673517,0.0046529662659945716
2020,TEXAS,MONTAGUE,1097,107,8615,9819,0.11172217130053977,0.8773805886546492,0.010897240044811081
2020,TEXAS,MONTGOMERY,74377,3784,193382,271543,0.27390505371156687,0.7121597684344653,0.013935177853967879
2020,TEXAS,MOORE,1062,87,4359,5508,0.19281045751633988,0.7913943355119826,0.01579520697167756
2020,TEXAS,MORRIS,1669,46,3872,5587,0.29872919276892784,0.6930374082691964,0.008233398961875783
2020,TEXAS,MOTLEY,46,2,604,652,0.0705521472392638,0.9263803680981595,0.003067484662576687
2020,TEXAS,NACOGDOCHES,9000,407,17378,26785,0.3360089602389397,0.6487959678924772,0.015195071868583163
2020,TEXAS,NAVARRO,5101,222,13800,19123,0.2667468493437222,0.7216440934999738,0.011609057156303927
2020,TEXAS,NEWTON,1173,39,4882,6094,0.19248441089596324,0.8011158516573679,0.006399737446668855
2020,TEXAS,NOLAN,1162,64,4131,5357,0.2169124509986933,0.7711405637483666,0.011946985252940079
2020,TEXAS,NUECES,60925,1780,64617,127322,0.47851117638742713,0.5075085217008843,0.013980301911688475
2020,TEXAS,OCHILTREE,302,42,2812,3156,0.09569074778200254,0.8910012674271229,0.013307984790874524
2020,TEXAS,OLDHAM,81,11,917,1009,0.0802775024777007,0.908820614469772,0.010901883052527254
2020,TEXAS,ORANGE,6357,451,29186,35994,0.17661276879479915,0.8108573651164083,0.012529866088792576
2020,TEXAS,PALO PINTO,2178,132,10179,12489,0.17439346625030028,0.8150372327648331,0.010569300984866683
2020,TEXAS,PANOLA,2057,68,9326,11451,0.17963496637848222,0.8144266876255349,0.005938345995982883
2020,TEXAS,PARKER,13017,1066,62045,76128,0.17098833543505676,0.8150089323245061,0.014002732240437158
2020,TEXAS,PARMER,488,27,2135,2650,0.18415094339622642,0.8056603773584906,0.010188679245283019
2020,TEXAS,PECOS,1382,71,3215,4668,0.29605826906598115,0.6887317909168809,0.015209940017137961
2020,TEXAS,POLK,5387,226,18573,24186,0.22273215910030597,0.7679235921607541,0.009344248738939883
2020,TEXAS,POTTER,9921,596,22820,33337,0.2975972643009269,0.6845247022827489,0.017878033416324206
2020,TEXAS,PRESIDIO,1463,33,721,2217,0.6599007668019846,0.3252142534957149,0.014884979702300407
2020,TEXAS,RAINS,842,56,5155,6053,0.1391045762431852,0.8516438129852966,0.009251610771518256
2020,TEXAS,RANDALL,12802,1076,50796,64674,0.19794662460958035,0.7854160868355134,0.016637288554906145
2020,TEXAS,REAGAN,172,10,942,1124,0.15302491103202848,0.8380782918149466,0.008896797153024912
2020,TEXAS,REAL,320,19,1643,1982,0.16145307769929365,0.8289606458123108,0.00958627648839556
2020,TEXAS,RED RIVER,1246,43,4517,5806,0.21460558043403377,0.7779882879779538,0.007406131588012401
2020,TEXAS,REEVES,1395,40,2254,3689,0.37815126050420167,0.6110056925996205,0.010843046896177827
2020,TEXAS,REFUGIO,1108,48,2210,3366,0.32917409387997626,0.6565656565656566,0.0142602495543672
2020,TEXAS,ROBERTS,17,4,529,550,0.03090909090909091,0.9618181818181818,0.007272727272727273
2020,TEXAS,ROBERTSON,2374,79,5646,8099,0.2931226077293493,0.6971231016174836,0.009754290653167057
2020,TEXAS,ROCKWALL,16412,753,36726,53891,0.304540646861257,0.6814867046445603,0.013972648494182702
2020,TEXAS,RUNNELS,552,50,3807,4409,0.12519845770015878,0.8634611022907689,0.011340440009072352
2020,TEXAS,RUSK,4629,214,16534,21377,0.21654114234925387,0.7734480984235393,0.010010759227206812
2020,TEXAS,SABINE,669,38,4784,5491,0.12183573119650337,0.8712438535785831,0.006920415224913495
2020,TEXAS,SAN AUGUSTINE,980,15,3007,4002,0.2448775612193903,0.7513743128435783,0.0037481259370314842
2020,TEXAS,SAN JACINTO,2337,142,10161,12640,0.18488924050632913,0.803876582278481,0.011234177215189873
2020,TEXAS,SAN PATRICIO,8988,387,16516,25891,0.3471476574871577,0.6379050635355915,0.014947278977250782
2020,TEXAS,SAN SABA,287,7,2308,2602,0.11029976940814758,0.8870099923136049,0.002690238278247502
2020,TEXAS,SCHLEICHER,211,8,940,1159,0.182053494391717,0.811044003451251,0.006902502157031924
2020,TEXAS,SCURRY,818,69,4983,5870,0.1393526405451448,0.848892674616695,0.011754684838160136
2020,TEXAS,SHACKELFORD,130,14,1484,1628,0.07985257985257985,0.9115479115479116,0.0085995085995086
2020,TEXAS,SHELBY,2068,44,7975,10087,0.2050163576881134,0.7906215921483097,0.004362050163576881
2020,TEXAS,SHERMAN,91,15,886,992,0.09173387096774194,0.8931451612903226,0.015120967741935484
2020,TEXAS,SMITH,29615,1394,69080,100089,0.2958866608718241,0.6901857346961204,0.013927604432055471
2020,TEXAS,SOMERVELL,768,74,4105,4947,0.15524560339599758,0.8297958358601173,0.014958560743885184
2020,TEXAS,STARR,9123,155,8247,17525,0.5205706134094151,0.4705848787446505,0.00884450784593438
2020,TEXAS,STEPHENS,397,18,3385,3800,0.10447368421052632,0.8907894736842106,0.004736842105263158
2020,TEXAS,STERLING,51,4,584,639,0.07981220657276995,0.9139280125195618,0.006259780907668232
2020,TEXAS,STONEWALL,116,5,615,736,0.15760869565217392,0.8355978260869565,0.006793478260869565
2020,TEXAS,SUTTON,322,13,1222,1557,0.20680796403339757,0.7848426461143224,0.008349389852280027
2020,TEXAS,SWISHER,478,32,1845,2355,0.2029723991507431,0.7834394904458599,0.013588110403397028
2020,TEXAS,TARRANT,411567,13389,409741,834697,0.49307353446819624,0.49088591428985606,0.016040551241947677
2020,TEXAS,TAYLOR,14588,1000,39547,55135,0.26458692300716424,0.7172757776367099,0.018137299356125874
2020,TEXAS,TERRELL,119,5,334,458,0.259825327510917,0.7292576419213974,0.010917030567685589
2020,TEXAS,TERRY,757,43,2812,3612,0.20957918050941307,0.778516057585825,0.011904761904761904
2020,TEXAS,THROCKMORTON,82,6,806,894,0.09172259507829977,0.901565995525727,0.006711409395973154
2020,TEXAS,TITUS,2856,115,7570,10541,0.27094203585997534,0.7181481832843184,0.01090978085570629
2020,TEXAS,TOM GREEN,12239,658,32313,45210,0.2707144437071444,0.7147312541473125,0.014554302145543022
2020,TEXAS,TRAVIS,435860,11378,161337,608575,0.7161976748962741,0.2651061906913692,0.018696134412356735
2020,TEXAS,TRINITY,1323,36,5579,6938,0.19068895935428076,0.8041222254251946,0.0051888152205246466
2020,TEXAS,TYLER,1403,63,8194,9660,0.14523809523809525,0.84824016563147,0.006521739130434782
2020,TEXAS,UPSHUR,2877,206,15809,18892,0.15228668219352107,0.8368092314207072,0.010904086385771755
2020,TEXAS,UPTON,170,20,1178,1368,0.12426900584795321,0.8611111111111112,0.014619883040935672
2020,TEXAS,UVALDE,4073,97,6174,10344,0.39375483372003095,0.5968677494199536,0.009377416860015468
2020,TEXAS,VAL VERDE,6771,225,8284,15280,0.4431282722513089,0.5421465968586388,0.014725130890052356
2020,TEXAS,VAN ZANDT,3516,243,22270,26029,0.13508010296208076,0.8555841561335433,0.009335740904375889
2020,TEXAS,VICTORIA,10380,450,23358,34188,0.3036153036153036,0.6832221832221832,0.013162513162513163
2020,TEXAS,WALKER,7884,353,15375,23612,0.33389801795697105,0.6511519566322209,0.014950025410808063
2020,TEXAS,WALLER,8191,283,14260,22734,0.3602973519838128,0.6272543327175156,0.012448315298671592
2020,TEXAS,WARD,764,55,3241,4060,0.18817733990147784,0.7982758620689655,0.013546798029556651
2020,TEXAS,WASHINGTON,4261,207,12959,17427,0.24450565214896425,0.7436162276926608,0.011878120158374935
2020,TEXAS,WEBB,41820,679,25898,68397,0.6114303258914865,0.3786423381142448,0.009927335994268755
2020,TEXAS,WHARTON,4694,141,11926,16761,0.2800548893264125,0.7115327247777579,0.008412385895829605
2020,TEXAS,WHEELER,168,10,2159,2337,0.07188703465982028,0.9238339751818571,0.004278990158322636
2020,TEXAS,WICHITA,13161,810,32069,46040,0.2858601216333623,0.6965464813205908,0.017593397046046916
2020,TEXAS,WILBARGER,956,44,3524,4524,0.21131741821396993,0.7789566755083996,0.009725906277630416
2020,TEXAS,WILLACY,3108,0,2441,5549,0.5601009190845198,0.43989908091548025,0.0
2020,TEXAS,WILLIAMSON,143795,6031,139729,289555,0.49660686225414863,0.4825646250280603,0.020828512717791094
2020,TEXAS,WILSON,6350,200,18463,25013,0.25386798864590415,0.7381361691920202,0.00799584216207572
2020,TEXAS,WINKLER,358,15,1753,2126,0.16839134524929444,0.8245531514581373,0.0070555032925682035
2020,TEXAS,WISE,4973,360,27032,32365,0.15365363818940214,0.8352232349760543,0.011123126834543489
2020,TEXAS,WOOD,3509,221,19049,22779,0.1540453926862461,0.8362526888801088,0.009701918433645025
2020,TEXAS,YOAKUM,420,37,2174,2631,0.15963511972633979,0.8263017863930064,0.014063093880653743
2020,TEXAS,YOUNG,1034,95,7110,8239,0.12550066755674233,0.8629688068940405,0.011530525549217139
2020,TEXAS,ZAPATA,1826,15,2033,3874,0.47134744450180693,0.5247805885389778,0.0038719669592152815
2020,TEXAS,ZAVALA,2864,25,1490,4379,0.6540306005937429,0.3402603334094542,0.005709065996802923
2020,UTAH,BEAVER,357,48,2695,3100,0.11516129032258064,0.8693548387096774,0.015483870967741935
2020,UTAH,BOX ELDER,4473,1002,21548,27023,0.16552566332383525,0.7973948118269623,0.03707952484920253
2020,UTAH,CACHE,16650,3676,38032,58358,0.28530792693375373,0.6517015661948662,0.06299050687138011
2020,UTAH,CARBON,2392,284,6693,9369,0.255310065108336,0.7143772014089017,0.0303127334827623
2020,UTAH,DAGGETT,111,12,496,619,0.17932148626817448,0.8012924071082391,0.01938610662358643
2020,UTAH,DAVIS,57411,8268,104135,169814,0.3380816658226059,0.6132297690414218,0.0486885651359723
2020,UTAH,DUCHESNE,843,206,7512,8561,0.09846980492933069,0.8774675855624343,0.02406260950823502
2020,UTAH,EMERY,572,119,4207,4898,0.11678236014699878,0.8589220089832584,0.024295630869742752
2020,UTAH,GARFIELD,514,60,2158,2732,0.18814055636896046,0.7898975109809663,0.021961932650073207
2020,UTAH,GRAND,2806,131,2248,5185,0.5411764705882353,0.43355834136933463,0.025265188042430088
2020,UTAH,IRON,4892,1223,18989,25104,0.1948693435309114,0.7564133205863608,0.04871733588272785
2020,UTAH,JUAB,645,133,5087,5865,0.10997442455242967,0.8673486786018755,0.0226768968456948
2020,UTAH,KANE,1083,99,2998,4180,0.2590909090909091,0.7172248803827751,0.02368421052631579
2020,UTAH,MILLARD,624,162,5404,6190,0.10080775444264943,0.8730210016155089,0.02617124394184168
2020,UTAH,MORGAN,1086,339,5181,6606,0.16439600363306087,0.7842870118074478,0.05131698455949137
2020,UTAH,PIUTE,86,12,773,871,0.09873708381171067,0.8874856486796785,0.013777267508610792
2020,UTAH,RICH,180,32,1157,1369,0.13148283418553688,0.8451424397370343,0.02337472607742878
2020,UTAH,SAN JUAN,3113,229,3535,6877,0.4526683146720954,0.5140322815181039,0.03329940380980079
2020,UTAH,SANPETE,1794,372,10459,12625,0.1420990099009901,0.8284356435643564,0.029465346534653464
2020,UTAH,SEVIER,1084,226,9052,10362,0.1046130090716078,0.873576529627485,0.02181046130090716
2020,UTAH,SUMMIT,15244,590,10252,26086,0.5843747604078816,0.393007743617266,0.022617495974852412
2020,UTAH,TOOELE,8943,1549,21014,31506,0.28385069510569416,0.6669840665270107,0.04916523836729512
2020,UTAH,UINTAH,1663,379,13261,15303,0.10867150231980657,0.8665621120041822,0.02476638567601124
2020,UTAH,UTAH,76033,15441,192812,284286,0.2674524950226181,0.678232484188458,0.05431502078892383
2020,UTAH,WASATCH,6187,808,10795,17790,0.3477796514896009,0.6068015739179314,0.04541877459246768
2020,UTAH,WASHINGTON,20530,3246,67294,91070,0.22543098715273965,0.7389261008015812,0.03564291204567915
2020,UTAH,WAYNE,365,27,1229,1621,0.22516964836520667,0.7581739666872301,0.016656384947563233
2020,UTAH,WEBER,40695,4759,65949,111403,0.365295369065465,0.5919858531637389,0.04271877777079612
2020,VERMONT,ADDISON,15089,955,6567,22611,0.6673300605899783,0.29043385962584584,0.042236079784175845
2020,VERMONT,BENNINGTON,11858,775,6724,19357,0.6125949268998295,0.34736787725370666,0.04003719584646381
2020,VERMONT,CALEDONIA,8529,705,5924,15158,0.5626731758807231,0.39081673043937193,0.046510093679905
2020,VERMONT,CHITTENDEN,72938,3713,20104,96755,0.7538421786987752,0.20778254353780165,0.03837527776342308
2020,VERMONT,ESSEX,1890,183,2164,4237,0.4460703327826292,0.5107387302336559,0.043190936983714893
2020,VERMONT,FRANKLIN,13612,1186,11274,26072,0.522092666462105,0.43241791960724146,0.045489413930653574
2020,VERMONT,GRAND ISLE,3346,242,2194,5782,0.5786924939467313,0.3794534763057765,0.041854029747492215
2020,VERMONT,LAMOILLE,10773,735,4171,15679,0.6870973914152688,0.2660246189170228,0.0468779896677084
2020,VERMONT,ORANGE,8351,743,5782,14876,0.5613740252756118,0.3886797526216725,0.049946222102715786
2020,VERMONT,ORLEANS,7757,599,7086,15442,0.5023313042352027,0.4588783836290636,0.038790312135733716
2020,VERMONT,RUTLAND,18746,1401,14625,34772,0.5391119291383872,0.42059703209478894,0.04029103876682388
2020,VERMONT,WASHINGTON,25101,1517,8707,35325,0.7105732484076434,0.246482661004954,0.042944090587402686
2020,VERMONT,WINDHAM,20057,1144,7251,28452,0.7049416561225924,0.25485027414593,0.04020806973147758
2020,VERMONT,WINDSOR,24779,1394,10135,36308,0.6824666740112372,0.2791395835628512,0.03839374242591165
2020,WASHINGTON,ADAMS,1814,141,3907,5862,0.3094506994199932,0.6664960764244285,0.024053224155578302
2020,WASHINGTON,ASOTIN,4250,382,7319,11951,0.35561877667140823,0.6124173709313028,0.03196385239728893
2020,WASHINGTON,BENTON,38706,3962,60365,103033,0.3756660487416653,0.5858802519581106,0.0384536993002242
2020,WASHINGTON,CHELAN,19349,1211,22746,43306,0.44679721054819194,0.5252389969057405,0.02796379254606752
2020,WASHINGTON,CLALLAM,24721,1481,23062,49264,0.5018065930496914,0.4681308866515102,0.03006252029879831
2020,WASHINGTON,CLARK,140324,8776,126303,275403,0.5095224089788419,0.4586115619655559,0.03186602905560215
2020,WASHINGTON,COLUMBIA,668,73,1754,2495,0.26773547094188377,0.7030060120240481,0.029258517034068135
2020,WASHINGTON,COWLITZ,23938,1918,34424,60280,0.3971134704711347,0.5710683477106835,0.031818181818181815
2020,WASHINGTON,DOUGLAS,7811,542,12955,21308,0.3665759339215318,0.607987610287216,0.025436455791252113
2020,WASHINGTON,FERRY,1486,110,2771,4367,0.34027936798717656,0.6345317151362492,0.02518891687657431
2020,WASHINGTON,FRANKLIN,13340,1025,18039,32404,0.4116775706702876,0.5566905320330824,0.031631897296630046
2020,WASHINGTON,GARFIELD,366,54,1069,1489,0.2458025520483546,0.7179314976494291,0.03626595030221625
2020,WASHINGTON,GRANT,11819,1097,24764,37680,0.31366772823779193,0.6572186836518047,0.029113588110403398
2020,WASHINGTON,GRAYS HARBOR,17354,1210,19877,38441,0.45144507166827086,0.5170781197159283,0.031476808615800836
2020,WASHINGTON,ISLAND,29213,1966,22746,53925,0.541733889661567,0.42180806675938803,0.03645804357904497
2020,WASHINGTON,JEFFERSON,17204,657,6931,24792,0.6939335269441755,0.27956598902871893,0.026500484027105517
2020,WASHINGTON,KING,907310,34030,269167,1210507,0.7495289163961877,0.22235889590064328,0.028112187703169002
2020,WASHINGTON,KITSAP,90277,6832,61563,158672,0.5689535645860644,0.3879890591912877,0.04305737622264798
2020,WASHINGTON,KITTITAS,11421,838,14105,26364,0.43320436959490216,0.5350098619329389,0.031785768472159005
2020,WASHINGTON,KLICKITAT,5959,364,7237,13560,0.4394542772861357,0.5337020648967552,0.026843657817109144
2020,WASHINGTON,LEWIS,14520,1398,29391,45309,0.32046613255644574,0.6486790703833676,0.030854797060186717
2020,WASHINGTON,LINCOLN,1713,170,5150,7033,0.24356604578416038,0.7322621925209726,0.024171761694867056
2020,WASHINGTON,MASON,17269,1324,18710,37303,0.462938637643085,0.5015682384794788,0.03549312387743613
2020,WASHINGTON,OKANOGAN,8900,542,11840,21282,0.4181937787801898,0.5563386899727469,0.025467531247063246
2020,WASHINGTON,PACIFIC,6794,317,6953,14064,0.4830773606370876,0.4943828213879408,0.02253981797497156
2020,WASHINGTON,PEND OREILLE,2593,232,5728,8553,0.3031684788962937,0.6697065357184614,0.027124985385244944
2020,WASHINGTON,PIERCE,249506,16845,197730,464081,0.537634593960968,0.42606786315319956,0.03629754288583243
2020,WASHINGTON,SAN JUAN,9725,415,3057,13197,0.7369099037660074,0.23164355535348943,0.031446540880503145
2020,WASHINGTON,SKAGIT,38252,2409,32762,73423,0.5209811639404546,0.4462089535976465,0.03280988246189886
2020,WASHINGTON,SKAMANIA,3192,235,3885,7312,0.4365426695842451,0.5313183807439825,0.03213894967177243
2020,WASHINGTON,SNOHOMISH,256728,15640,166428,438796,0.5850737016745823,0.3792833116072161,0.035642986718201625
2020,WASHINGTON,SPOKANE,135765,11089,148576,295430,0.4595504857326609,0.5029143959652033,0.03753511830213587
2020,WASHINGTON,STEVENS,7839,783,19808,28430,0.2757298628209638,0.6967288075976081,0.02754132958142807
2020,WASHINGTON,THURSTON,96608,6249,65277,168134,0.5745893156648864,0.3882439006982526,0.03716678363686107
2020,WASHINGTON,WAHKIAKUM,1165,75,1741,2981,0.39080845353908084,0.5840322039584033,0.025159342502515933
2020,WASHINGTON,WALLA WALLA,13690,1171,16400,31261,0.4379258501007645,0.5246153354019385,0.037458814497296954
2020,WASHINGTON,WHATCOM,83660,4471,50489,138620,0.6035204155244553,0.3642259414225941,0.03225364305295051
2020,WASHINGTON,WHITMAN,11184,875,9067,21126,0.529395058222096,0.4291867840575594,0.0414181577203446
2020,WASHINGTON,YAKIMA,43179,2459,50555,96193,0.4488788165459025,0.5255579927853378,0.025563190668759683
2020,WEST VIRGINIA,BARBOUR,1457,104,5116,6677,0.21821177175378165,0.7662123708252209,0.015575857420997454
2020,WEST VIRGINIA,BERKELEY,17186,1070,33279,51535,0.3334820995439992,0.6457553119239352,0.020762588532065588
2020,WEST VIRGINIA,BOONE,2041,155,6816,9012,0.22647581003106967,0.7563249001331558,0.017199289835774522
2020,WEST VIRGINIA,BRAXTON,1457,87,4120,5664,0.2572387005649718,0.7274011299435028,0.015360169491525424
2020,WEST VIRGINIA,BROOKE,2947,164,7545,10656,0.2765578078078078,0.7080518018018018,0.01539039039039039
2020,WEST VIRGINIA,CABELL,14994,645,21721,37360,0.40133832976445394,0.5813972162740899,0.0172644539614561
2020,WEST VIRGINIA,CALHOUN,568,39,2364,2971,0.19118142039717267,0.7956916863009088,0.013126893301918546
2020,WEST VIRGINIA,CLAY,641,45,2679,3365,0.19049034175334323,0.7961367013372956,0.01337295690936107
2020,WEST VIRGINIA,DODDRIDGE,435,47,2619,3101,0.14027732989358271,0.8445662689455015,0.015156401160915834
2020,WEST VIRGINIA,FAYETTE,5063,219,11580,16862,0.300260941762543,0.6867512750563397,0.012987783181117304
2020,WEST VIRGINIA,GILMER,599,51,2012,2662,0.22501878287002253,0.7558226897069872,0.01915852742299023
2020,WEST VIRGINIA,GRANT,607,31,4871,5509,0.11018333635868578,0.884189508077691,0.005627155563623162
2020,WEST VIRGINIA,GREENBRIER,4655,270,10925,15850,0.29369085173501575,0.6892744479495269,0.017034700315457414
2020,WEST VIRGINIA,HAMPSHIRE,1939,114,8033,10086,0.19224667856434663,0.7964505254808646,0.011302795954788817
2020,WEST VIRGINIA,HANCOCK,3790,204,9806,13800,0.2746376811594203,0.7105797101449275,0.014782608695652174
2020,WEST VIRGINIA,HARDY,1381,91,4859,6331,0.2181329963670826,0.7674932870004738,0.014373716632443531
2020,WEST VIRGINIA,HARRISON,9215,567,20683,30465,0.3024782537337929,0.6789102248481864,0.01861152141802068
2020,WEST VIRGINIA,JACKSON,3207,208,10093,13508,0.23741486526502814,0.7471868522357121,0.015398282499259699
2020,WEST VIRGINIA,JEFFERSON,12127,543,15033,27703,0.4377504241417897,0.5426488105981302,0.019600765260080137
2020,WEST VIRGINIA,KANAWHA,34344,1502,46398,82244,0.41758669325421915,0.5641505763338359,0.018262730411944945
2020,WEST VIRGINIA,LEWIS,1538,137,5782,7457,0.20624916186133835,0.7753788386750704,0.018371999463591256
2020,WEST VIRGINIA,LINCOLN,1711,107,6012,7830,0.21851851851851853,0.767816091954023,0.013665389527458494
2020,WEST VIRGINIA,LOGAN,2333,159,10534,13026,0.17910333179794258,0.8086903116843237,0.012206356517733764
2020,WEST VIRGINIA,MARION,8901,593,16300,25794,0.3450802512212142,0.6319299061797318,0.022989842599054042
2020,WEST VIRGINIA,MARSHALL,3455,190,10435,14080,0.24538352272727273,0.7411221590909091,0.013494318181818182
2020,WEST VIRGINIA,MASON,2526,186,8491,11203,0.22547531911095242,0.7579219851825404,0.016602695706507187
2020,WEST VIRGINIA,MCDOWELL,1333,46,5148,6527,0.20422858893825646,0.7887237628313161,0.007047648230427455
2020,WEST VIRGINIA,MERCER,5556,341,19237,25134,0.2210551444258773,0.765377576191613,0.013567279382509748
2020,WEST VIRGINIA,MINERAL,2660,172,10040,12872,0.20665009322560596,0.7799875699192045,0.013362336855189559
2020,WEST VIRGINIA,MINGO,1397,81,8544,10022,0.13939333466373977,0.8525244462183197,0.00808221911794053
2020,WEST VIRGINIA,MONONGALIA,20282,987,20803,42072,0.4820783418900932,0.4944618748811561,0.023459783228750714
2020,WEST VIRGINIA,MONROE,1345,77,5068,6490,0.20724191063174113,0.7808936825885978,0.011864406779661017
2020,WEST VIRGINIA,MORGAN,1998,160,6537,8695,0.2297872340425532,0.751811385853939,0.018401380103507763
2020,WEST VIRGINIA,NICHOLAS,2226,125,8279,10630,0.20940733772342426,0.7788334901222954,0.011759172154280339
2020,WEST VIRGINIA,OHIO,7223,321,12354,19898,0.36300130666398633,0.6208664187355513,0.01613227460046236
2020,WEST VIRGINIA,PENDLETON,820,57,2782,3659,0.2241049467067505,0.7603170265099755,0.01557802678327412
2020,WEST VIRGINIA,PLEASANTS,699,50,2742,3491,0.20022916069894015,0.7854482956173017,0.014322543683758236
2020,WEST VIRGINIA,POCAHONTAS,1047,66,2895,4008,0.26122754491017963,0.7223053892215568,0.016467065868263474
2020,WEST VIRGINIA,PRESTON,3163,219,11190,14572,0.21706011528959648,0.7679110623112819,0.015028822399121603
2020,WEST VIRGINIA,PUTNAM,7878,589,20034,28501,0.2764113539875794,0.70292270446651,0.02066594154591067
2020,WEST VIRGINIA,RALEIGH,7982,451,24673,33106,0.24110433154111038,0.7452727602247327,0.01362290823415695
2020,WEST VIRGINIA,RANDOLPH,3362,165,8673,12200,0.27557377049180326,0.7109016393442623,0.013524590163934426
2020,WEST VIRGINIA,RITCHIE,586,48,3649,4283,0.1368199859911277,0.8519729161802475,0.011207097828624796
2020,WEST VIRGINIA,ROANE,1455,95,4213,5763,0.25247267048412286,0.7310428596217248,0.01648446989415235
2020,WEST VIRGINIA,SUMMERS,1448,63,4074,5585,0.25926589077887197,0.7294538943598926,0.011280214861235453
2020,WEST VIRGINIA,TAYLOR,1796,110,5477,7383,0.24326154679669512,0.741839360693485,0.014899092509819856
2020,WEST VIRGINIA,TUCKER,938,65,2841,3844,0.24401664932362122,0.7390738813735692,0.016909469302809572
2020,WEST VIRGINIA,TYLER,631,65,3226,3922,0.16088730239673635,0.8225395206527282,0.01657317695053544
2020,WEST VIRGINIA,UPSHUR,2256,194,7771,10221,0.2207220428529498,0.7602974268662558,0.018980530280794442
2020,WEST VIRGINIA,WAYNE,4088,274,12585,16947,0.24122263527467988,0.7426093113825456,0.016168053342774533
2020,WEST VIRGINIA,WEBSTER,610,33,2759,3402,0.17930629041740154,0.8109935332157554,0.009700176366843033
2020,WEST VIRGINIA,WETZEL,1539,135,4993,6667,0.23083845807709613,0.7489125543722814,0.020248987550622467
2020,WEST VIRGINIA,WIRT,466,53,2134,2653,0.17565020731247644,0.8043724085940445,0.01997738409347908
2020,WEST VIRGINIA,WOOD,10926,634,27202,38762,0.28187400030958154,0.7017697745214385,0.01635622516897993
2020,WEST VIRGINIA,WYOMING,1157,82,7353,8592,0.13466014897579143,0.8557960893854749,0.009543761638733706
2020,WISCONSIN,ADAMS,4329,127,7362,11818,0.36630563547131495,0.622948045354544,0.010746319174141141
2020,WISCONSIN,ASHLAND,4801,115,3841,8757,0.5482471165924403,0.438620532145712,0.013132351261847666
2020,WISCONSIN,BARRON,9194,349,15803,25346,0.36273968279018387,0.6234908861358794,0.013769431073936717
2020,WISCONSIN,BAYFIELD,6147,116,4617,10880,0.5649816176470588,0.42435661764705884,0.010661764705882353
2020,WISCONSIN,BROWN,65511,2635,75871,144017,0.4548837984404619,0.5268197504461278,0.018296451113410224
2020,WISCONSIN,BUFFALO,2860,122,4834,7816,0.36591606960081885,0.618474923234391,0.015609007164790174
2020,WISCONSIN,BURNETT,3569,110,6462,10141,0.3519376787299083,0.6372152647667882,0.010847056503303422
2020,WISCONSIN,CALUMET,12116,502,18156,30774,0.3937089751088581,0.5899785533242348,0.01631247156690713
2020,WISCONSIN,CHIPPEWA,13983,638,21317,35938,0.3890867605320274,0.593160442985141,0.017752796482831543
2020,WISCONSIN,CLARK,4524,372,10002,14898,0.3036649214659686,0.6713652839307289,0.024969794603302457
2020,WISCONSIN,COLUMBIA,16410,532,16927,33869,0.4845138622339012,0.4997785585638785,0.01570757920222032
2020,WISCONSIN,CRAWFORD,3953,122,4620,8695,0.45462909718228867,0.5313398504887866,0.01403105232892467
2020,WISCONSIN,DANE,260185,5806,78800,344791,0.7546165648175271,0.2285442485447706,0.01683918663770226
2020,WISCONSIN,DODGE,16356,725,31355,48436,0.3376827153357007,0.6473490791972912,0.01496820546700801
2020,WISCONSIN,DOOR,10044,321,9752,20117,0.4992792165829895,0.4847641298404335,0.015956653576577023
2020,WISCONSIN,DOUGLAS,13218,536,10923,24677,0.5356404749361754,0.4426388945171617,0.021720630546662883
2020,WISCONSIN,DUNN,9897,454,13173,23524,0.42071926543104915,0.5599812956980106,0.019299438870940315
2020,WISCONSIN,EAU CLAIRE,31620,1314,25341,58275,0.5425997425997426,0.4348519948519948,0.02254826254826255
2020,WISCONSIN,FLORENCE,781,26,2133,2940,0.26564625850340134,0.7255102040816327,0.008843537414965987
2020,WISCONSIN,FOND DU LAC,20588,909,35754,57251,0.3596094391364343,0.6245131089413285,0.015877451922237166
2020,WISCONSIN,FOREST,1721,47,3285,5053,0.3405897486641599,0.6501088462299623,0.009301405105877696
2020,WISCONSIN,GRANT,10998,468,14142,25608,0.42947516401124647,0.5522492970946579,0.018275538894095594
2020,WISCONSIN,GREEN,10851,386,10169,21406,0.5069139493599926,0.4750537232551621,0.01803232738484537
2020,WISCONSIN,GREEN LAKE,3344,159,7168,10671,0.3133726923437354,0.6717271108612126,0.01490019679505201
2020,WISCONSIN,IOWA,7828,255,5909,13992,0.5594625500285878,0.42231275014293884,0.018224699828473412
2020,WISCONSIN,IRON,1533,39,2438,4010,0.38229426433915215,0.6079800498753117,0.00972568578553616
2020,WISCONSIN,JACKSON,4256,137,5791,10184,0.417910447761194,0.5686370777690495,0.013452474469756481
2020,WISCONSIN,JEFFERSON,19904,867,27208,47979,0.41484816273786446,0.5670814314595969,0.01807040580253861
2020,WISCONSIN,JUNEAU,4746,214,8749,13709,0.3461959296812313,0.6381938872273689,0.015610183091399811
2020,WISCONSIN,KENOSHA,42193,1573,44972,88738,0.47547837454078296,0.5067952849962812,0.017726340462935832
2020,WISCONSIN,KEWAUNEE,3976,192,7927,12095,0.3287308805291443,0.6553947912360479,0.01587432823480777
2020,WISCONSIN,LA CROSSE,37846,1354,28684,67884,0.5575098697778563,0.4225443403452949,0.01994578987684874
2020,WISCONSIN,LAFAYETTE,3647,87,4821,8555,0.4263004091174752,0.5635300993571011,0.010169491525423728
2020,WISCONSIN,LANGLADE,3704,131,7330,11165,0.3317510076130766,0.6565158978952083,0.011733094491715182
2020,WISCONSIN,LINCOLN,6261,219,10017,16497,0.3795235497363157,0.6072013093289689,0.013275140934715404
2020,WISCONSIN,MANITOWOC,16818,793,27218,44829,0.37515893729505456,0.6071516206027349,0.01768944210221062
2020,WISCONSIN,MARATHON,30808,1319,44624,76751,0.40140193613112535,0.5814126200310094,0.017185443837865303
2020,WISCONSIN,MARINETTE,7366,309,15304,22979,0.320553548892467,0.6659993907480743,0.013447060359458637
2020,WISCONSIN,MARQUETTE,3239,107,5719,9065,0.35730832873690016,0.6308880308880309,0.011803640375068947
2020,WISCONSIN,MENOMINEE,1303,9,278,1590,0.819496855345912,0.17484276729559747,0.005660377358490566
2020,WISCONSIN,MILWAUKEE,317270,7344,134357,458971,0.6912637181869878,0.29273527085589285,0.016001010957119297
2020,WISCONSIN,MONROE,8433,403,13775,22611,0.37296006368581663,0.6092167529078767,0.017823183406306665
2020,WISCONSIN,OCONTO,6715,274,16226,23215,0.28925263838035753,0.6989446478569891,0.011802713762653457
2020,WISCONSIN,ONEIDA,10105,383,13671,24159,0.418270623784097,0.56587607102943,0.01585330518647295
2020,WISCONSIN,OUTAGAMIE,47667,1970,58385,108022,0.4412712225287441,0.5404917516802132,0.018237025791042565
2020,WISCONSIN,OZAUKEE,26517,1057,33912,61486,0.4312689067429984,0.5515401880102787,0.017190905246722833
2020,WISCONSIN,PEPIN,1489,71,2584,4144,0.3593146718146718,0.6235521235521235,0.017133204633204634
2020,WISCONSIN,PIERCE,9796,706,12815,23317,0.4201226572886735,0.5495990050177981,0.030278337693528327
2020,WISCONSIN,POLK,9370,390,16611,26371,0.35531455007394486,0.6298964771908536,0.014788972735201546
2020,WISCONSIN,PORTAGE,20428,876,19299,40603,0.5031155333349753,0.47530970617934637,0.0215747604856784
2020,WISCONSIN,PRICE,3032,120,5394,8546,0.3547858647320384,0.6311724783524456,0.01404165691551603
2020,WISCONSIN,RACINE,50159,1813,54479,106451,0.47119331899183664,0.5117753708278926,0.017031310180270733
2020,WISCONSIN,RICHLAND,3995,148,4871,9014,0.44319946749500777,0.540381628577768,0.016418903927224317
2020,WISCONSIN,ROCK,46658,1564,37138,85360,0.5466026241799438,0.4350749765698219,0.0183223992502343
2020,WISCONSIN,RUSK,2517,112,5257,7886,0.3191732183616536,0.6666243976667512,0.014202383971595232
2020,WISCONSIN,SAUK,18108,602,17493,36203,0.5001795431317847,0.4831920006629285,0.016628456205286853
2020,WISCONSIN,SAWYER,4498,103,5909,10510,0.4279733587059943,0.5622264509990486,0.009800190294957184
2020,WISCONSIN,SHAWANO,7131,311,15173,22615,0.3153216891443732,0.6709263762989166,0.013751934556710149
2020,WISCONSIN,SHEBOYGAN,27101,1301,37609,66011,0.4105527866567693,0.5697383769371771,0.019708836406053535
2020,WISCONSIN,ST. CROIX,23190,1318,32199,56707,0.4089442220537147,0.5678134974518138,0.023242280494471582
2020,WISCONSIN,TAYLOR,2693,336,7657,10686,0.25201197828935057,0.7165450121654501,0.031443009545199324
2020,WISCONSIN,TREMPEALEAU,6285,262,8833,15380,0.4086475942782835,0.5743172951885566,0.01703511053315995
2020,WISCONSIN,VERNON,7457,248,8218,15923,0.46831627205928533,0.5161087734723356,0.015574954468379074
2020,WISCONSIN,VILAS,5903,205,9261,15369,0.3840848461188106,0.6025766152644935,0.013338538616695947
2020,WISCONSIN,WALWORTH,22789,960,33851,57600,0.3956423611111111,0.5876909722222222,0.016666666666666666
2020,WISCONSIN,WASHBURN,3867,177,6334,10378,0.37261514742724994,0.6103295432645982,0.01705530930815186
2020,WISCONSIN,WASHINGTON,26650,1183,60237,88070,0.30260020438287727,0.6839672987396389,0.01343249687748382
2020,WISCONSIN,WAUKESHA,103906,4441,159649,267996,0.3877147420110748,0.5957141151360468,0.0165711428528784
2020,WISCONSIN,WAUPACA,9703,475,18952,29130,0.33309303123927225,0.6506007552351528,0.016306213525575007
2020,WISCONSIN,WAUSHARA,4388,164,9016,13568,0.32340801886792453,0.6645047169811321,0.012087264150943397
2020,WISCONSIN,WINNEBAGO,44060,2176,47796,94032,0.4685638931427599,0.5082950484941297,0.02314105836311043
2020,WISCONSIN,WOOD,16365,625,24308,41298,0.39626616301031525,0.5885999322001065,0.015133904789578188
2020,WYOMING,ALBANY,9092,1073,8579,18744,0.48506188647033716,0.4576931284677764,0.05724498506188647
2020,WYOMING,BIG HORN,788,190,4806,5784,0.13623789764868602,0.8309128630705395,0.03284923928077455
2020,WYOMING,CAMPBELL,1935,825,16975,19735,0.09804915125411705,0.8601469470483912,0.04180390169749176
2020,WYOMING,CARBON,1427,265,5014,6706,0.21279451237697583,0.7476886370414554,0.039516850581568744
2020,WYOMING,CONVERSE,861,232,5917,7010,0.12282453637660486,0.8440798858773181,0.033095577746077035
2020,WYOMING,CROOK,378,114,3651,4143,0.09123823316437364,0.8812454742939899,0.027516292541636494
2020,WYOMING,FREMONT,5519,708,12007,18234,0.3026763189645717,0.6584951190084457,0.03882856202698256
2020,WYOMING,GOSHEN,1203,191,4878,6272,0.1918048469387755,0.7777423469387755,0.03045280612244898
2020,WYOMING,HOT SPRINGS,482,107,1999,2588,0.18624420401854713,0.7724111282843895,0.04134466769706337
2020,WYOMING,JOHNSON,897,174,3881,4952,0.1811389337641357,0.7837237479806138,0.035137318255250405
2020,WYOMING,LARAMIE,15217,2129,27891,45237,0.33638393350575857,0.6165528218051595,0.04706324468908195
2020,WYOMING,LINCOLN,1509,373,8643,10525,0.1433729216152019,0.821187648456057,0.03543942992874109
2020,WYOMING,NATRONA,8530,1590,25271,35391,0.24102172868808455,0.7140515950382865,0.04492667627362889
2020,WYOMING,NIOBRARA,155,49,1118,1322,0.1172465960665658,0.8456883509833586,0.037065052950075644
2020,WYOMING,PARK,3410,592,12813,16815,0.20279512340172465,0.7619982158786798,0.0352066607195956
2020,WYOMING,PLATTE,890,175,3898,4963,0.17932701994761233,0.7854120491638122,0.03526093088857546
2020,WYOMING,SHERIDAN,4043,660,11843,16546,0.24434908739272332,0.7157621177323824,0.03988879487489423
2020,WYOMING,SUBLETTE,882,161,3957,5000,0.1764,0.7914,0.0322
2020,WYOMING,SWEETWATER,3823,646,12229,16698,0.22894957479937716,0.7323631572643431,0.038687267936279794
2020,WYOMING,TETON,9848,598,4341,14787,0.6659903969703118,0.29356867518766483,0.0404409278420234
2020,WYOMING,UINTA,1591,372,7496,9459,0.1681995982662015,0.7924727772491806,0.039327624484617824
2020,WYOMING,WASHAKIE,651,136,3245,4032,0.16145833333333334,0.8048115079365079,0.03373015873015873
2020,WYOMING,WESTON,360,93,3107,3560,0.10112359550561797,0.8727528089887641,0.026123595505617977
2020,ARIZONA,APACHE,23293,437,11442,35172,0.6622597520755146,0.3253155919481406,0.012424655976344819
2020,ARIZONA,COCHISE,23732,1153,35557,60442,0.3926408788590715,0.5882829820323616,0.01907613910856689
2020,ARIZONA,COCONINO,44698,1522,27052,73272,0.6100283873785348,0.3691996942897696,0.0207719183316956
2020,ARIZONA,GILA,8943,342,18377,27662,0.3232954956257682,0.6643409731761984,0.012363531198033403
2020,ARIZONA,GRAHAM,4034,212,10749,14995,0.2690230076692231,0.7168389463154384,0.014138046015338445
2020,ARIZONA,GREENLEE,1182,70,2433,3685,0.32075983717774764,0.6602442333785618,0.018995929443690638
2020,ARIZONA,LA PAZ,2236,93,5129,7458,0.2998122821131671,0.6877178868329311,0.01246983105390185
2020,ARIZONA,MARICOPA,1040774,31705,995665,2068144,0.5032405867289705,0.4814292428380229,0.0153301704330066
2020,ARIZONA,MOHAVE,24831,1302,78535,104668,0.2372358313906829,0.750324836626285,0.012439331983032063
2020,ARIZONA,NAVAJO,23383,727,27657,51767,0.45169702706357334,0.534259277145672,0.014043695790754727
2020,ARIZONA,PIMA,304981,7658,207758,520397,0.5860544930120658,0.39922981877297525,0.014715688214958963
2020,ARIZONA,PINAL,75106,2791,107077,184974,0.4060354428189908,0.5788759501335323,0.015088607047476943
2020,ARIZONA,SANTA CRUZ,13138,224,6194,19556,0.6718142769482511,0.3167314379218654,0.011454285129883411
2020,ARIZONA,YAVAPAI,49602,2092,91527,143221,0.3463318926693711,0.6390613108412873,0.014606796489341647
2020,ARIZONA,YUMA,32210,1137,36534,69881,0.4609264320773887,0.5228030509008171,0.016270517021794193
2020,ARKANSAS,ARKANSAS,1818,170,4304,6292,0.28893833439287986,0.684043229497775,0.0270184361093452
2020,ARKANSAS,ASHLEY,2125,253,5548,7926,0.2681049709815796,0.6999747665909665,0.03192026242745395
2020,ARKANSAS,BAXTER,4635,536,15836,21007,0.22064073880135193,0.7538439567763127,0.025515304422335412
2020,ARKANSAS,BENTON,42249,3698,73965,119912,0.3523333778103943,0.6168273400493696,0.030839282140236172
2020,ARKANSAS,BOONE,3064,398,13652,17114,0.17903470842585018,0.7977094776206615,0.023255813953488372
2020,ARKANSAS,BRADLEY,1214,105,2335,3654,0.3322386425834702,0.6390257252326218,0.028735632183908046
2020,ARKANSAS,CALHOUN,479,67,1636,2182,0.21952337305224565,0.7497708524289642,0.0307057745187901
2020,ARKANSAS,CARROLL,4023,350,7424,11797,0.3410189031109604,0.6293125370856998,0.029668559803339833
2020,ARKANSAS,CHICOT,2260,91,1752,4103,0.5508164757494516,0.42700463075798195,0.022178893492566416
2020,ARKANSAS,CLARK,3438,341,4616,8395,0.4095294818344253,0.5498511018463371,0.04061941631923764
2020,ARKANSAS,CLAY,962,135,4086,5183,0.1856067914335327,0.78834651746093,0.026046691105537333
2020,ARKANSAS,CLEBURNE,1988,364,10328,12680,0.15678233438485806,0.8145110410094637,0.028706624605678233
2020,ARKANSAS,CLEVELAND,651,82,2867,3600,0.18083333333333335,0.7963888888888889,0.02277777777777778
2020,ARKANSAS,COLUMBIA,2814,302,5500,8616,0.3266016713091922,0.638347260909935,0.035051067780872795
2020,ARKANSAS,CONWAY,2615,376,5694,8685,0.30109383995394357,0.6556131260794473,0.04329303396660909
2020,ARKANSAS,CRAIGHEAD,11921,1032,25558,38511,0.30954792137311415,0.6636545402612241,0.02679753836566176
2020,ARKANSAS,CRAWFORD,4959,525,18607,24091,0.20584450624714623,0.7723631231580258,0.021792370594827946
2020,ARKANSAS,CRITTENDEN,8514,520,7333,16367,0.5201930714242072,0.44803568155434714,0.03177124702144559
2020,ARKANSAS,CROSS,1772,224,4946,6942,0.25525785076346874,0.7124747911264765,0.03226735811005474
2020,ARKANSAS,DALLAS,963,113,1573,2649,0.3635334088335221,0.5938089845224613,0.04265760664401661
2020,ARKANSAS,DESHA,2016,227,1921,4164,0.484149855907781,0.4613352545629203,0.054514889529298755
2020,ARKANSAS,DREW,2426,133,4349,6908,0.3511870295309786,0.6295599305153445,0.019253039953676897
2020,ARKANSAS,FAULKNER,18347,1660,34421,54428,0.3370875284779893,0.6324134636584111,0.030499007863599617
2020,ARKANSAS,FRANKLIN,1300,152,5677,7129,0.18235376630663488,0.7963248702482817,0.021321363445083463
2020,ARKANSAS,FULTON,1035,123,3961,5119,0.20218792732955657,0.7737839421762063,0.024028130494237156
2020,ARKANSAS,GARLAND,14045,1085,29069,44199,0.3177673703024955,0.6576845629991629,0.02454806669834159
2020,ARKANSAS,GRANT,1268,138,6794,8200,0.1546341463414634,0.8285365853658536,0.016829268292682928
2020,ARKANSAS,GREENE,3058,372,12670,16100,0.18993788819875776,0.7869565217391304,0.0231055900621118
2020,ARKANSAS,HEMPSTEAD,2138,240,4470,6848,0.31220794392523366,0.6527453271028038,0.035046728971962614
2020,ARKANSAS,HOT SPRING,3082,273,9202,12557,0.2454407899976109,0.7328183483316079,0.021740861670781236
2020,ARKANSAS,HOWARD,1340,127,3367,4834,0.2772031443938767,0.6965246172941664,0.02627223831195697
2020,ARKANSAS,INDEPENDENCE,2806,456,11250,14512,0.1933572216097023,0.7752205071664829,0.031422271223814774
2020,ARKANSAS,IZARD,1021,158,4631,5810,0.1757314974182444,0.7970740103270224,0.027194492254733218
2020,ARKANSAS,JACKSON,1365,133,3593,5091,0.26812021213906895,0.7057552543704577,0.026124533490473386
2020,ARKANSAS,JEFFERSON,14981,656,9521,25158,0.5954765879640671,0.37844820732967643,0.02607520470625646
2020,ARKANSAS,JOHNSON,2283,277,6938,9498,0.24036639292482628,0.7304695725415877,0.029164034533586018
2020,ARKANSAS,LAFAYETTE,839,83,1757,2679,0.3131765584173199,0.6558417319895483,0.030981709593131766
2020,ARKANSAS,LAWRENCE,1080,208,4569,5857,0.18439474133515452,0.7800921973706676,0.03551306129417791
2020,ARKANSAS,LEE,1423,139,1286,2848,0.4996488764044944,0.4515449438202247,0.0488061797752809
2020,ARKANSAS,LINCOLN,1032,114,2729,3875,0.2663225806451613,0.704258064516129,0.029419354838709676
2020,ARKANSAS,LITTLE RIVER,1226,236,3715,5177,0.2368166892022407,0.7175970639366428,0.045586246861116474
2020,ARKANSAS,LOGAN,1544,240,6441,8225,0.18772036474164133,0.7831003039513678,0.02917933130699088
2020,ARKANSAS,LONOKE,6686,1092,22884,30662,0.21805492140108276,0.7463309634074751,0.035614115191442176
2020,ARKANSAS,MADISON,1563,130,5658,7351,0.21262413277105155,0.7696911984763978,0.01768466875255067
2020,ARKANSAS,MARION,1531,189,5783,7503,0.20405171264827401,0.7707583633213382,0.025189924030387844
2020,ARKANSAS,MILLER,4245,364,11920,16529,0.25682134430395065,0.7211567547946034,0.022021900901445943
2020,ARKANSAS,MISSISSIPPI,4558,488,7296,12342,0.3693080538000324,0.5911521633446767,0.039539782855290875
2020,ARKANSAS,MONROE,1147,124,1545,2816,0.4073153409090909,0.5486505681818182,0.04403409090909091
2020,ARKANSAS,MONTGOMERY,731,96,3046,3873,0.1887425768138394,0.7864704363542474,0.024786986831913247
2020,ARKANSAS,NEVADA,1076,149,2133,3358,0.32042882668254913,0.6351995235259082,0.04437164979154259
2020,ARKANSAS,NEWTON,709,97,3192,3998,0.17733866933466733,0.7983991995997999,0.024262131065532766
2020,ARKANSAS,OUACHITA,3995,340,5294,9629,0.41489251220272094,0.5497974867587496,0.035310001038529444
2020,ARKANSAS,PERRY,1012,136,3479,4627,0.21871623081910524,0.7518910741301059,0.02939269505078885
2020,ARKANSAS,PHILLIPS,3623,202,2417,6242,0.5804229413649471,0.38721563601409803,0.03236142262095482
2020,ARKANSAS,PIKE,644,83,3519,4246,0.15167216203485634,0.8287800282618936,0.019547809703250117
2020,ARKANSAS,POINSETT,1424,179,5918,7521,0.18933652439835127,0.7868634490094403,0.023800026592208482
2020,ARKANSAS,POLK,1246,209,7035,8490,0.14676089517078916,0.8286219081272085,0.024617196702002356
2020,ARKANSAS,POPE,5772,579,18081,24432,0.2362475442043222,0.7400540275049116,0.023698428290766207
2020,ARKANSAS,PRAIRIE,654,55,2786,3495,0.1871244635193133,0.7971387696709585,0.015736766809728183
2020,ARKANSAS,PULASKI,101947,4322,63687,169956,0.5998434889030102,0.3747263997740592,0.025430111322930642
2020,ARKANSAS,RANDOLPH,1215,242,5355,6812,0.1783617146212566,0.7861127422196125,0.035525543159130944
2020,ARKANSAS,SALINE,16060,1343,39556,56959,0.28195719728225566,0.6944644393335557,0.023578363384188627
2020,ARKANSAS,SCOTT,483,106,2962,3551,0.13601802309208674,0.8341312306392565,0.029850746268656716
2020,ARKANSAS,SEARCY,588,66,3365,4019,0.14630505100771335,0.8372729534710127,0.01642199552127395
2020,ARKANSAS,SEBASTIAN,14487,1455,31198,47140,0.3073186253712346,0.6618158676283411,0.03086550700042427
2020,ARKANSAS,SEVIER,1116,202,3884,5202,0.21453287197231835,0.746635909265667,0.03883121876201461
2020,ARKANSAS,SHARP,1398,230,5938,7566,0.18477398889770025,0.7848268569918054,0.030399154110494316
2020,ARKANSAS,ST. FRANCIS,3604,262,3242,7108,0.5070343275182893,0.45610579628587505,0.03685987619583568
2020,ARKANSAS,STONE,1180,142,4616,5938,0.19872010778039745,0.7773661165375547,0.023913775682047826
2020,ARKANSAS,UNION,5584,545,10478,16607,0.33624375263443124,0.6309387607635335,0.03281748660203529
2020,ARKANSAS,VAN BUREN,1593,180,6034,7807,0.20404764954527987,0.7728961188676828,0.023056231587037273
2020,ARKANSAS,WASHINGTON,43824,2938,47504,94266,0.46489720577939025,0.5039356713979589,0.031167122822650797
2020,ARKANSAS,WHITE,5978,725,24182,30885,0.19355674275538287,0.7829690788408613,0.023474178403755867
2020,ARKANSAS,WOODRUFF,856,77,1543,2476,0.345718901453958,0.6231825525040388,0.031098546042003232
2020,ARKANSAS,YELL,1284,231,5226,6741,0.19047619047619047,0.7752558967512239,0.03426791277258567
2020,GEORGIA,APPLING,1779,36,6526,8341,0.21328377892339048,0.7824001918235224,0.00431602925308716
2020,GEORGIA,ATKINSON,825,30,2300,3155,0.26148969889064977,0.7290015847860539,0.009508716323296355
2020,GEORGIA,BACON,625,25,4018,4668,0.13389031705227078,0.8607540702656384,0.005355612682090831
2020,GEORGIA,BAKER,652,6,897,1555,0.4192926045016077,0.5768488745980708,0.0038585209003215433
2020,GEORGIA,BALDWIN,9140,208,8903,18251,0.500794477014958,0.48780888718426385,0.01139663580077804
2020,GEORGIA,BANKS,932,74,7795,8801,0.1058970571525963,0.885694807408249,0.008408135439154642
2020,GEORGIA,BARROW,10453,664,26804,37921,0.2756520133962712,0.7068378998444134,0.017510086759315417
2020,GEORGIA,BARTOW,12092,701,37674,50467,0.23960211623437097,0.746507618840034,0.013890264925594944
2020,GEORGIA,BEN HILL,2392,58,4110,6560,0.3646341463414634,0.6265243902439024,0.008841463414634146
2020,GEORGIA,BERRIEN,1269,55,6419,7743,0.16388996512979465,0.8290068448921607,0.007103189978044685
2020,GEORGIA,BIBB,43468,749,26585,70802,0.6139374593938024,0.3754837433970792,0.010578797209118387
2020,GEORGIA,BLECKLEY,1311,67,4328,5706,0.22975814931650893,0.7584998247458815,0.011742025937609533
2020,GEORGIA,BRANTLEY,699,56,6991,7746,0.09024012393493416,0.9025303382390911,0.007229537825974697
2020,GEORGIA,BROOKS,2790,50,4260,7100,0.3929577464788732,0.6,0.007042253521126761
2020,GEORGIA,BRYAN,6739,357,14244,21340,0.31579194001874417,0.6674789128397376,0.016729147141518276
2020,GEORGIA,BULLOCH,11243,455,18386,30084,0.37372024996675973,0.6111554314585826,0.015124318574657625
2020,GEORGIA,BURKE,5209,75,5400,10684,0.48755147884687383,0.5054286783976039,0.007019842755522276
2020,GEORGIA,BUTTS,3274,91,8406,11771,0.27814119446096336,0.71412794155127,0.007730863987766545
2020,GEORGIA,CALHOUN,1260,11,923,2194,0.5742935278030994,0.42069279854147673,0.005013673655423883
2020,GEORGIA,CAMDEN,7967,470,15251,23688,0.3363306315433975,0.6438280986153326,0.01984126984126984
2020,GEORGIA,CANDLER,1269,29,3133,4431,0.2863913337846987,0.707063868201309,0.0065447980139923265
2020,GEORGIA,CARROLL,16238,760,37476,54474,0.29808716084737674,0.6879612292102655,0.013951609942357822
2020,GEORGIA,CATOOSA,6932,494,25167,32593,0.21268370509005002,0.7721596661859909,0.015156628723959132
2020,GEORGIA,CHARLTON,1103,44,3419,4566,0.24156811213315812,0.7487954445904511,0.009636443276390714
2020,GEORGIA,CHATHAM,78254,1929,53237,133420,0.5865237595562884,0.3990181382101634,0.014458102233548193
2020,GEORGIA,CHATTAHOOCHEE,667,35,880,1582,0.4216182048040455,0.5562579013906448,0.022123893805309734
2020,GEORGIA,CHATTOOGA,1854,132,8064,10050,0.18447761194029852,0.8023880597014925,0.013134328358208954
2020,GEORGIA,CHEROKEE,42794,2449,99587,144830,0.2954774563281088,0.6876130635917973,0.016909480080093905
2020,GEORGIA,CLARKE,36048,839,14446,51333,0.7022383262228975,0.28141741180137536,0.016344261975727116
2020,GEORGIA,CLAY,790,7,637,1434,0.5509065550906556,0.44421199442119946,0.0048814504881450485
2020,GEORGIA,CLAYTON,95476,1055,15813,112344,0.8498540197963398,0.14075518051698355,0.009390799686676636
2020,GEORGIA,CLINCH,747,12,2105,2864,0.2608240223463687,0.734986033519553,0.004189944134078212
2020,GEORGIA,COBB,221846,6441,165459,393746,0.563424136372179,0.42021760221056215,0.01635826141725884
2020,GEORGIA,COFFEE,4511,125,10578,15214,0.29650322071776,0.6952806625476535,0.008216116734586564
2020,GEORGIA,COLQUITT,4187,119,11777,16083,0.2603370018031462,0.732263881116707,0.007399117080146738
2020,GEORGIA,COLUMBIA,29236,1330,50013,80579,0.3628240608595292,0.6206703979945147,0.01650554114595614
2020,GEORGIA,COOK,2059,76,4900,7035,0.29267945984363897,0.6965174129353234,0.010803127221037668
2020,GEORGIA,COWETA,24210,1088,51501,76799,0.315238479667704,0.6705946692014219,0.0141668511308741
2020,GEORGIA,CRAWFORD,1615,59,4428,6102,0.2646673221894461,0.7256637168141593,0.009668960996394626
2020,GEORGIA,CRISP,2986,66,4987,8039,0.3714392337355392,0.6203507898992412,0.008209976365219555
2020,GEORGIA,DADE,1261,107,6066,7434,0.16962604250739843,0.8159806295399515,0.014393327952649986
2020,GEORGIA,DAWSON,2486,197,13398,16081,0.15459237609601392,0.833157141968783,0.012250481935203035
2020,GEORGIA,DECATUR,4780,89,6758,11627,0.4111120667412058,0.5812333362002237,0.0076545970585705685
2020,GEORGIA,DEKALB,308227,4204,58373,370804,0.8312396845772969,0.1574227893981726,0.011337526024530479
2020,GEORGIA,DODGE,2171,56,5843,8070,0.2690210656753408,0.7240396530359355,0.006939281288723668
2020,GEORGIA,DOOLY,1911,35,2159,4105,0.46552984165651645,0.5259439707673569,0.008526187576126675
2020,GEORGIA,DOUGHERTY,24577,280,10454,35311,0.6960154059641471,0.29605505366599644,0.007929540369856419
2020,GEORGIA,DOUGLAS,42809,837,25451,69097,0.6195493292038728,0.3683372650042694,0.012113405791857823
2020,GEORGIA,EARLY,2437,28,2722,5187,0.46982841719683827,0.5247734721418932,0.005398110661268556
2020,GEORGIA,ECHOLS,167,18,1256,1441,0.11589174184594032,0.871616932685635,0.012491325468424705
2020,GEORGIA,EFFINGHAM,7720,492,23358,31570,0.244535951853025,0.7398796325625594,0.015584415584415584
2020,GEORGIA,ELBERT,2879,66,6226,9171,0.31392432668193215,0.6788790753462,0.007196597971867844
2020,GEORGIA,EMANUEL,2884,66,6551,9501,0.3035469950531523,0.6895063677507631,0.006946637196084623
2020,GEORGIA,EVANS,1324,35,2888,4247,0.3117494702142689,0.6800094184129974,0.008241111372733695
2020,GEORGIA,FANNIN,2571,110,12169,14850,0.17313131313131314,0.8194612794612794,0.007407407407407408
2020,GEORGIA,FAYETTE,33065,976,37952,71993,0.4592807634075535,0.5271623630075146,0.013556873584931869
2020,GEORGIA,FLOYD,12008,517,29123,41648,0.28832116788321166,0.6992652708413369,0.012413561275451403
2020,GEORGIA,FORSYTH,42203,1980,85122,129305,0.3263833571787634,0.6583040098990758,0.015312632922160783
2020,GEORGIA,FRANKLIN,1593,103,9069,10765,0.14797956339990712,0.8424523920111472,0.009568044588945657
2020,GEORGIA,FULTON,381144,6275,137240,524659,0.726460424771137,0.261579425874711,0.011960149354151935
2020,GEORGIA,GILMER,2932,164,13429,16525,0.17742813918305597,0.8126475037821482,0.009924357034795763
2020,GEORGIA,GLASCOCK,155,8,1403,1566,0.09897828863346105,0.8959131545338442,0.005108556832694764
2020,GEORGIA,GLYNN,15879,489,25616,41984,0.3782155106707317,0.6101371951219512,0.011647294207317074
2020,GEORGIA,GORDON,4384,244,19405,24033,0.18241584487995674,0.8074314484250822,0.010152706694961095
2020,GEORGIA,GRADY,3619,54,7034,10707,0.33800317549266834,0.6569533949752498,0.0050434295320818156
2020,GEORGIA,GREENE,4088,91,7068,11247,0.3634747043656086,0.6284342491331022,0.008091046501289233
2020,GEORGIA,GWINNETT,241827,5625,166413,413865,0.5843137254901961,0.40209488601355514,0.013591388496248778
2020,GEORGIA,HABERSHAM,3563,232,16637,20432,0.17438332028191073,0.8142619420516837,0.011354737666405637
2020,GEORGIA,HALL,25031,1322,64170,90523,0.27651536073705024,0.7088806159760502,0.014604023286899461
2020,GEORGIA,HANCOCK,2985,21,1159,4165,0.7166866746698679,0.27827130852340937,0.005042016806722689
2020,GEORGIA,HARALSON,1792,125,12331,14248,0.1257720381807973,0.8654548006737788,0.00877316114542392
2020,GEORGIA,HARRIS,5457,215,14319,19991,0.27297283777699966,0.7162723225451453,0.010754839677855035
2020,GEORGIA,HART,3157,106,9464,12727,0.2480553154710458,0.7436159346271706,0.00832874990178361
2020,GEORGIA,HEARD,824,51,4516,5391,0.15284733815618623,0.8376924503802634,0.009460211463550361
2020,GEORGIA,HENRY,73276,1279,48187,122742,0.596992064655945,0.3925877042903,0.01042023105375503
2020,GEORGIA,HOUSTON,32232,1057,41534,74823,0.43077663285353435,0.5550966948665518,0.01412667227991393
2020,GEORGIA,IRWIN,1008,26,3134,4168,0.2418426103646833,0.7519193857965452,0.006238003838771593
2020,GEORGIA,JACKSON,7642,531,29497,37670,0.20286700292009557,0.7830368993894345,0.01409609769046987
2020,GEORGIA,JASPER,1761,61,5822,7644,0.23037676609105182,0.7616431187859759,0.007980115122972265
2020,GEORGIA,JEFF DAVIS,1028,48,4695,5771,0.17813203950788425,0.8135505111765725,0.008317449315543233
2020,GEORGIA,JEFFERSON,4061,44,3537,7642,0.5314053912588328,0.4628369536770479,0.0057576550641193405
2020,GEORGIA,JENKINS,1266,28,2161,3455,0.36642547033285094,0.6254703328509407,0.008104196816208394
2020,GEORGIA,JOHNSON,1222,28,2850,4100,0.29804878048780487,0.6951219512195121,0.006829268292682927
2020,GEORGIA,JONES,4888,113,9965,14966,0.32660697581184017,0.6658425765067486,0.007550447681411198
2020,GEORGIA,LAMAR,2615,94,6330,9039,0.28930191392853194,0.7002987056090275,0.010399380462440535
2020,GEORGIA,LANIER,1019,48,2509,3576,0.2849552572706935,0.7016219239373602,0.013422818791946308
2020,GEORGIA,LAURENS,8073,163,14493,22729,0.3551850059395486,0.6376435390910291,0.0071714549694223235
2020,GEORGIA,LEE,4558,149,12007,16714,0.27270551633361256,0.7183798013641259,0.008914682302261577
2020,GEORGIA,LIBERTY,13099,331,7959,21389,0.6124175978306606,0.3721071578848941,0.015475244284445275
2020,GEORGIA,LINCOLN,1435,36,3179,4650,0.3086021505376344,0.6836559139784947,0.007741935483870968
2020,GEORGIA,LONG,2033,95,3528,5656,0.35944130127298446,0.6237623762376238,0.016796322489391797
2020,GEORGIA,LOWNDES,20117,547,25691,46355,0.43397691726890303,0.5542228454319922,0.011800237299104736
2020,GEORGIA,LUMPKIN,3126,242,12163,15531,0.2012748696156075,0.7831433906380787,0.015581739746313824
2020,GEORGIA,MACON,2857,22,1783,4662,0.6128271128271128,0.38245388245388245,0.004719004719004719
2020,GEORGIA,MADISON,3411,200,11326,14937,0.22835910825466962,0.7582513222199906,0.01338956952533976
2020,GEORGIA,MARION,1311,38,2275,3624,0.3617549668874172,0.6277593818984547,0.010485651214128035
2020,GEORGIA,MCDUFFIE,4168,118,6169,10455,0.39866092778574846,0.5900526064084171,0.011286465805834528
2020,GEORGIA,MCINTOSH,2612,68,4016,6696,0.3900836320191159,0.5997610513739546,0.01015531660692951
2020,GEORGIA,MERIWETHER,4287,66,6524,10877,0.3941344120621495,0.5997977383469707,0.006067849590879838
2020,GEORGIA,MILLER,749,20,2066,2835,0.2641975308641975,0.7287477954144621,0.007054673721340388
2020,GEORGIA,MITCHELL,3995,33,4935,8963,0.4457212986723195,0.5505968983599241,0.0036818029677563317
2020,GEORGIA,MONROE,4384,148,11060,15592,0.28116983068240126,0.7093381221139046,0.009492047203694202
2020,GEORGIA,MONTGOMERY,979,27,2960,3966,0.24684820978315683,0.7463439233484619,0.00680786686838124
2020,GEORGIA,MORGAN,3355,122,8230,11707,0.28658067822670197,0.702998206201418,0.010421115571880071
2020,GEORGIA,MURRAY,2302,144,12943,15389,0.14958736760023394,0.8410552992397167,0.009357333160049386
2020,GEORGIA,MUSCOGEE,49529,965,30049,80543,0.6149386042238307,0.373080218020188,0.011981177755981277
2020,GEORGIA,NEWTON,29794,576,23869,54239,0.5493095374177253,0.44007079776544555,0.010619664816829218
2020,GEORGIA,OCONEE,8162,411,16595,25168,0.3243006993006993,0.6593690400508583,0.016330260648442466
2020,GEORGIA,OGLETHORPE,2436,102,5593,8131,0.29959414586151767,0.6878612716763006,0.012544582462181774
2020,GEORGIA,PAULDING,29704,1156,54525,85385,0.34788311764361424,0.638578204602682,0.013538677753703812
2020,GEORGIA,PEACH,5920,123,6502,12545,0.4719011558389797,0.5182941410920685,0.009804703068951773
2020,GEORGIA,PICKENS,2808,233,14075,17116,0.16405702266884786,0.8223299836410376,0.013612993690114513
2020,GEORGIA,PIERCE,1100,49,7899,9048,0.12157382847038019,0.8730106100795756,0.005415561450044209
2020,GEORGIA,PIKE,1505,88,9127,10720,0.14039179104477612,0.8513992537313433,0.008208955223880597
2020,GEORGIA,POLK,3658,152,13589,17399,0.21024196792919134,0.781021897810219,0.008736134260589688
2020,GEORGIA,PULASKI,1217,37,2805,4059,0.29982754372998277,0.6910569105691057,0.009115545700911555
2020,GEORGIA,PUTNAM,3448,116,8291,11855,0.2908477435681147,0.699367355546183,0.009784900885702235
2020,GEORGIA,QUITMAN,497,5,604,1106,0.44936708860759494,0.546112115732369,0.0045207956600361665
2020,GEORGIA,RABUN,1984,110,7474,9568,0.20735785953177258,0.7811454849498328,0.011496655518394648
2020,GEORGIA,RANDOLPH,1671,12,1391,3074,0.5435914118412492,0.4525048796356539,0.003903708523096942
2020,GEORGIA,RICHMOND,59124,1111,26781,87016,0.6794612485060219,0.30777098464650177,0.012767766847476327
2020,GEORGIA,ROCKDALE,31244,430,13012,44686,0.6991899028778589,0.2911873965000224,0.009622700622118785
2020,GEORGIA,SCHLEY,462,13,1800,2275,0.20307692307692307,0.7912087912087912,0.005714285714285714
2020,GEORGIA,SCREVEN,2661,51,3916,6628,0.40147857573928786,0.5908267954133977,0.007694628847314424
2020,GEORGIA,SEMINOLE,1254,19,2611,3884,0.32286302780638515,0.6722451081359423,0.004891864057672502
2020,GEORGIA,SPALDING,11784,275,18057,30116,0.39128702350909816,0.5995816177447204,0.009131358746181432
2020,GEORGIA,STEPHENS,2385,132,9368,11885,0.20067311737484222,0.7882204459402609,0.011106436684896928
2020,GEORGIA,STEWART,1182,7,801,1990,0.5939698492462312,0.40251256281407033,0.0035175879396984926
2020,GEORGIA,SUMTER,6318,100,5732,12150,0.52,0.4717695473251029,0.00823045267489712
2020,GEORGIA,TALBOT,2114,16,1392,3522,0.6002271436683703,0.39522998296422485,0.004542873367404884
2020,GEORGIA,TALIAFERRO,561,7,360,928,0.6045258620689655,0.3879310344827586,0.007543103448275862
2020,GEORGIA,TATTNALL,2061,69,6053,8183,0.25186361969937676,0.7397042649395087,0.008432115361114505
2020,GEORGIA,TAYLOR,1387,34,2418,3839,0.361292003125814,0.6298515238343319,0.008856473039854129
2020,GEORGIA,TELFAIR,1487,21,2825,4333,0.34318024463420266,0.6519732287099007,0.004846526655896607
2020,GEORGIA,TERRELL,2376,36,2004,4416,0.5380434782608695,0.453804347826087,0.008152173913043478
2020,GEORGIA,THOMAS,8708,191,12954,21853,0.39848075779069236,0.5927790234750377,0.008740218734269894
2020,GEORGIA,TIFT,5322,177,10784,16283,0.3268439476754898,0.662285819566419,0.01087023275809126
2020,GEORGIA,TOOMBS,2939,103,7872,10914,0.269287154113982,0.7212754260582738,0.009437419827744181
2020,GEORGIA,TOWNS,1550,45,6384,7979,0.19425993232234615,0.800100263190876,0.005639804486777792
2020,GEORGIA,TREUTLEN,952,24,2101,3077,0.30939226519337015,0.682807929801755,0.007799805004874878
2020,GEORGIA,TROUP,11578,328,18143,30049,0.3853040034610137,0.60378049186329,0.010915504675696363
2020,GEORGIA,TURNER,1410,33,2349,3792,0.37183544303797467,0.6194620253164557,0.00870253164556962
2020,GEORGIA,TWIGGS,2044,30,2370,4444,0.45994599459945995,0.5333033303330333,0.0067506750675067504
2020,GEORGIA,UNION,2801,108,12651,15560,0.18001285347043702,0.8130462724935733,0.006940874035989717
2020,GEORGIA,UPSON,4201,96,8608,12905,0.32553273924835335,0.6670282836110035,0.0074389771406431614
2020,GEORGIA,WALKER,5769,411,23174,29354,0.19653198882605438,0.7894665122300197,0.014001498943925871
2020,GEORGIA,WALTON,12682,571,37842,51095,0.24820432527644584,0.7406204129562579,0.011175261767296213
2020,GEORGIA,WARE,4211,116,9865,14192,0.2967164599774521,0.6951099210822999,0.008173618940248028
2020,GEORGIA,WARREN,1469,16,1166,2651,0.5541305167861185,0.43983402489626555,0.006035458317615994
2020,GEORGIA,WASHINGTON,4730,66,4663,9459,0.5000528597103288,0.4929696585262713,0.006977481763399937
2020,GEORGIA,WAYNE,2687,104,9987,12778,0.21028329942087964,0.7815777116919705,0.00813898888714979
2020,GEORGIA,WEBSTER,639,3,748,1390,0.45971223021582736,0.5381294964028777,0.002158273381294964
2020,GEORGIA,WHEELER,689,13,1583,2285,0.3015317286652079,0.6927789934354486,0.0056892778993435445
2020,GEORGIA,WHITE,2411,183,12222,14816,0.1627294816414687,0.8249190064794817,0.012351511879049676
2020,GEORGIA,WHITFIELD,10670,440,25636,36746,0.290371741141893,0.6976541664398846,0.011974092418222391
2020,GEORGIA,WILCOX,862,16,2403,3281,0.2627247790307833,0.7323986589454434,0.0048765620237732395
2020,GEORGIA,WILKES,2160,46,2823,5029,0.42950884867766953,0.5613442036190097,0.00914694770332074
2020,GEORGIA,WILKINSON,2075,31,2664,4770,0.4350104821802935,0.5584905660377358,0.00649895178197065
2020,GEORGIA,WORTH,2395,60,6830,9285,0.2579429186860528,0.7355950457727517,0.006462035541195477
2020,IOWA,ADAIR,1198,57,2922,4177,0.28680871438831695,0.6995451280823558,0.013646157529327269
2020,IOWA,ADAMS,590,35,1535,2160,0.27314814814814814,0.7106481481481481,0.016203703703703703
2020,IOWA,ALLAMAKEE,2576,102,4744,7422,0.3470762597682565,0.6391808137968202,0.0137429264349232
2020,IOWA,APPANOOSE,1891,103,4522,6516,0.2902087170042971,0.6939840392879066,0.015807243707796195
2020,IOWA,AUDUBON,1071,50,2299,3420,0.3131578947368421,0.6722222222222223,0.014619883040935672
2020,IOWA,BENTON,5160,274,9208,14642,0.3524108728315804,0.6288758366343395,0.018713290534080045
2020,IOWA,BLACK HAWK,35647,1133,29813,66593,0.5352965026354122,0.4476896971153124,0.01701380024927545
2020,IOWA,BOONE,6303,308,8729,15340,0.4108865710560626,0.5690352020860495,0.020078226857887876
2020,IOWA,BREMER,5958,264,8324,14546,0.40959714010724596,0.5722535404922315,0.01814931940052248
2020,IOWA,BUCHANAN,4169,175,6430,10774,0.386950064971227,0.5968071282717654,0.01624280675700761
2020,IOWA,BUENA VISTA,2961,132,5074,8167,0.3625566303416187,0.621280764050447,0.01616260560793437
2020,IOWA,BUTLER,2424,118,5556,8098,0.2993331686836256,0.6860953321807853,0.014571499135589035
2020,IOWA,CALHOUN,1470,90,3698,5258,0.2795739825028528,0.7033092430581971,0.017116774438950173
2020,IOWA,CARROLL,3454,115,7766,11335,0.3047198941332157,0.6851345390383767,0.010145566828407587
2020,IOWA,CASS,2201,96,4979,7276,0.3025013743815283,0.684304562946674,0.013194062671797692
2020,IOWA,CEDAR,4337,182,6184,10703,0.4052134915444268,0.5777819302999159,0.017004578155657292
2020,IOWA,CERRO GORDO,10941,361,12499,23801,0.45968656779126926,0.5251460022688123,0.015167429939918492
2020,IOWA,CHEROKEE,1936,72,4510,6518,0.29702362687941086,0.6919300398895367,0.01104633323105247
2020,IOWA,CHICKASAW,2233,76,4322,6631,0.336751621173277,0.651787060775147,0.011461318051575931
2020,IOWA,CLARKE,1466,51,3153,4670,0.3139186295503212,0.6751605995717345,0.010920770877944325
2020,IOWA,CLAY,2662,149,6158,8969,0.29680008919611994,0.6865871334596945,0.01661277734418553
2020,IOWA,CLAYTON,3340,135,6119,9594,0.34813425057327496,0.6377944548676256,0.014071294559099437
2020,IOWA,CLINTON,10812,465,13410,24687,0.43796330052254223,0.5432008749544295,0.018835824523028316
2020,IOWA,CRAWFORD,2220,72,4862,7154,0.31031590718479174,0.6796197931227286,0.010064299692479732
2020,IOWA,DALLAS,26879,981,28162,56022,0.4797936524936632,0.5026953696761987,0.01751097783013816
2020,IOWA,DAVIS,1013,54,3035,4102,0.24695270599707458,0.7398829839102876,0.013164310092637738
2020,IOWA,DECATUR,1120,66,2618,3804,0.29442691903259727,0.6882229232386962,0.017350157728706624
2020,IOWA,DELAWARE,3157,158,6688,10003,0.31560531840447864,0.6685994201739478,0.015795261421573527
2020,IOWA,DES MOINES,8893,421,10642,19956,0.44563038685107237,0.533273201042293,0.021096412106634595
2020,IOWA,DICKINSON,3661,131,7452,11244,0.32559587335467804,0.6627534685165422,0.011650658128779794
2020,IOWA,DUBUQUE,25657,911,27358,53926,0.47578162667358975,0.507324852575752,0.01689352075065831
2020,IOWA,EMMET,1520,65,3268,4853,0.3132083247475788,0.6733978982072945,0.013393777045126726
2020,IOWA,FAYETTE,3835,177,6174,10186,0.37649715295503633,0.6061260553701159,0.01737679167484783
2020,IOWA,FLOYD,3172,113,4747,8032,0.3949203187250996,0.5910109561752988,0.014068725099601593
2020,IOWA,FRANKLIN,1626,71,3433,5130,0.3169590643274854,0.6692007797270955,0.013840155945419104
2020,IOWA,FREMONT,1080,60,2717,3857,0.2800103707544724,0.7044334975369458,0.0155561317085818
2020,IOWA,GREENE,1769,59,3229,5057,0.3498121415859205,0.6385208621712478,0.011666996242831719
2020,IOWA,GRUNDY,2206,125,4945,7276,0.30318856514568443,0.6796316657504123,0.017179769103903245
2020,IOWA,GUTHRIE,1985,106,4280,6371,0.3115680426934547,0.6717940668654843,0.016637890441061058
2020,IOWA,HAMILTON,2843,118,4982,7943,0.35792521717235304,0.6272189349112426,0.014855847916404381
2020,IOWA,HANCOCK,1683,88,4401,6172,0.27268308489954635,0.7130589760207389,0.014257939079714841
2020,IOWA,HARDIN,2976,149,5864,8989,0.33107130937812884,0.652352875737012,0.016575814884859274
2020,IOWA,HARRISON,2440,135,5580,8155,0.299202942979767,0.6842427958307786,0.01655426118945432
2020,IOWA,HENRY,3275,182,6525,9982,0.32809056301342415,0.6536766179122421,0.0182328190743338
2020,IOWA,HOWARD,1772,53,3133,4958,0.3574021782977007,0.6319080274304155,0.010689794271883823
2020,IOWA,HUMBOLDT,1442,60,3825,5327,0.2706964520367937,0.7180401727050872,0.011263375258119017
2020,IOWA,IDA,917,47,2885,3849,0.23824369966224992,0.7495453364510263,0.012210963886723825
2020,IOWA,IOWA,3547,160,6035,9742,0.364093615274071,0.6194826524327653,0.016423732293163622
2020,IOWA,JACKSON,4029,149,6957,11135,0.3618320610687023,0.6247867085765604,0.013381230354737315
2020,IOWA,JASPER,7737,322,12125,20184,0.38332342449464923,0.6007233452239398,0.01595323028141102
2020,IOWA,JEFFERSON,4319,164,4476,8959,0.4820850541355062,0.4996093313985936,0.018305614465900212
2020,IOWA,JOHNSON,59177,1468,23206,83851,0.7057399434711572,0.2767528115347462,0.01750724499409667
2020,IOWA,JONES,4213,180,6596,10989,0.3833833833833834,0.6002366002366002,0.01638001638001638
2020,IOWA,KEOKUK,1414,80,3809,5303,0.26664152366584953,0.718272675843862,0.015085800490288516
2020,IOWA,KOSSUTH,2696,106,6288,9090,0.29658965896589656,0.6917491749174918,0.011661166116611662
2020,IOWA,LEE,6541,385,9808,16734,0.39088084140074103,0.586112107087367,0.023007051511891956
2020,IOWA,LINN,70874,2840,53744,127458,0.5560576817461438,0.4216604685465016,0.02228184970735458
2020,IOWA,LOUISA,1726,100,3506,5332,0.3237059264816204,0.6575393848462115,0.018754688672168042
2020,IOWA,LUCAS,1284,51,3295,4630,0.27732181425485963,0.7116630669546437,0.011015118790496761
2020,IOWA,LYON,1067,78,5718,6863,0.15547136820632376,0.8331633396473845,0.011365292146291709
2020,IOWA,MADISON,3134,165,6525,9824,0.31901465798045603,0.6641897394136808,0.016795602605863193
2020,IOWA,MAHASKA,2894,190,8320,11404,0.25377060680462993,0.729568572430726,0.016660820764643983
2020,IOWA,MARION,6178,332,12722,19232,0.32123544093178036,0.6615016638935108,0.017262895174708817
2020,IOWA,MARSHALL,8176,350,9610,18136,0.45081605646228495,0.5298853109836789,0.01929863255403617
2020,IOWA,MILLS,2508,144,5616,8268,0.3033381712626996,0.6792452830188679,0.01741654571843251
2020,IOWA,MITCHELL,2053,85,3684,5822,0.3526279628993473,0.6327722432153899,0.014599793885262797
2020,IOWA,MONONA,1407,59,3262,4728,0.29758883248730966,0.689932318104907,0.012478849407783418
2020,IOWA,MONROE,1078,32,2978,4088,0.2636986301369863,0.7284735812133072,0.007827788649706457
2020,IOWA,MONTGOMERY,1583,78,3666,5327,0.2971653838933734,0.6881922282710718,0.01464238783555472
2020,IOWA,MUSCATINE,9372,434,10865,20671,0.453388805573025,0.5256155967297179,0.020995597697257028
2020,IOWA,O'BRIEN,1569,111,5871,7551,0.2077870480731029,0.77751291219706,0.014700039729837107
2020,IOWA,OSCEOLA,601,32,2695,3328,0.18058894230769232,0.8097956730769231,0.009615384615384616
2020,IOWA,PAGE,2086,114,5328,7528,0.2770988310308183,0.7077577045696068,0.01514346439957492
2020,IOWA,PALO ALTO,1519,61,3378,4958,0.3063735377168213,0.6813231141589351,0.012303348124243647
2020,IOWA,PLYMOUTH,3494,179,10515,14188,0.24626444882999718,0.7411192557090499,0.012616295460952918
2020,IOWA,POCAHONTAS,933,58,2832,3823,0.24404917603975934,0.7407794925451217,0.015171331415119017
2020,IOWA,POLK,146250,4941,107564,258755,0.565206469440204,0.4156982473768623,0.019095283182933662
2020,IOWA,POTTAWATTAMIE,18575,817,26352,45744,0.40606418328086746,0.5760755508919203,0.017860265827212313
2020,IOWA,POWESHIEK,4306,161,5673,10140,0.42465483234714,0.5594674556213017,0.015877712031558185
2020,IOWA,RINGGOLD,709,31,1974,2714,0.261238025055269,0.7273397199705232,0.011422254974207811
2020,IOWA,SAC,1389,77,4069,5535,0.25094850948509484,0.7351400180668474,0.013911472448057814
2020,IOWA,SCOTT,46926,1715,43958,92599,0.5067657318113586,0.4747135498223523,0.018520718366289053
2020,IOWA,SHELBY,1959,125,4711,6795,0.2883002207505519,0.6933038999264165,0.01839587932303164
2020,IOWA,SIOUX,3019,257,15775,19051,0.15846937168652564,0.8280405228072018,0.013490105506272637
2020,IOWA,STORY,29175,1322,20541,51038,0.5716329009757436,0.40246483012657236,0.02590226889768408
2020,IOWA,TAMA,3577,146,5325,9048,0.3953359858532272,0.588527851458886,0.016136162687886826
2020,IOWA,TAYLOR,746,33,2470,3249,0.2296091104955371,0.7602339181286549,0.010156971375807941
2020,IOWA,UNION,2061,100,4024,6185,0.3332255456750202,0.6506063055780114,0.016168148746968473
2020,IOWA,VAN BUREN,875,46,2870,3791,0.2308098127143234,0.7570561857029807,0.012134001582695859
2020,IOWA,WAPELLO,5821,276,9536,15633,0.3723533550821979,0.60999168425766,0.017654960660142008
2020,IOWA,WARREN,12574,597,17868,31039,0.4051032571925642,0.575662875736976,0.019233867070459744
2020,IOWA,WASHINGTON,4561,213,6991,11765,0.38767530811729706,0.5942201444963876,0.018104547386315343
2020,IOWA,WAYNE,727,38,2344,3109,0.23383724670311998,0.7539401736892891,0.012222579607590866
2020,IOWA,WEBSTER,6613,239,10970,17822,0.3710582426214791,0.6155313657277522,0.013410391650768712
2020,IOWA,WINNEBAGO,2135,109,3726,5970,0.3576214405360134,0.6241206030150753,0.018257956448911223
2020,IOWA,WINNESHIEK,5617,184,6263,12064,0.4656001326259947,0.5191478779840849,0.015251989389920425
2020,IOWA,WOODBURY,18704,732,25926,45362,0.4123274987875314,0.5715356465764296,0.016136854636038974
2020,IOWA,WORTH,1596,80,2742,4418,0.3612494341330919,0.6206428248076052,0.01810774105930285
2020,IOWA,WRIGHT,1996,110,4148,6254,0.31915574032619126,0.6632555164694596,0.017588743204349215
2020,KENTUCKY,ADAIR,1392,95,7276,8763,0.15884970900376583,0.8303092548214082,0.010841036174825973
2020,KENTUCKY,ALLEN,1642,135,7586,9363,0.1753711417280786,0.8102104026487237,0.014418455623197693
2020,KENTUCKY,ANDERSON,3347,236,9657,13240,0.2527945619335347,0.729380664652568,0.01782477341389728
2020,KENTUCKY,BALLARD,825,44,3356,4225,0.1952662721893491,0.7943195266272189,0.010414201183431953
2020,KENTUCKY,BARREN,5127,274,14654,20055,0.2556469708302169,0.7306906008476689,0.013662428322114187
2020,KENTUCKY,BATH,1573,68,3986,5627,0.27954505064865826,0.7083703572063267,0.012084592145015106
2020,KENTUCKY,BELL,1789,115,8140,10044,0.1781162883313421,0.8104340900039825,0.011449621664675428
2020,KENTUCKY,BOONE,20897,1245,44811,66953,0.3121144683584007,0.6692903977416994,0.01859513389989993
2020,KENTUCKY,BOURBON,3296,157,6190,9643,0.34180234366898266,0.6419164160530955,0.01628124027792181
2020,KENTUCKY,BOYD,7083,363,14295,21741,0.3257899820615427,0.6575134538429696,0.01669656409548779
2020,KENTUCKY,BOYLE,5298,297,8872,14467,0.36621276007465264,0.6132577590378102,0.020529480887537154
2020,KENTUCKY,BRACKEN,800,46,3398,4244,0.1885014137606032,0.8006597549481621,0.010838831291234684
2020,KENTUCKY,BREATHITT,1301,95,4265,5661,0.2298180533474651,0.7534004592828122,0.016781487369722663
2020,KENTUCKY,BRECKINRIDGE,2350,146,7701,10197,0.23045993919780328,0.755222124154163,0.014317936648033736
2020,KENTUCKY,BULLITT,10551,705,30708,41964,0.25142979696883044,0.7317700886474121,0.016800114383757506
2020,KENTUCKY,BUTLER,1079,83,4960,6122,0.17624959163672002,0.8101927474681476,0.01355766089513231
2020,KENTUCKY,CALDWELL,1433,89,4906,6428,0.2229309271935283,0.7632233976353454,0.013845675171126323
2020,KENTUCKY,CALLOWAY,5794,298,11351,17443,0.33216763171472796,0.6507481511207934,0.017084217164478586
2020,KENTUCKY,CAMPBELL,19373,978,28482,48833,0.3967194315319558,0.5832531280076997,0.02002744046034444
2020,KENTUCKY,CARLISLE,463,16,2159,2638,0.1755117513267627,0.8184230477634572,0.006065200909780136
2020,KENTUCKY,CARROLL,1116,65,2954,4135,0.26989117291414755,0.7143893591293833,0.015719467956469165
2020,KENTUCKY,CARTER,2642,168,8775,11585,0.22805351747949934,0.7574449719464825,0.014501510574018127
2020,KENTUCKY,CASEY,918,74,6179,7171,0.12801561846325477,0.8616650397434109,0.010319341793334264
2020,KENTUCKY,CHRISTIAN,8296,487,15080,23863,0.34765117545991703,0.6319406612747769,0.02040816326530612
2020,KENTUCKY,CLARK,6004,313,11811,18128,0.3312003530450132,0.6515335392762577,0.017266107678729038
2020,KENTUCKY,CLAY,831,82,6677,7590,0.10948616600790514,0.8797101449275362,0.01080368906455863
2020,KENTUCKY,CLINTON,603,49,4280,4932,0.12226277372262774,0.8678021086780211,0.009935117599351177
2020,KENTUCKY,CRITTENDEN,731,60,3451,4242,0.17232437529467232,0.8135313531353136,0.014144271570014143
2020,KENTUCKY,CUMBERLAND,508,32,2769,3309,0.1535207011181626,0.8368087035358114,0.00967059534602599
2020,KENTUCKY,DAVIESS,17283,934,31023,49240,0.35099512591389115,0.6300365556458164,0.018968318440292446
2020,KENTUCKY,EDMONSON,1227,76,4828,6131,0.20013048442342196,0.7874734953514925,0.01239602022508563
2020,KENTUCKY,ELLIOTT,712,37,2246,2995,0.23772954924874792,0.7499165275459099,0.012353923205342237
2020,KENTUCKY,ESTILL,1355,83,5100,6538,0.20724992352401345,0.780055062710309,0.012695013765677577
2020,KENTUCKY,FAYETTE,90566,3253,58845,152664,0.5932374364617723,0.38545433108001886,0.021308232458208877
2020,KENTUCKY,FLEMING,1474,58,5534,7066,0.20860458533823945,0.7831870931219926,0.008208321539767903
2020,KENTUCKY,FLOYD,3884,217,12250,16351,0.23753898844107393,0.7491896520090514,0.013271359549874625
2020,KENTUCKY,FRANKLIN,12650,509,12900,26059,0.4854368932038835,0.4950305076940788,0.019532599102037685
2020,KENTUCKY,FULTON,791,25,1605,2421,0.3267244940107394,0.6629491945477075,0.010326311441553077
2020,KENTUCKY,GALLATIN,822,72,2955,3849,0.21356196414653156,0.7677318784099766,0.018706157443491817
2020,KENTUCKY,GARRARD,1830,119,6754,8703,0.21027231988969322,0.7760542341721246,0.013673445938182236
2020,KENTUCKY,GRANT,2205,176,8725,11106,0.19854132901134522,0.7856113812353682,0.01584728975328651
2020,KENTUCKY,GRAVES,3559,253,13206,17018,0.20913150781525444,0.7760018803619697,0.014866611822775884
2020,KENTUCKY,GRAYSON,2400,130,9453,11983,0.20028373529166318,0.7888675623800384,0.010848702328298423
2020,KENTUCKY,GREEN,920,54,4838,5812,0.1582931865106676,0.8324156916724019,0.009291121816930488
2020,KENTUCKY,GREENUP,4873,239,13064,18176,0.2681007922535211,0.71875,0.013149207746478873
2020,KENTUCKY,HANCOCK,1351,91,3145,4587,0.2945280139524744,0.6856333115325921,0.019838674514933506
2020,KENTUCKY,HARDIN,18101,1008,29832,48941,0.3698534970678981,0.6095502748207025,0.02059622811139944
2020,KENTUCKY,HARLAN,1494,110,9367,10971,0.1361771944216571,0.8537963722541245,0.010026433324218395
2020,KENTUCKY,HARRISON,2400,119,6334,8853,0.2710945442222975,0.7154636846266802,0.013441771151022252
2020,KENTUCKY,HART,1908,116,6345,8369,0.22798422750627315,0.758155096188314,0.013860676305412833
2020,KENTUCKY,HENDERSON,7639,319,12730,20688,0.3692478731631864,0.6153325599381284,0.015419566898685228
2020,KENTUCKY,HENRY,2142,122,5843,8107,0.26421610953496977,0.720735167139509,0.015048723325521155
2020,KENTUCKY,HICKMAN,458,27,1714,2199,0.20827648931332424,0.7794452023647113,0.01227830832196453
2020,KENTUCKY,HOPKINS,5439,313,15757,21509,0.25287089125482354,0.7325770607652611,0.014552047979915383
2020,KENTUCKY,JACKSON,605,55,5453,6113,0.09896940945525928,0.8920333715033535,0.008997219041387207
2020,KENTUCKY,JEFFERSON,228288,7186,150619,386093,0.5912772311334316,0.390110672817171,0.018612096049397425
2020,KENTUCKY,JESSAMINE,8567,588,17096,26251,0.3263494724010514,0.6512513808997753,0.022399146699173363
2020,KENTUCKY,JOHNSON,1608,134,8450,10192,0.1577708006279435,0.8290816326530612,0.01314756671899529
2020,KENTUCKY,KENTON,32265,1720,48123,82108,0.3929580552443124,0.5860939250742924,0.020948019681395237
2020,KENTUCKY,KNOTT,1412,60,4779,6251,0.22588385858262677,0.7645176771716525,0.009598464245720684
2020,KENTUCKY,KNOX,2114,147,11012,13273,0.159270699917125,0.8296541851879756,0.01107511489489942
2020,KENTUCKY,LARUE,1504,112,5685,7301,0.20599917819476785,0.7786604574715792,0.015340364333652923
2020,KENTUCKY,LAUREL,4474,389,23234,28097,0.1592340819304552,0.8269210235968253,0.013844894472719508
2020,KENTUCKY,LAWRENCE,1238,84,5633,6955,0.17800143781452193,0.809920920201294,0.01207764198418404
2020,KENTUCKY,LEE,459,41,2159,2659,0.17262128619781872,0.811959383226777,0.015419330575404287
2020,KENTUCKY,LESLIE,446,44,4321,4811,0.09270421949698607,0.8981500727499481,0.00914570775306589
2020,KENTUCKY,LETCHER,1799,110,7226,9135,0.19693486590038314,0.7910235358511221,0.0120415982484948
2020,KENTUCKY,LEWIS,823,74,4986,5883,0.1398946115927248,0.847526772055074,0.012578616352201259
2020,KENTUCKY,LINCOLN,2254,170,8489,10913,0.2065426555484285,0.7778795931457895,0.015577751305782095
2020,KENTUCKY,LIVINGSTON,939,54,4010,5003,0.18768738756745953,0.8015190885468719,0.010793523885668599
2020,KENTUCKY,LOGAN,3094,185,9067,12346,0.2506074842054107,0.7344079053944598,0.014984610400129597
2020,KENTUCKY,LYON,1092,36,3100,4228,0.2582781456953642,0.7332071901608326,0.008514664143803218
2020,KENTUCKY,MADISON,15580,970,27353,43903,0.3548732432863358,0.6230325945835137,0.022094162130150558
2020,KENTUCKY,MAGOFFIN,1213,59,4174,5446,0.22273228057289754,0.7664340800587587,0.010833639368343738
2020,KENTUCKY,MARION,2722,93,6113,8928,0.3048835125448029,0.6846998207885304,0.010416666666666666
2020,KENTUCKY,MARSHALL,4071,233,13297,17601,0.23129367649565366,0.7554684392932219,0.013237884211124368
2020,KENTUCKY,MARTIN,403,31,3496,3930,0.10254452926208651,0.8895674300254452,0.007888040712468193
2020,KENTUCKY,MASON,2362,119,5477,7958,0.29680824327720534,0.6882382508167881,0.014953505906006534
2020,KENTUCKY,MCCRACKEN,11190,511,21820,33521,0.33382059007786163,0.6509352346290385,0.015244175293099849
2020,KENTUCKY,MCCREARY,725,46,5664,6435,0.11266511266511267,0.8801864801864802,0.007148407148407148
2020,KENTUCKY,MCLEAN,1074,75,3633,4782,0.2245922208281054,0.759723964868256,0.015683814303638646
2020,KENTUCKY,MEADE,3632,294,10184,14110,0.25740609496810773,0.7217576187101347,0.02083628632175762
2020,KENTUCKY,MENIFEE,750,41,2311,3102,0.24177949709864605,0.745003223726628,0.013217279174725984
2020,KENTUCKY,MERCER,3033,196,8506,11735,0.2584576054537708,0.7248402215594376,0.01670217298679165
2020,KENTUCKY,METCALFE,975,78,3959,5012,0.19453312051077415,0.789904229848364,0.01556264964086193
2020,KENTUCKY,MONROE,657,45,4628,5330,0.12326454033771107,0.8682926829268293,0.008442776735459663
2020,KENTUCKY,MONTGOMERY,3630,214,8993,12837,0.2827763496143959,0.7005530887278959,0.016670561657708187
2020,KENTUCKY,MORGAN,1172,66,4297,5535,0.211743450767841,0.7763324299909665,0.011924119241192412
2020,KENTUCKY,MUHLENBERG,3544,189,10496,14229,0.24906880314849955,0.7376484644036826,0.013282732447817837
2020,KENTUCKY,NELSON,7188,354,15703,23245,0.3092277909227791,0.6755431275543128,0.015229081522908153
2020,KENTUCKY,NICHOLAS,955,33,2408,3396,0.28121319199057715,0.7090694935217904,0.009717314487632508
2020,KENTUCKY,OHIO,2404,141,8582,11127,0.21605104700278602,0.7712770737844882,0.012671879212725803
2020,KENTUCKY,OLDHAM,14504,781,22651,37936,0.3823281315900464,0.5970845634753269,0.02058730493462674
2020,KENTUCKY,OWEN,1098,66,4292,5456,0.20124633431085043,0.7866568914956011,0.012096774193548387
2020,KENTUCKY,OWSLEY,216,9,1670,1895,0.11398416886543536,0.8812664907651715,0.00474934036939314
2020,KENTUCKY,PENDLETON,1322,88,5515,6925,0.19090252707581226,0.7963898916967509,0.012707581227436824
2020,KENTUCKY,PERRY,2350,138,8118,10606,0.22157269470111257,0.7654158023760136,0.013011502922873844
2020,KENTUCKY,PIKE,4862,227,20279,25368,0.19165878271838538,0.79939293598234,0.008948281299274677
2020,KENTUCKY,POWELL,1367,97,4041,5505,0.2483197093551317,0.7340599455040872,0.017620345140781108
2020,KENTUCKY,PULASKI,5664,432,25441,31537,0.17959856676285,0.8067032374671022,0.01369819577004788
2020,KENTUCKY,ROBERTSON,253,9,884,1146,0.22076788830715532,0.7713787085514834,0.007853403141361256
2020,KENTUCKY,ROCKCASTLE,1134,72,6577,7783,0.14570217139920338,0.8450468970833869,0.009250931517409739
2020,KENTUCKY,ROWAN,3880,184,5994,10058,0.3857625770530921,0.5959435275402665,0.01829389540664148
2020,KENTUCKY,RUSSELL,1329,104,7506,8939,0.1486743483611142,0.839691240630943,0.011634411007942724
2020,KENTUCKY,SCOTT,10564,622,17764,28950,0.36490500863557856,0.6136096718480138,0.0214853195164076
2020,KENTUCKY,SHELBY,8076,412,15054,23542,0.3430464701384759,0.6394528927024042,0.01750063715911987
2020,KENTUCKY,SIMPSON,2681,163,5888,8732,0.3070316078790655,0.674301420064132,0.018666972056802567
2020,KENTUCKY,SPENCER,2530,162,8737,11429,0.22136669874879691,0.7644588327937702,0.014174468457432846
2020,KENTUCKY,TAYLOR,2961,173,9376,12510,0.23669064748201438,0.749480415667466,0.013828936850519584
2020,KENTUCKY,TODD,1202,89,4060,5351,0.22463091011025976,0.7587366847318259,0.01663240515791441
2020,KENTUCKY,TRIGG,1791,97,5487,7375,0.24284745762711865,0.744,0.013152542372881356
2020,KENTUCKY,TRIMBLE,1012,80,3227,4319,0.234313498495022,0.747163695299838,0.018522806205140078
2020,KENTUCKY,UNION,1529,82,4965,6576,0.23251216545012166,0.7550182481751825,0.012469586374695864
2020,KENTUCKY,WARREN,22477,1084,31790,55351,0.40608119094505973,0.5743347003667504,0.019584108688189914
2020,KENTUCKY,WASHINGTON,1644,97,4482,6223,0.26418126305640366,0.7202313996464728,0.015587337297123574
2020,KENTUCKY,WAYNE,1700,110,7430,9240,0.18398268398268397,0.8041125541125541,0.011904761904761904
2020,KENTUCKY,WEBSTER,1412,73,4506,5991,0.2356868636287765,0.7521281922884326,0.012184944082790854
2020,KENTUCKY,WHITLEY,2552,228,12567,15347,0.1662865706652766,0.8188571056232489,0.014856323711474556
2020,KENTUCKY,WOLFE,839,43,2097,2979,0.28163813360187984,0.7039274924471299,0.014434373950990266
2020,KENTUCKY,WOODFORD,6530,319,8362,15211,0.4292945894418513,0.5497337453158898,0.02097166524225889
2020,MARYLAND,ALLEGANY,9158,597,20886,30641,0.2988805848373095,0.6816357168499723,0.019483698312718255
2020,MARYLAND,ANNE ARUNDEL,172823,8973,127821,309617,0.5581831746964798,0.412835858496142,0.028980966807378147
2020,MARYLAND,BALTIMORE,258409,10321,146202,414932,0.6227743341077574,0.3523517106417437,0.024873955250498878
2020,MARYLAND,BALTIMORE CITY,207260,4827,25374,237461,0.8728170099511078,0.10685544152513465,0.020327548523757587
2020,MARYLAND,CALVERT,22587,1180,25346,49113,0.4598986011850223,0.5160751735792968,0.02402622523568098
2020,MARYLAND,CAROLINE,5095,416,10283,15794,0.3225908572875776,0.6510700265923769,0.026339116120045587
2020,MARYLAND,CARROLL,36456,3653,60218,100327,0.3633717742980454,0.6002172894634545,0.036410936238500106
2020,MARYLAND,CECIL,16809,1214,29439,47462,0.354157009818381,0.6202646327588387,0.02557835742278033
2020,MARYLAND,CHARLES,62171,1748,25579,89498,0.6946635679009587,0.2858052693914948,0.019531162707546536
2020,MARYLAND,DORCHESTER,6857,356,8764,15977,0.4291794454528385,0.5485385241284346,0.02228203041872692
2020,MARYLAND,FREDERICK,77675,4258,63682,145615,0.5334271881330906,0.43733131888885074,0.02924149297805858
2020,MARYLAND,GARRETT,3281,328,12002,15611,0.21017231439369674,0.7688168599064762,0.021010825699827044
2020,MARYLAND,HARFORD,63095,4161,80930,148186,0.4257824625808106,0.5461379617507727,0.02807957566841672
2020,MARYLAND,HOWARD,129433,5239,48390,183062,0.7070446078377818,0.26433667282122997,0.028618719340988297
2020,MARYLAND,KENT,5329,270,5195,10794,0.49370020381693536,0.48128589957383733,0.02501389660922735
2020,MARYLAND,MONTGOMERY,419569,12952,101222,533743,0.7860880611080614,0.18964557849002237,0.02426636040191628
2020,MARYLAND,PRINCE GEORGE'S,379208,8557,37090,424855,0.8925586376528463,0.08730037306845866,0.020140989278695086
2020,MARYLAND,QUEEN ANNE'S,10709,840,18741,30290,0.3535490260812149,0.6187190491911522,0.027731924727632883
2020,MARYLAND,SOMERSET,4241,167,5739,10147,0.4179560461220065,0.5655858874544201,0.01645806642357347
2020,MARYLAND,ST MARY'S,23138,1701,30826,55665,0.4156651396748406,0.553777059193389,0.030557801131770413
2020,MARYLAND,TALBOT,11062,547,10946,22555,0.49044557747727774,0.4853025936599424,0.02425182886277987
2020,MARYLAND,WASHINGTON,26044,1511,40224,67779,0.3842488086280411,0.5934581507546586,0.022293040617300343
2020,MARYLAND,WICOMICO,22054,1218,22944,46216,0.47719404535225896,0.496451445386879,0.02635450926086204
2020,MARYLAND,WORCESTER,12560,560,18571,31691,0.3963270329115522,0.5860023350478054,0.017670632040642453
2020,NORTH CAROLINA,ALAMANCE,38825,1210,46056,86091,0.4509762925276742,0.5349688120709482,0.014054895401377611
2020,NORTH CAROLINA,ALEXANDER,4145,203,15888,20236,0.2048329709428741,0.7851354022534097,0.01003162680371615
2020,NORTH CAROLINA,ALLEGHANY,1486,63,4527,6076,0.2445687952600395,0.7450625411454904,0.010368663594470046
2020,NORTH CAROLINA,ANSON,5789,84,5321,11194,0.5171520457387886,0.4753439342504913,0.007504020010720028
2020,NORTH CAROLINA,ASHE,4164,199,11451,15814,0.26331099026179333,0.7241052232199318,0.012583786518274947
2020,NORTH CAROLINA,AVERY,2191,95,7172,9458,0.23165574117149504,0.7582998519771622,0.010044406851342778
2020,NORTH CAROLINA,BEAUFORT,9633,245,16437,26315,0.36606498194945847,0.6246247387421623,0.009310279308379252
2020,NORTH CAROLINA,BERTIE,5939,59,3817,9815,0.6050942435048395,0.3888945491594498,0.006011207335710647
2020,NORTH CAROLINA,BLADEN,7326,123,9676,17125,0.4277956204379562,0.5650218978102189,0.007182481751824818
2020,NORTH CAROLINA,BRUNSWICK,33310,1015,55850,90175,0.3693928472414749,0.6193512614360965,0.01125589132242861
2020,NORTH CAROLINA,BUNCOMBE,96515,2642,62412,161569,0.5973608798717576,0.3862869733674158,0.016352146760826643
2020,NORTH CAROLINA,BURKE,13118,465,31019,44602,0.29411237164252724,0.6954620869019327,0.01042554145554011
2020,NORTH CAROLINA,CABARRUS,52162,1828,63237,117227,0.44496575021112883,0.539440572564341,0.015593677224530185
2020,NORTH CAROLINA,CALDWELL,10245,465,32119,42829,0.23920707931541713,0.7499357911695347,0.010857129515048214
2020,NORTH CAROLINA,CAMDEN,1537,104,4312,5953,0.2581891483285738,0.7243406685704686,0.0174701831009575
2020,NORTH CAROLINA,CARTERET,12093,574,30028,42695,0.283241597376742,0.7033142054104696,0.013444197212788382
2020,NORTH CAROLINA,CASWELL,4860,102,7089,12051,0.4032860343539955,0.5882499377645009,0.00846402788150361
2020,NORTH CAROLINA,CATAWBA,25689,1148,56588,83425,0.30792927779442614,0.6783098591549296,0.01376086305064429
2020,NORTH CAROLINA,CHATHAM,26787,626,21186,48599,0.5511841807444597,0.43593489577974853,0.012880923475791683
2020,NORTH CAROLINA,CHEROKEE,3583,212,12628,16423,0.2181696401388297,0.768921634293369,0.012908725567801255
2020,NORTH CAROLINA,CHOWAN,3247,66,4471,7784,0.4171377183967112,0.5743833504624871,0.008478931140801645
2020,NORTH CAROLINA,CLAY,1699,82,5112,6893,0.24648193819817205,0.7416219352966777,0.011896126505150153
2020,NORTH CAROLINA,CLEVELAND,16955,555,33798,51308,0.33045528962345055,0.6587276837920012,0.01081702658454822
2020,NORTH CAROLINA,COLUMBUS,9446,168,16832,26446,0.35718067004461923,0.6364667624593511,0.006352567496029645
2020,NORTH CAROLINA,CRAVEN,21148,885,31032,53065,0.39853010458871196,0.5847922359370583,0.01667765947422972
2020,NORTH CAROLINA,CUMBERLAND,84469,2649,60032,147150,0.5740332993544003,0.40796466190961606,0.01800203873598369
2020,NORTH CAROLINA,CURRITUCK,4195,295,11657,16147,0.2598005821514833,0.7219297702359572,0.018269647612559607
2020,NORTH CAROLINA,DARE,9936,358,13938,24232,0.41003631561571474,0.5751898316275998,0.014773852756685375
2020,NORTH CAROLINA,DAVIDSON,22636,1220,64658,88514,0.25573355627358385,0.7304833133741555,0.01378313035226066
2020,NORTH CAROLINA,DAVIE,6713,370,18228,25311,0.26522065505116355,0.7201611947374659,0.014618150211370551
2020,NORTH CAROLINA,DUPLIN,8767,155,13793,22715,0.38595641646489104,0.6072198987453225,0.0068236847897864845
2020,NORTH CAROLINA,DURHAM,144688,2767,32459,179914,0.804206454194782,0.1804139755661038,0.015379570239114243
2020,NORTH CAROLINA,EDGECOMBE,16089,182,9206,25477,0.6315107744239903,0.36134552733838365,0.0071436982376260946
2020,NORTH CAROLINA,FORSYTH,113033,3173,85064,201270,0.561598847319521,0.4226362597505838,0.015764892929895167
2020,NORTH CAROLINA,FRANKLIN,15879,571,20901,37351,0.42512917994163474,0.5595834114213809,0.015287408636984284
2020,NORTH CAROLINA,GASTON,40959,1506,73033,115498,0.3546295173942406,0.6323312957800135,0.0130391868257459
2020,NORTH CAROLINA,GATES,2546,58,3367,5971,0.426394238820968,0.5638921453692849,0.009713615809747111
2020,NORTH CAROLINA,GRAHAM,905,50,3710,4665,0.1939978563772776,0.7952840300107181,0.010718113612004287
2020,NORTH CAROLINA,GRANVILLE,14565,386,16647,31598,0.4609468953731249,0.52683714159124,0.012215963035635167
2020,NORTH CAROLINA,GREENE,3832,47,4874,8753,0.4377927567691077,0.5568376556609163,0.0053695875699760085
2020,NORTH CAROLINA,GUILFORD,173086,4106,107294,284486,0.6084165828898435,0.3771503694382149,0.014433047671941677
2020,NORTH CAROLINA,HALIFAX,15545,134,10080,25759,0.6034783959004619,0.3913195388019721,0.0052020652975658995
2020,NORTH CAROLINA,HARNETT,22093,1023,35177,58293,0.37899919372823493,0.6034515293431458,0.017549276928619215
2020,NORTH CAROLINA,HAYWOOD,13144,564,22834,36542,0.3596956926276613,0.6248700125882546,0.015434294784084068
2020,NORTH CAROLINA,HENDERSON,27211,1128,40032,68371,0.39799037603662374,0.5855114010326016,0.016498222930774745
2020,NORTH CAROLINA,HERTFORD,7097,58,3479,10634,0.6673876246003385,0.3271581719014482,0.005454203498213278
2020,NORTH CAROLINA,HOKE,11804,382,9453,21639,0.5454965571421969,0.4368501317066408,0.017653311151162254
2020,NORTH CAROLINA,HYDE,1046,28,1418,2492,0.41974317817014445,0.5690208667736758,0.011235955056179775
2020,NORTH CAROLINA,IREDELL,33888,1473,67010,102371,0.3310312490842133,0.6545799103261666,0.014388840589620108
2020,NORTH CAROLINA,JACKSON,9591,481,11356,21428,0.44759193578495426,0.5299607989546388,0.022447265260406944
2020,NORTH CAROLINA,JOHNSTON,41257,1747,68353,111357,0.37049309877241665,0.6138186193952783,0.01568828183230511
2020,NORTH CAROLINA,JONES,2197,48,3280,5525,0.3976470588235294,0.5936651583710407,0.008687782805429865
2020,NORTH CAROLINA,LEE,12143,396,16469,29008,0.41860865968008826,0.5677399338113623,0.013651406508549365
2020,NORTH CAROLINA,LENOIR,13605,214,14590,28409,0.4788975324721039,0.5135696434228589,0.007532824105037136
2020,NORTH CAROLINA,LINCOLN,13274,602,36341,50217,0.26433279566680606,0.7236792321325447,0.011987972200649183
2020,NORTH CAROLINA,MACON,6230,302,14211,20743,0.3003422841440486,0.6850985874752928,0.014559128380658535
2020,NORTH CAROLINA,MADISON,4901,196,7979,13076,0.3748088100336494,0.6102018966044662,0.014989293361884369
2020,NORTH CAROLINA,MARTIN,5911,97,6532,12540,0.47137161084529505,0.5208931419457735,0.00773524720893142
2020,NORTH CAROLINA,MCDOWELL,5832,288,16883,23003,0.2535321479806982,0.733947745946181,0.012520106073120898
2020,NORTH CAROLINA,MECKLENBURG,378107,9735,179211,567053,0.6667930510904625,0.3160392414818368,0.01716770742770076
2020,NORTH CAROLINA,MITCHELL,1867,84,7090,9041,0.2065037053423294,0.7842052870257715,0.009291007631899125
2020,NORTH CAROLINA,MONTGOMERY,4327,111,8411,12849,0.33675772433652423,0.6546034710872441,0.008638804576231613
2020,NORTH CAROLINA,MOORE,20779,796,36764,58339,0.35617682853665644,0.6301787826325442,0.013644388830799294
2020,NORTH CAROLINA,NASH,25947,497,25827,52271,0.4963937938818848,0.4940980658491324,0.009508140268982801
2020,NORTH CAROLINA,NEW HANOVER,66138,2361,63331,131830,0.5016915724797087,0.48039899871046043,0.017909428809830843
2020,NORTH CAROLINA,NORTHAMPTON,6069,52,3989,10110,0.6002967359050445,0.3945598417408506,0.005143422354104847
2020,NORTH CAROLINA,ONSLOW,24266,1891,46078,72235,0.33593133522530627,0.6378902194227175,0.02617844535197619
2020,NORTH CAROLINA,ORANGE,63594,1227,20176,84997,0.7481911126275045,0.23737308375589727,0.014435803616598233
2020,NORTH CAROLINA,PAMLICO,2713,69,4849,7631,0.3555235224741187,0.6354344122657581,0.009042065260123182
2020,NORTH CAROLINA,PASQUOTANK,9832,295,9770,19897,0.4941448459566769,0.4910287983113032,0.014826355732019902
2020,NORTH CAROLINA,PENDER,11723,490,21956,34169,0.3430887646697299,0.6425707512657672,0.014340484064502912
2020,NORTH CAROLINA,PERQUIMANS,2492,89,4903,7484,0.33297701763762694,0.6551309460181721,0.011892036344200963
2020,NORTH CAROLINA,PERSON,8465,245,13184,21894,0.386635607929113,0.6021741116287568,0.011190280442130263
2020,NORTH CAROLINA,PITT,47252,1339,38982,87573,0.5395726993479726,0.4451371998218629,0.015290100830164549
2020,NORTH CAROLINA,POLK,4518,151,7689,12358,0.36559313804822785,0.6221880563197928,0.012218805631979284
2020,NORTH CAROLINA,RANDOLPH,15618,804,56894,73316,0.21302307818211577,0.7760106934366304,0.01096622838125375
2020,NORTH CAROLINA,RICHMOND,8754,179,11830,20763,0.4216153735009392,0.5697635216490873,0.008621104849973511
2020,NORTH CAROLINA,ROBESON,19020,362,27806,47188,0.4030685767568026,0.589259981351191,0.007671441892006442
2020,NORTH CAROLINA,ROCKINGHAM,15992,516,31301,47809,0.33449768871969715,0.6547093643456253,0.010792946934677571
2020,NORTH CAROLINA,ROWAN,23114,997,49297,73408,0.31487031386224934,0.6715480601569311,0.01358162598081953
2020,NORTH CAROLINA,RUTHERFORD,9135,403,24891,34429,0.2653286473612362,0.7229661041563797,0.011705248482384037
2020,NORTH CAROLINA,SAMPSON,10966,241,17411,28618,0.38318540778530996,0.608393318890209,0.008421273324481096
2020,NORTH CAROLINA,SCOTLAND,7186,116,7473,14775,0.48636209813874787,0.5057868020304569,0.007851099830795263
2020,NORTH CAROLINA,STANLY,8129,352,25458,33939,0.23951795869059195,0.7501104923539291,0.010371548955478947
2020,NORTH CAROLINA,STOKES,5286,273,20142,25701,0.2056729310143574,0.7837049142056729,0.010622154779969651
2020,NORTH CAROLINA,SURRY,8721,379,27538,36638,0.2380315519406081,0.7516239969430646,0.01034445111632731
2020,NORTH CAROLINA,SWAIN,2780,127,4161,7068,0.39332201471420486,0.5887096774193549,0.017968307866440294
2020,NORTH CAROLINA,TRANSYLVANIA,8444,324,11636,20404,0.41384042344638305,0.5702803371887865,0.015879239364830426
2020,NORTH CAROLINA,TYRRELL,758,15,1044,1817,0.4171711612548156,0.5745734727572922,0.00825536598789213
2020,NORTH CAROLINA,UNION,48725,1904,80382,131011,0.37191533535351995,0.6135515338406698,0.0145331308058102
2020,NORTH CAROLINA,VANCE,12431,177,8391,20999,0.5919805705033573,0.39959045668841375,0.008428972808228963
2020,NORTH CAROLINA,WAKE,393336,12297,226197,631830,0.6225345425193486,0.35800294382982767,0.0194625136508238
2020,NORTH CAROLINA,WARREN,6400,141,3752,10293,0.6217817934518605,0.36451957641115323,0.0136986301369863
2020,NORTH CAROLINA,WASHINGTON,3396,28,2781,6205,0.547300564061241,0.44818694601128123,0.004512489927477841
2020,NORTH CAROLINA,WATAUGA,17122,647,14451,32220,0.5314090626939789,0.4485102420856611,0.020080695220360024
2020,NORTH CAROLINA,WAYNE,24215,613,30709,55537,0.4360156292201595,0.5529466841925204,0.011037686587320164
2020,NORTH CAROLINA,WILKES,7511,363,27592,35466,0.21178029662211695,0.7779845485817403,0.010235154796142785
2020,NORTH CAROLINA,WILSON,20754,400,19581,40735,0.5094881551491347,0.48069227936663805,0.009819565484227324
2020,NORTH CAROLINA,YADKIN,3763,227,15933,19923,0.18887717713195804,0.7997289564824575,0.0113938663855845
2020,NORTH CAROLINA,YANCEY,3688,148,7516,11352,0.324876673713883,0.6620859760394644,0.013037350246652573
2020,OKLAHOMA,ADAIR,1387,136,5585,7108,0.19513224535734383,0.7857343837929094,0.019133370849746763
2020,OKLAHOMA,ALFALFA,232,52,1978,2262,0.10256410256410256,0.874447391688771,0.022988505747126436
2020,OKLAHOMA,ATOKA,765,67,4557,5389,0.14195583596214512,0.8456114306921507,0.012432733345704213
2020,OKLAHOMA,BEAVER,190,20,1968,2178,0.08723599632690542,0.9035812672176309,0.009182736455463728
2020,OKLAHOMA,BECKHAM,1048,133,6767,7948,0.1318570709612481,0.8514091595369905,0.01673376950176145
2020,OKLAHOMA,BLAINE,688,77,3136,3901,0.17636503460651115,0.803896436811074,0.019738528582414764
2020,OKLAHOMA,BRYAN,3323,309,12344,15976,0.20799949924887332,0.7726589884827241,0.019341512268402604
2020,OKLAHOMA,CADDO,2670,176,7013,9859,0.2708185414342225,0.7113297494674916,0.01785170909828583
2020,OKLAHOMA,CANADIAN,16742,1648,43550,61940,0.2702938327413626,0.7030997739748144,0.026606393283823054
2020,OKLAHOMA,CARTER,4470,310,14699,19479,0.22947789927614354,0.7546075260536989,0.015914574670157607
2020,OKLAHOMA,CHEROKEE,6027,464,11223,17714,0.34023935869933386,0.6335666704301682,0.02619397087049791
2020,OKLAHOMA,CHOCTAW,1082,52,4698,5832,0.1855281207133059,0.8055555555555556,0.008916323731138546
2020,OKLAHOMA,CIMARRON,70,14,970,1054,0.06641366223908918,0.920303605313093,0.013282732447817837
2020,OKLAHOMA,CLEVELAND,49827,3274,66677,119778,0.41599458999148425,0.5566715089582394,0.027333901050276343
2020,OKLAHOMA,COAL,374,59,2091,2524,0.14817749603803487,0.8284469096671949,0.023375594294770204
2020,OKLAHOMA,COMANCHE,13747,979,20905,35631,0.38581572226432037,0.5867082035306335,0.027476074205046167
2020,OKLAHOMA,COTTON,393,62,2117,2572,0.15279937791601866,0.823094867807154,0.02410575427682737
2020,OKLAHOMA,CRAIG,1217,129,4686,6032,0.20175729442970822,0.7768567639257294,0.021385941644562333
2020,OKLAHOMA,CREEK,6577,634,23294,30505,0.21560399934436977,0.763612522537289,0.020783478118341255
2020,OKLAHOMA,CUSTER,2369,262,8060,10691,0.22158825180057992,0.7539051538677393,0.024506594331680853
2020,OKLAHOMA,DELAWARE,3472,216,13557,17245,0.20133371991881704,0.7861409104088142,0.012525369672368803
2020,OKLAHOMA,DEWEY,214,21,2124,2359,0.0907164052564646,0.9003815175922001,0.008902077151335312
2020,OKLAHOMA,ELLIS,162,23,1688,1873,0.08649225840896957,0.9012279765082755,0.012279765082754938
2020,OKLAHOMA,GARFIELD,4919,541,16970,22430,0.2193045028979046,0.7565760142666073,0.024119482835488187
2020,OKLAHOMA,GARVIN,1865,179,8878,10922,0.17075627174510163,0.8128547885002747,0.016388939754623695
2020,OKLAHOMA,GRADY,4144,419,18538,23101,0.17938617375871174,0.8024760832864378,0.01813774295485044
2020,OKLAHOMA,GRANT,280,30,1916,2226,0.12578616352201258,0.8607367475292004,0.013477088948787063
2020,OKLAHOMA,GREER,328,40,1605,1973,0.16624429802331475,0.8134820070957932,0.02027369488089204
2020,OKLAHOMA,HARMON,177,9,747,933,0.18971061093247588,0.8006430868167203,0.00964630225080386
2020,OKLAHOMA,HARPER,136,24,1327,1487,0.09145931405514458,0.8924008069939475,0.01613987895090787
2020,OKLAHOMA,HASKELL,783,66,4165,5014,0.15616274431591542,0.8306741124850419,0.01316314319904268
2020,OKLAHOMA,HUGHES,919,63,3875,4857,0.18921144739551163,0.7978175828700844,0.012970969734403953
2020,OKLAHOMA,JACKSON,1646,183,6392,8221,0.2002189514657584,0.7775209828488019,0.02226006568543973
2020,OKLAHOMA,JEFFERSON,319,40,2026,2385,0.13375262054507336,0.8494758909853249,0.016771488469601678
2020,OKLAHOMA,JOHNSTON,738,72,3441,4251,0.17360621030345802,0.8094565984474241,0.016937191249117856
2020,OKLAHOMA,KAY,4040,375,12834,17249,0.23421647631746767,0.7440431329352426,0.021740390747289697
2020,OKLAHOMA,KINGFISHER,854,90,5521,6465,0.13209590100541377,0.8539829853054911,0.013921113689095127
2020,OKLAHOMA,KIOWA,699,55,2673,3427,0.2039684855558798,0.7799824919754887,0.016049022468631456
2020,OKLAHOMA,LATIMER,762,50,3437,4249,0.179336314426924,0.8088962108731467,0.011767474699929396
2020,OKLAHOMA,LE FLORE,3299,293,15213,18805,0.1754320659399096,0.8089869715501197,0.015580962509970752
2020,OKLAHOMA,LINCOLN,2609,266,12013,14888,0.17524180548092425,0.8068914562063407,0.017866738312735088
2020,OKLAHOMA,LOGAN,5455,511,15608,21574,0.2528506535644758,0.7234634282006118,0.023685918234912395
2020,OKLAHOMA,LOVE,711,60,3305,4076,0.17443572129538765,0.8108439646712463,0.014720314033366046
2020,OKLAHOMA,MAJOR,320,63,3084,3467,0.0922988174214018,0.8895298528987597,0.018171329679838477
2020,OKLAHOMA,MARSHALL,1100,73,4891,6064,0.18139841688654354,0.8065633245382586,0.012038258575197889
2020,OKLAHOMA,MAYES,3581,296,12749,16626,0.21538554071935523,0.766811018886082,0.017803440394562733
2020,OKLAHOMA,MCCLAIN,3582,359,15295,19236,0.18621334996880848,0.7951237263464338,0.018662923684757745
2020,OKLAHOMA,MCCURTAIN,1858,124,9485,11467,0.16203017354146682,0.8271561873201361,0.010813639138397139
2020,OKLAHOMA,MCINTOSH,2031,132,6172,8335,0.24367126574685063,0.740491901619676,0.015836832633473304
2020,OKLAHOMA,MURRAY,1156,126,4612,5894,0.19613165931455717,0.7824906684764167,0.021377672209026127
2020,OKLAHOMA,MUSKOGEE,8027,528,16526,25081,0.32004306048403175,0.6589051473226746,0.021051792193293728
2020,OKLAHOMA,NOBLE,1003,114,3821,4938,0.20311867152693397,0.7737950587282301,0.023086269744835967
2020,OKLAHOMA,NOWATA,712,69,3610,4391,0.1621498519699385,0.8221361876565703,0.015713960373491234
2020,OKLAHOMA,OKFUSKEE,896,84,3058,4038,0.2218920257553244,0.7573055968301139,0.020802377414561663
2020,OKLAHOMA,OKLAHOMA,141724,7966,145050,294740,0.480844133812852,0.4921286557644025,0.02702721042274547
2020,OKLAHOMA,OKMULGEE,4357,288,9668,14313,0.30440857961293927,0.6754698525815692,0.02012156780549151
2020,OKLAHOMA,OSAGE,6002,415,14121,20538,0.2922387769013536,0.6875547765118317,0.020206446586814687
2020,OKLAHOMA,OTTAWA,2686,207,8545,11438,0.2348312642070292,0.7470711662878126,0.018097569505158246
2020,OKLAHOMA,PAWNEE,1363,156,5267,6786,0.20085470085470086,0.7761567933981727,0.022988505747126436
2020,OKLAHOMA,PAYNE,10904,926,17813,29643,0.3678440103903114,0.6009175859393449,0.031238403670343758
2020,OKLAHOMA,PITTSBURG,3768,305,13851,17924,0.21022093282749385,0.7727627761660344,0.01701629100647177
2020,OKLAHOMA,PONTOTOC,4117,398,10805,15320,0.268733681462141,0.7052872062663186,0.02597911227154047
2020,OKLAHOMA,POTTAWATOMIE,7275,670,20240,28185,0.2581160191591272,0.7181124711726096,0.02377150966826326
2020,OKLAHOMA,PUSHMATAHA,668,55,4016,4739,0.1409580080185693,0.8474361679679258,0.011605824013504958
2020,OKLAHOMA,ROGER MILLS,168,37,1629,1834,0.0916030534351145,0.8882224645583424,0.020174482006543076
2020,OKLAHOMA,ROGERS,9589,933,34031,44553,0.21522680852018944,0.7638318407290193,0.020941350750791194
2020,OKLAHOMA,SEMINOLE,2150,176,6011,8337,0.2578865299268322,0.7210027587861341,0.021110711287033707
2020,OKLAHOMA,SEQUOYAH,3035,238,12113,15386,0.1972572468477837,0.7872741453269205,0.015468607825295723
2020,OKLAHOMA,STEPHENS,3154,343,15560,19057,0.16550348953140578,0.8164978747966627,0.017998635671931575
2020,OKLAHOMA,TEXAS,894,122,4505,5521,0.16192718710378554,0.8159753667813802,0.02209744611483427
2020,OKLAHOMA,TILLMAN,597,35,2076,2708,0.22045790251107827,0.7666174298375185,0.01292466765140325
2020,OKLAHOMA,TULSA,108996,7108,150574,266678,0.4087176295007462,0.5646285032886103,0.02665386721064355
2020,OKLAHOMA,WAGONER,8464,709,26165,35338,0.23951553568396627,0.7404210764615994,0.02006338785443432
2020,OKLAHOMA,WASHINGTON,5790,635,17076,23501,0.24637249478745585,0.7266073784094293,0.02702012680311476
2020,OKLAHOMA,WASHITA,598,93,4086,4777,0.12518316935315052,0.855348545111995,0.01946828553485451
2020,OKLAHOMA,WOODS,591,94,2993,3678,0.16068515497553018,0.813757476889614,0.0255573681348559
2020,OKLAHOMA,WOODWARD,1005,169,6611,7785,0.12909441233140656,0.8491971740526654,0.02170841361592807
2020,SOUTH CAROLINA,ABBEVILLE,4101,117,8215,12433,0.3298479852006756,0.6607415748411486,0.009410439958175823
2020,SOUTH CAROLINA,AIKEN,32275,1321,51589,85185,0.37888125843751835,0.6056113165463404,0.01550742501614134
2020,SOUTH CAROLINA,ALLENDALE,2718,40,835,3593,0.7564709156693571,0.23239632618981354,0.011132758140829391
2020,SOUTH CAROLINA,ANDERSON,27169,1359,67565,96093,0.28273651566711416,0.7031209349276222,0.014142549405263652
2020,SOUTH CAROLINA,BAMBERG,4010,55,2417,6482,0.6186362233878433,0.3728787411292811,0.008485035482875656
2020,SOUTH CAROLINA,BARNWELL,4720,109,5492,10321,0.45732002712915415,0.5321189807189226,0.010560992151923264
2020,SOUTH CAROLINA,BEAUFORT,43419,1222,53194,97835,0.4437982317166658,0.5437113507435989,0.012490417539735269
2020,SOUTH CAROLINA,BERKELEY,45223,1838,57397,104458,0.4329299814279423,0.5494744299144153,0.017595588657642307
2020,SOUTH CAROLINA,CALHOUN,3905,81,4305,8291,0.4709926426245326,0.519237727656495,0.00976962971897238
2020,SOUTH CAROLINA,CHARLESTON,121485,4075,93297,218857,0.5550884824337353,0.42629205371543977,0.01861946385082497
2020,SOUTH CAROLINA,CHEROKEE,6983,244,18043,25270,0.27633557578155915,0.714008705975465,0.00965571824297586
2020,SOUTH CAROLINA,CHESTER,6941,156,8660,15757,0.4405026337500793,0.5495970045059339,0.0099003617439868
2020,SOUTH CAROLINA,CHESTERFIELD,7431,148,11297,18876,0.39367450731087095,0.5984848484848485,0.007840644204280567
2020,SOUTH CAROLINA,CLARENDON,8250,122,8361,16733,0.49303770991454016,0.4996713081933903,0.007290981892069563
2020,SOUTH CAROLINA,COLLETON,8602,241,10440,19283,0.44609241300627495,0.5414095317118706,0.012498055281854483
2020,SOUTH CAROLINA,DARLINGTON,15220,365,16832,32417,0.46950674029058825,0.5192337353857543,0.01125952432365734
2020,SOUTH CAROLINA,DILLON,6436,83,6582,13101,0.49126020914434015,0.5024043966109457,0.006335394244714144
2020,SOUTH CAROLINA,DORCHESTER,33824,1541,41913,77278,0.43769248686560214,0.5423665208726934,0.019940992261704496
2020,SOUTH CAROLINA,EDGEFIELD,4953,167,8184,13304,0.372294046903187,0.6151533373421527,0.012552615754660252
2020,SOUTH CAROLINA,FAIRFIELD,7382,129,4625,12136,0.6082729070533949,0.38109756097560976,0.010629531970995386
2020,SOUTH CAROLINA,FLORENCE,31153,742,32615,64510,0.48291737715082933,0.5055805301503643,0.011502092698806386
2020,SOUTH CAROLINA,GEORGETOWN,15822,359,20487,36668,0.4314934002399913,0.5587160466892113,0.009790553070797426
2020,SOUTH CAROLINA,GREENVILLE,103030,5104,150021,258155,0.3991013151013926,0.5811276171292441,0.019771067769363368
2020,SOUTH CAROLINA,GREENWOOD,12145,430,19431,32006,0.3794601012310192,0.6071049178279073,0.013434980941073548
2020,SOUTH CAROLINA,HAMPTON,5323,76,3906,9305,0.5720580333154218,0.4197743148844707,0.00816765180010747
2020,SOUTH CAROLINA,HORRY,59180,1743,118821,179744,0.3292460388107531,0.6610568363895318,0.00969712479971515
2020,SOUTH CAROLINA,JASPER,7185,131,7078,14394,0.4991663192997082,0.4917326663887731,0.009101014311518689
2020,SOUTH CAROLINA,KERSHAW,12699,459,20471,33629,0.3776205061107972,0.6087305599333909,0.013648933955811947
2020,SOUTH CAROLINA,LANCASTER,18937,619,30312,49868,0.37974252025346916,0.607844710034491,0.012412769712039785
2020,SOUTH CAROLINA,LAURENS,10159,325,20004,30488,0.3332130674363684,0.656127000787195,0.010659931776436631
2020,SOUTH CAROLINA,LEE,5329,94,3008,8431,0.6320721148143755,0.35677855533151465,0.011149329854109833
2020,SOUTH CAROLINA,LEXINGTON,49301,2450,92817,144568,0.34102290963422055,0.6420300481434342,0.016947042222345193
2020,SOUTH CAROLINA,MARION,8872,121,5711,14704,0.6033732317736671,0.3883977149075082,0.00822905331882481
2020,SOUTH CAROLINA,MARLBORO,6290,112,5044,11446,0.5495369561418836,0.4406779661016949,0.009785077756421458
2020,SOUTH CAROLINA,MCCORMICK,2687,52,2958,5697,0.47165174653326314,0.5192206424433913,0.009127611023345621
2020,SOUTH CAROLINA,NEWBERRY,6958,230,11443,18631,0.37346358220170683,0.614191401427728,0.012345016370565186
2020,SOUTH CAROLINA,OCONEE,10414,556,29698,40668,0.2560735713583161,0.7302547457460411,0.013671682895642766
2020,SOUTH CAROLINA,ORANGEBURG,27295,307,13603,41205,0.6624196092707195,0.33012983861181894,0.007450552117461473
2020,SOUTH CAROLINA,PICKENS,13645,994,42907,57546,0.237114656101206,0.7456122058874639,0.017273138011330066
2020,SOUTH CAROLINA,RICHLAND,132570,2939,58313,193822,0.6839780829833558,0.3008585196726894,0.015163397343954763
2020,SOUTH CAROLINA,SALUDA,2963,101,6210,9274,0.31949536338149664,0.6696139745525124,0.010890662065990942
2020,SOUTH CAROLINA,SPARTANBURG,52926,2169,93560,148655,0.3560324240691534,0.6293767448118126,0.014590831119034005
2020,SOUTH CAROLINA,SUMTER,27379,541,21000,48920,0.5596688470973017,0.42927228127555195,0.011058871627146362
2020,SOUTH CAROLINA,UNION,4935,139,8183,13257,0.3722561665535189,0.6172588066681753,0.010485026778305801
2020,SOUTH CAROLINA,WILLIAMSBURG,10289,164,5532,15985,0.6436659368157648,0.3460744447919925,0.010259618392242728
2020,SOUTH CAROLINA,YORK,59008,2315,82727,144050,0.40963554321416173,0.5742936480388754,0.01607080874696286
2020,UTAH,SALT LAKE,289906,26501,230174,546581,0.5303989710582695,0.4211159919572762,0.04848503698445427
2020,VIRGINIA,ACCOMACK,7578,212,9172,16962,0.4467633533781394,0.5407381205046574,0.01249852611720316
2020,VIRGINIA,ALBEMARLE,42466,1387,20804,64657,0.6567889014337195,0.321759438266545,0.02145166029973553
2020,VIRGINIA,ALEXANDRIA CITY,66240,1737,14544,82521,0.8027047660595484,0.17624604646090086,0.02104918747955066
2020,VIRGINIA,ALLEGHANY,2243,101,5859,8203,0.27343654760453495,0.7142508838229916,0.012312568572473485
2020,VIRGINIA,AMELIA,2411,93,5390,7894,0.30542183937167466,0.6827970610590322,0.011781099569293133
2020,VIRGINIA,AMHERST,5672,292,11041,17005,0.3335489561893561,0.6492796236401058,0.017171420170538076
2020,VIRGINIA,APPOMATTOX,2418,148,6702,9268,0.26089771255934396,0.7231333621061717,0.015968925334484248
2020,VIRGINIA,ARLINGTON,105344,3077,22318,130739,0.8057580370050252,0.17070652215482757,0.023535440840147165
2020,VIRGINIA,AUGUSTA,10840,724,30714,42278,0.2563981266852737,0.7264771275840863,0.01712474573064005
2020,VIRGINIA,BATH,646,21,1834,2501,0.258296681327469,0.7333066773290684,0.008396641343462616
2020,VIRGINIA,BEDFORD,12176,893,35600,48669,0.250179785900676,0.7314717787503339,0.018348435348990118
2020,VIRGINIA,BLAND,532,44,2903,3479,0.1529175050301811,0.8344351825237137,0.012647312446105202
2020,VIRGINIA,BOTETOURT,5700,324,15099,21123,0.2698480329498651,0.7148132367561426,0.01533873029399233
2020,VIRGINIA,BRISTOL CITY,2313,154,5347,7814,0.29600716662400817,0.6842846173534681,0.019708216022523675
2020,VIRGINIA,BRUNSWICK,4552,39,3357,7948,0.5727226975339708,0.4223704076497232,0.004906894816305989
2020,VIRGINIA,BUCHANAN,1587,59,8311,9957,0.15938535703525158,0.8346891634026313,0.005925479562117104
2020,VIRGINIA,BUCKINGHAM,3471,114,4544,8129,0.4269897896420224,0.5589863451839094,0.01402386517406815
2020,VIRGINIA,BUENA VISTA CITY,825,88,1863,2776,0.29719020172910665,0.6711095100864554,0.03170028818443804
2020,VIRGINIA,CAMPBELL,8070,586,21245,29901,0.2698906391090599,0.7105113541353132,0.019598006755626902
2020,VIRGINIA,CAROLINE,7657,295,8336,16288,0.4701006876227898,0.5117878192534381,0.018111493123772103
2020,VIRGINIA,CARROLL,2842,156,12659,15657,0.1815162547103532,0.8085201507313023,0.00996359455834451
2020,VIRGINIA,CHARLES CITY,2624,56,1761,4441,0.5908579148840352,0.3965323125422202,0.012609772573744652
2020,VIRGINIA,CHARLOTTE,2317,59,3815,6191,0.3742529478274915,0.6162170893232111,0.009529962849297368
2020,VIRGINIA,CHARLOTTESVILLE CITY,20696,423,3094,24213,0.8547474497170942,0.127782596126048,0.017469954156857887
2020,VIRGINIA,CHESAPEAKE CITY,66377,2689,58180,127246,0.5216431164830329,0.4572245885921758,0.02113229492479135
2020,VIRGINIA,CHESTERFIELD,106935,3694,93326,203955,0.5243068323894977,0.4575813292147778,0.01811183839572455
2020,VIRGINIA,CLARKE,3920,225,5192,9337,0.419835064795973,0.5560672592909929,0.024097675913034165
2020,VIRGINIA,COLONIAL HEIGHTS CITY,2972,181,6007,9160,0.32445414847161574,0.6557860262008733,0.019759825327510916
2020,VIRGINIA,COVINGTON CITY,964,59,1580,2603,0.37034191317710335,0.6069919323857088,0.02266615443718786
2020,VIRGINIA,CRAIG,587,47,2536,3170,0.18517350157728707,0.8,0.014826498422712935
2020,VIRGINIA,CULPEPER,10617,487,16012,27116,0.39154005015489013,0.5905000737571914,0.01795987608791857
2020,VIRGINIA,CUMBERLAND,2227,67,3019,5313,0.4191605495953322,0.5682288725766986,0.012610577827969132
2020,VIRGINIA,DANVILLE CITY,11710,318,7428,19456,0.6018708881578947,0.38178453947368424,0.016344572368421052
2020,VIRGINIA,DICKENSON,1503,56,5748,7307,0.20569317093198303,0.7866429451211168,0.0076638839469002325
2020,VIRGINIA,DINWIDDIE,6224,173,8695,15092,0.41240392260800424,0.5761330506228466,0.011463026769149218
2020,VIRGINIA,EMPORIA CITY,1612,18,754,2384,0.6761744966442953,0.3162751677852349,0.007550335570469799
2020,VIRGINIA,ESSEX,3038,65,3075,6178,0.4917449012625445,0.4977338944642279,0.010521204273227582
2020,VIRGINIA,FAIRFAX,419943,12899,168401,601243,0.6984580277857705,0.2800880841855955,0.021453888028634013
2020,VIRGINIA,FAIRFAX CITY,9174,306,4007,13487,0.6802105731445095,0.29710091198932304,0.02268851486616742
2020,VIRGINIA,FALLS CHURCH CITY,7146,183,1490,8819,0.8102959519219867,0.1689533960766527,0.020750652001360698
2020,VIRGINIA,FAUQUIER,17565,1000,25106,43671,0.40221199422958026,0.5748895147809759,0.022898490989443795
2020,VIRGINIA,FLOYD,3004,183,6225,9412,0.3191670208244794,0.6613897152571185,0.01944326391840204
2020,VIRGINIA,FLUVANNA,7414,277,8155,15846,0.4678783289158147,0.5146409188438723,0.01748075224031301
2020,VIRGINIA,FRANKLIN,8381,428,20895,29704,0.2821505521141934,0.7034406140587126,0.014408833827093993
2020,VIRGINIA,FRANKLIN CITY,2525,52,1487,4064,0.6213090551181102,0.3658956692913386,0.012795275590551181
2020,VIRGINIA,FREDERICK,17207,953,30558,48718,0.35319594400426946,0.6272424976394761,0.019561558356254363
2020,VIRGINIA,FREDERICKSBURG CITY,8517,323,4037,12877,0.6614118195231808,0.31350469829929334,0.02508348217752582
2020,VIRGINIA,GALAX CITY,777,24,1838,2639,0.29442970822281167,0.6964759378552482,0.00909435392194013
2020,VIRGINIA,GILES,2156,146,6876,9178,0.23490956635432556,0.7491828285029418,0.015907605142732623
2020,VIRGINIA,GLOUCESTER,6964,445,14875,22284,0.31251121881170346,0.6675192963561299,0.019969484832166578
2020,VIRGINIA,GOOCHLAND,6685,301,9966,16952,0.3943487494100991,0.587895233600755,0.017756016989145824
2020,VIRGINIA,GRAYSON,1535,67,6529,8131,0.18878366744557865,0.8029762636822039,0.008240068872217439
2020,VIRGINIA,GREENE,4163,284,6866,11313,0.3679837355255016,0.606912401661805,0.02510386281269336
2020,VIRGINIA,GREENSVILLE,2627,33,1914,4574,0.5743331875819851,0.4184521206821163,0.007214691735898557
2020,VIRGINIA,HALIFAX,7666,164,10418,18248,0.4201008329679965,0.5709118807540552,0.00898728627794827
2020,VIRGINIA,HAMPTON CITY,46220,1307,18430,65957,0.7007595857907425,0.27942447352062705,0.019815940688630473
2020,VIRGINIA,HANOVER,25307,1363,44318,70988,0.3564968727108807,0.6243026990477264,0.01920042824139291
2020,VIRGINIA,HARRISONBURG CITY,11022,480,5591,17093,0.644825367109343,0.3270929620312409,0.028081670859416135
2020,VIRGINIA,HENRICO,116572,3287,63440,183299,0.6359663718841893,0.34610117894805753,0.017932449167753235
2020,VIRGINIA,HENRY,9127,253,16725,26105,0.3496265083317372,0.6406818617123157,0.009691629955947136
2020,VIRGINIA,HIGHLAND,417,24,1092,1533,0.2720156555772994,0.7123287671232876,0.015655577299412915
2020,VIRGINIA,HOPEWELL CITY,5430,178,4020,9628,0.5639800581636892,0.41753219775654343,0.018487744079767346
2020,VIRGINIA,ISLE OF WIGHT,9399,350,13707,23456,0.4007077080491132,0.5843707366984994,0.014921555252387449
2020,VIRGINIA,JAMES CITY,25553,933,23153,49639,0.5147766876850863,0.4664276073248857,0.018795704990028004
2020,VIRGINIA,KING AND QUEEN,1590,75,2450,4115,0.3863912515188335,0.5953827460510328,0.018226002430133656
2020,VIRGINIA,KING GEORGE,5404,377,8446,14227,0.3798411471146412,0.5936599423631124,0.026498910522246434
2020,VIRGINIA,KING WILLIAM,3260,157,7320,10737,0.30362298593648135,0.6817546800782341,0.01462233398528453
2020,VIRGINIA,LANCASTER,3368,87,3697,7152,0.470917225950783,0.5169183445190156,0.012164429530201342
2020,VIRGINIA,LEE,1489,93,8365,9947,0.14969337488690057,0.8409570724841661,0.009349552628933347
2020,VIRGINIA,LEXINGTON CITY,1791,67,906,2764,0.6479739507959479,0.32778581765557163,0.024240231548480463
2020,VIRGINIA,LOUDOUN,138372,4516,82088,224976,0.6150522722423725,0.36487447549960883,0.020073252258018634
2020,VIRGINIA,LOUISA,8269,353,13294,21916,0.37730425260083955,0.60658879357547,0.016106953823690453
2020,VIRGINIA,LUNENBURG,2418,47,3537,6002,0.4028657114295235,0.589303565478174,0.007830723092302566
2020,VIRGINIA,LYNCHBURG CITY,18048,1219,17097,36364,0.4963150368496315,0.4701627983720163,0.033522164778352216
2020,VIRGINIA,MADISON,2698,135,5300,8133,0.3317349071683266,0.6516660518873725,0.016599040944300997
2020,VIRGINIA,MANASSAS CITY,10356,366,6256,16978,0.6099658381434798,0.36847685239721994,0.02155730945930027
2020,VIRGINIA,MANASSAS PARK CITY,3992,117,1979,6088,0.6557161629434954,0.325065703022339,0.01921813403416557
2020,VIRGINIA,MARTINSVILLE CITY,3766,93,2165,6024,0.6251660026560425,0.3593957503320053,0.015438247011952191
2020,VIRGINIA,MATHEWS,1825,103,3901,5829,0.31308972379481903,0.6692400068622405,0.01767026934294047
2020,VIRGINIA,MECKLENBURG,6803,138,9266,16207,0.41975689516875425,0.5717282655642624,0.008514839266983402
2020,VIRGINIA,MIDDLESEX,2491,98,4196,6785,0.3671333824613117,0.6184229918938836,0.014443625644804716
2020,VIRGINIA,MONTGOMERY,23218,1190,20629,45037,0.5155316739569688,0.4580456069454005,0.026422719097630838
2020,VIRGINIA,NELSON,4327,179,4812,9318,0.4643700364885168,0.5164198325820991,0.01921013092938399
2020,VIRGINIA,NEW KENT,4621,219,9631,14471,0.3193283117960058,0.6655379724967175,0.015133715707276622
2020,VIRGINIA,NEWPORT NEWS CITY,53099,1794,26377,81270,0.6533653254583487,0.32456010828103854,0.02207456626061277
2020,VIRGINIA,NORFOLK CITY,64440,2105,23443,89988,0.7160954793972529,0.26051251277948173,0.023392007823265323
2020,VIRGINIA,NORTHAMPTON,3667,110,2955,6732,0.5447118241235889,0.43894830659536543,0.016339869281045753
2020,VIRGINIA,NORTHUMBERLAND,3252,78,4485,7815,0.4161228406909789,0.5738963531669866,0.009980806142034549
2020,VIRGINIA,NORTON CITY,464,28,1109,1601,0.28981886321049344,0.6926920674578388,0.017489069331667707
2020,VIRGINIA,NOTTOWAY,2971,80,4027,7078,0.4197513421870585,0.5689460299519639,0.011302627860977677
2020,VIRGINIA,ORANGE,7995,333,12426,20754,0.38522694420352704,0.5987279560566637,0.016045099739809193
2020,VIRGINIA,PAGE,3007,162,9345,12514,0.2402908742208726,0.7467636247402909,0.012945501038836503
2020,VIRGINIA,PATRICK,1954,96,7485,9535,0.20492920818038804,0.7850026219192449,0.01006816990036707
2020,VIRGINIA,PETERSBURG CITY,12389,160,1584,14133,0.8766008632279063,0.11207811504988326,0.01132102172221043
2020,VIRGINIA,PITTSYLVANIA,10115,361,23751,34227,0.295526923189295,0.6939258480147252,0.010547228795979783
2020,VIRGINIA,POQUOSON CITY,2054,198,5605,7857,0.2614229349624539,0.7133766068473972,0.025200458190148912
2020,VIRGINIA,PORTSMOUTH CITY,30948,898,12755,44601,0.6938857873141858,0.28598013497455216,0.02013407771126208
2020,VIRGINIA,POWHATAN,5320,358,14055,19733,0.2695991486342675,0.7122586530177875,0.018142198347945067
2020,VIRGINIA,PRINCE EDWARD,4973,168,4434,9575,0.5193733681462142,0.46308093994778066,0.01754569190600522
2020,VIRGINIA,PRINCE GEORGE,7103,233,10103,17439,0.40730546476288776,0.5793336773897586,0.013360857847353632
2020,VIRGINIA,PRINCE WILLIAM,142863,4182,81222,228267,0.6258591912102932,0.3558201579729002,0.018320650816806634
2020,VIRGINIA,PULASKI,4925,334,12127,17386,0.28327389853905444,0.6975152421488554,0.019210859312090187
2020,VIRGINIA,RADFORD CITY,3358,176,2786,6320,0.5313291139240506,0.4408227848101266,0.027848101265822784
2020,VIRGINIA,RAPPAHANNOCK,2096,71,2812,4979,0.42096806587668206,0.5647720425788311,0.014259891544486845
2020,VIRGINIA,RICHMOND,1513,42,2547,4102,0.36884446611409066,0.62091662603608,0.010238907849829351
2020,VIRGINIA,RICHMOND CITY,92175,2403,16603,111181,0.8290535253325658,0.14933306949928496,0.021613405168149233
2020,VIRGINIA,ROANOKE,21801,1157,34268,57226,0.3809631985461154,0.5988187187641981,0.020218082689686508
2020,VIRGINIA,ROANOKE CITY,26773,943,15607,43323,0.6179858273896083,0.3602474436211712,0.021766728989220507
2020,VIRGINIA,ROCKBRIDGE,4086,203,8088,12377,0.3301284640866123,0.6534701462389917,0.01640138967439606
2020,VIRGINIA,ROCKINGHAM,12644,828,30349,43821,0.288537459209055,0.6925674904726045,0.01889505031834052
2020,VIRGINIA,RUSSELL,2373,134,10879,13386,0.17727476467951592,0.8127147766323024,0.010010458688181682
2020,VIRGINIA,SALEM CITY,5148,220,7683,13051,0.3944525323729982,0.5886905217990959,0.01685694582790591
2020,VIRGINIA,SCOTT,1692,114,9063,10869,0.15567209494893736,0.8338393596467016,0.010488545404361027
2020,VIRGINIA,SHENANDOAH,6836,385,16463,23684,0.28863367674379325,0.6951106232055396,0.016255700050667118
2020,VIRGINIA,SMYTH,3008,165,10963,14136,0.21279003961516696,0.7755376344086021,0.0116723259762309
2020,VIRGINIA,SOUTHAMPTON,3969,87,5730,9786,0.4055793991416309,0.5855303494788473,0.008890251379521767
2020,VIRGINIA,SPOTSYLVANIA,34307,1599,39411,75317,0.45550141402339445,0.5232683192373567,0.021230266739248774
2020,VIRGINIA,STAFFORD,40245,1748,37636,79629,0.5054063218174283,0.4726418767032111,0.021951801479360534
2020,VIRGINIA,STAUNTON CITY,6981,316,5695,12992,0.5373306650246306,0.4383466748768473,0.02432266009852217
2020,VIRGINIA,SUFFOLK CITY,28676,884,20082,49642,0.5776560170823093,0.4045364812054309,0.01780750171225978
2020,VIRGINIA,SURRY,2397,49,2025,4471,0.5361216730038023,0.45291881010959517,0.010959516886602549
2020,VIRGINIA,SUSSEX,2827,42,2219,5088,0.55562106918239,0.436124213836478,0.008254716981132075
2020,VIRGINIA,TAZEWELL,3205,216,16731,20152,0.15904128622469235,0.8302401746724891,0.01071853910281858
2020,VIRGINIA,VIRGINIA BEACH CITY,117393,5237,105087,227717,0.5155214586526259,0.4614806975324635,0.02299784381491061
2020,VIRGINIA,WARREN,6603,475,14069,21147,0.31224287132926654,0.6652953137560883,0.022461814914645103
2020,VIRGINIA,WASHINGTON,6617,397,21679,28693,0.23061373854250167,0.755550134179068,0.013836127278430279
2020,VIRGINIA,WAYNESBORO CITY,4961,249,5507,10717,0.46290939628627414,0.5138564896892787,0.02323411402444714
2020,VIRGINIA,WESTMORELAND,4501,129,5318,9948,0.4524527543224769,0.5345798150381986,0.012967430639324488
2020,VIRGINIA,WILLIAMSBURG CITY,4790,137,1963,6890,0.6952104499274311,0.2849056603773585,0.01988388969521045
2020,VIRGINIA,WINCHESTER CITY,6610,282,5221,12113,0.5456947081647816,0.4310245191116982,0.023280772723520186
2020,VIRGINIA,WISE,3110,139,13366,16615,0.1871802588022871,0.8044538068010834,0.008365934396629552
2020,VIRGINIA,WYTHE,3143,197,11733,15073,0.2085185430902939,0.7784117295826976,0.013069727327008559
2020,VIRGINIA,YORK,17683,867,20241,38791,0.45585316181588514,0.5217962929545513,0.02235054522956356
