Period End Year,State FIPS,County FIPS,County Name,Population (B02001_001E),Population by Race: White Alone (B02001_002E),Population by Race: Black or African American Alone (B02001_003E),Population by Race: American Indian and Alaska Native Alone (B02001_004E),Population by Race: Asian Alone (B02001_005E),Population by Race: Native Hawaiian and Other Pacific Islander Alone (B02001_006E),Population by Race: Some Other Race Alone (B02001_007E),Population by Race: Two or More Races (B02001_008E),Population: Ethnicity (B03003_001E),Population: Not Hispanic or Latino (B03003_002E),Population: Hispanic or Latino (B03003_003E),% white
2010,42,1,"Adams County, Pennsylvania",100839,93905,1518,106,716,11,3275,1308,100839,95188,5651,0.931236922
2010,42,3,"Allegheny County, Pennsylvania",1223066,1003321,158648,1436,32667,401,5117,21476,1223066,1205439,17627,0.820332672
2010,42,5,"Armstrong County, Pennsylvania",69489,68107,589,36,126,0,216,415,69489,69092,397,0.98011196
2010,42,7,"Beaver County, Pennsylvania",171569,156869,10212,208,689,10,455,3126,171569,169591,1978,0.914320186
2010,42,9,"Bedford County, Pennsylvania",49882,49037,190,39,114,25,82,395,49882,49453,429,0.983060022
2010,42,11,"Berks County, Pennsylvania",407310,344302,18497,560,5140,130,31001,7680,407310,346042,61268,0.845307014
2010,42,13,"Blair County, Pennsylvania",127071,122519,2187,79,748,9,326,1203,127071,125840,1231,0.964177507
2010,42,15,"Bradford County, Pennsylvania",62415,60911,323,103,306,0,193,579,62415,61723,692,0.975903228
2010,42,17,"Bucks County, Pennsylvania",622859,564298,22380,853,23062,150,4787,7329,622859,598379,24480,0.905980326
2010,42,19,"Butler County, Pennsylvania",182554,176961,1816,187,1544,15,435,1596,182554,180682,1872,0.96936249
2010,42,21,"Cambria County, Pennsylvania",144741,136759,5178,122,819,72,379,1412,144741,142756,1985,0.944853221
2010,42,23,"Cameron County, Pennsylvania",5197,5114,3,7,17,0,0,56,5197,5169,28,0.984029248
2010,42,25,"Carbon County, Pennsylvania",64563,62132,961,94,331,0,441,604,64563,62591,1972,0.962346855
2010,42,27,"Centre County, Pennsylvania",151411,135751,4332,351,7863,78,1279,1757,151411,147865,3546,0.896572904
2010,42,29,"Chester County, Pennsylvania",490571,428615,29867,475,17686,59,6875,6994,490571,461568,29003,0.873706354
2010,42,31,"Clarion County, Pennsylvania",40290,39293,440,22,126,0,95,314,40290,40045,245,0.975254406
2010,42,33,"Clearfield County, Pennsylvania",82131,78959,1758,42,369,22,339,642,82131,80396,1735,0.961378773
2010,42,35,"Clinton County, Pennsylvania",38970,37760,541,57,169,0,132,311,38970,38568,402,0.968950475
2010,42,37,"Columbia County, Pennsylvania",66642,64167,930,121,574,0,244,606,66642,65387,1255,0.962861259
2010,42,39,"Crawford County, Pennsylvania",89153,85835,1530,196,335,8,219,1030,89153,88300,853,0.962783081
2010,42,41,"Cumberland County, Pennsylvania",231336,212397,6991,288,6230,90,1326,4014,231336,225441,5895,0.918132068
2010,42,43,"Dauphin County, Pennsylvania",264823,196732,46436,299,7859,78,6009,7410,264823,247850,16973,0.742881094
2010,42,45,"Delaware County, Pennsylvania",556468,411963,106149,377,25364,80,4406,8129,556468,541436,15032,0.740317503
2010,42,47,"Elk County, Pennsylvania",32480,32063,92,53,101,6,20,145,32480,32306,174,0.98716133
2010,42,49,"Erie County, Pennsylvania",279234,248289,18911,376,2978,73,2854,5753,279234,270483,8751,0.889178968
2010,42,51,"Fayette County, Pennsylvania",138807,129926,5565,247,436,0,337,2296,138807,137754,1053,0.936019077
2010,42,53,"Forest County, Pennsylvania",7585,6323,1199,18,0,0,28,17,7585,7331,254,0.833618985
2010,42,55,"Franklin County, Pennsylvania",146558,137439,4684,153,1261,0,1083,1938,146558,140884,5674,0.9377789
2010,42,57,"Fulton County, Pennsylvania",14839,14538,136,33,4,0,9,119,14839,14718,121,0.979715614
2010,42,59,"Greene County, Pennsylvania",39003,37125,1334,139,138,0,0,267,39003,38558,445,0.951849858
2010,42,61,"Huntingdon County, Pennsylvania",45830,42804,2366,34,217,9,53,347,45830,45170,660,0.93397338
2010,42,63,"Indiana County, Pennsylvania",88745,84495,2198,181,737,45,443,646,88745,87825,920,0.952109978
2010,42,65,"Jefferson County, Pennsylvania",45244,44536,121,85,48,0,59,395,45244,44969,275,0.984351516
2010,42,67,"Juniata County, Pennsylvania",24385,23779,90,46,77,8,98,287,24385,23874,511,0.975148657
2010,42,69,"Lackawanna County, Pennsylvania",213731,200192,5138,230,3161,95,2252,2663,213731,204768,8963,0.936654018
2010,42,71,"Lancaster County, Pennsylvania",511250,461689,18235,890,9464,191,13135,7646,511250,470064,41186,0.903059169
2010,42,73,"Lawrence County, Pennsylvania",91682,86324,3236,65,350,19,213,1475,91682,90748,934,0.941558867
2010,42,75,"Lebanon County, Pennsylvania",131341,118633,2301,142,1252,0,6277,2736,131341,120458,10883,0.903244227
2010,42,77,"Lehigh County, Pennsylvania",343946,279462,19830,790,10258,48,26342,7216,343946,284805,59141,0.812517081
2010,42,79,"Luzerne County, Pennsylvania",319120,296697,10401,344,2838,35,5253,3552,319120,301823,17297,0.929734896
2010,42,81,"Lycoming County, Pennsylvania",116376,108227,4958,222,620,39,394,1916,116376,114912,1464,0.929976971
2010,42,83,"McKean County, Pennsylvania",43853,41937,979,85,181,0,234,437,43853,43113,740,0.956308576
2010,42,85,"Mercer County, Pennsylvania",117296,108034,6357,180,770,17,209,1729,117296,116041,1255,0.921037376
2010,42,87,"Mifflin County, Pennsylvania",46583,45649,262,59,77,0,35,501,46583,46062,521,0.979949767
2010,42,89,"Monroe County, Pennsylvania",168080,134284,21589,288,3530,50,4490,3849,168080,147552,20528,0.798929081
2010,42,91,"Montgomery County, Pennsylvania",790497,655774,66003,492,48336,267,6381,13244,790497,760057,30440,0.829571776
2010,42,93,"Montour County, Pennsylvania",18152,17354,266,15,358,0,76,83,18152,17873,279,0.956037902
2010,42,95,"Northampton County, Pennsylvania",294536,256359,13467,448,6748,143,11102,6269,294536,265816,28720,0.870382568
2010,42,97,"Northumberland County, Pennsylvania",94099,90386,1802,150,245,38,728,750,94099,92079,2020,0.960541557
2010,42,99,"Perry County, Pennsylvania",45599,44442,303,89,117,0,274,374,45599,45047,552,0.974626637
2010,42,101,"Philadelphia County, Pennsylvania",1504950,623627,661929,3952,92889,376,91822,30355,1504950,1329832,175118,0.414383867
2010,42,103,"Pike County, Pennsylvania",56993,51233,2898,63,479,73,1128,1119,56993,52227,4766,0.898934957
2010,42,105,"Potter County, Pennsylvania",17583,17228,81,49,53,2,36,134,17583,17428,155,0.979810044
2010,42,107,"Schuylkill County, Pennsylvania",148288,141124,3812,114,789,6,1059,1384,148288,144704,3584,0.951688606
2010,42,109,"Snyder County, Pennsylvania",39400,38228,365,68,204,0,187,348,39400,38807,593,0.970253807
2010,42,111,"Somerset County, Pennsylvania",78219,75666,1698,60,173,0,63,559,78219,77437,782,0.967360871
2010,42,113,"Sullivan County, Pennsylvania",6467,6134,186,131,6,0,0,10,6467,6457,10,0.948507809
2010,42,115,"Susquehanna County, Pennsylvania",43343,42635,145,63,80,18,32,370,43343,42809,534,0.983665182
2010,42,117,"Tioga County, Pennsylvania",41631,40663,241,51,174,18,43,441,41631,41227,404,0.976748096
2010,42,119,"Union County, Pennsylvania",44866,39060,3324,98,556,19,1051,758,44866,42598,2268,0.870592431
2010,42,121,"Venango County, Pennsylvania",55320,53766,547,53,158,26,22,748,55320,54806,514,0.971908894
2010,42,123,"Warren County, Pennsylvania",41877,41168,112,124,144,15,39,275,41877,41584,293,0.983069465
2010,42,125,"Washington County, Pennsylvania",206987,195671,6891,194,1282,0,440,2509,206987,204760,2227,0.9453299
2010,42,127,"Wayne County, Pennsylvania",52302,49787,1384,131,244,0,168,588,52302,50590,1712,0.951913885
2010,42,129,"Westmoreland County, Pennsylvania",365841,349822,7804,311,2580,92,942,4290,365841,362810,3031,0.956213218
2010,42,131,"Wyoming County, Pennsylvania",28262,27596,187,29,88,3,95,264,28262,27885,377,0.976434789
2010,42,133,"York County, Pennsylvania",428175,384221,22149,802,5380,43,7932,7648,428175,406345,21830,0.897345711
2011,42,1,"Adams County, Pennsylvania",101137,94174,1629,166,710,0,3032,1426,101137,95243,5894,0.931152793
2011,42,3,"Allegheny County, Pennsylvania",1223525,1000387,159207,1357,33659,435,5230,23250,1223525,1204855,18670,0.817626939
2011,42,5,"Armstrong County, Pennsylvania",69208,67786,622,27,117,0,212,444,69208,68804,404,0.979453242
2011,42,7,"Beaver County, Pennsylvania",171027,156152,10260,205,813,15,357,3225,171027,168998,2029,0.913025429
2011,42,9,"Bedford County, Pennsylvania",49864,48978,273,40,125,9,73,366,49864,49419,445,0.98223167
2011,42,11,"Berks County, Pennsylvania",409624,346213,18837,545,5288,139,29931,8671,409624,345326,64298,0.845197059
2011,42,13,"Blair County, Pennsylvania",127090,122435,2261,118,816,0,245,1215,127090,125828,1262,0.963372413
2011,42,15,"Bradford County, Pennsylvania",62522,61048,346,59,327,3,127,612,62522,61801,721,0.976424299
2011,42,17,"Bucks County, Pennsylvania",624351,563523,22647,635,23817,130,5165,8434,624351,598658,25693,0.902574033
2011,42,19,"Butler County, Pennsylvania",183317,177451,2044,179,1781,16,377,1469,183317,181365,1952,0.968000786
2011,42,21,"Cambria County, Pennsylvania",144489,136070,5246,123,783,45,591,1631,144489,142424,2065,0.941732589
2011,42,23,"Cameron County, Pennsylvania",5130,5004,32,24,22,0,0,48,5130,5078,52,0.975438596
2011,42,25,"Carbon County, Pennsylvania",64974,62459,808,117,327,0,440,823,64974,62887,2087,0.961292209
2011,42,27,"Centre County, Pennsylvania",152689,136530,4666,348,8158,71,1223,1693,152689,148920,3769,0.894170503
2011,42,29,"Chester County, Pennsylvania",495651,432971,29750,503,18339,90,6125,7873,495651,464935,30716,0.873540051
2011,42,31,"Clarion County, Pennsylvania",40178,39120,494,25,128,0,86,325,40178,39921,257,0.973667181
2011,42,33,"Clearfield County, Pennsylvania",81954,78625,1835,73,394,0,248,779,81954,80092,1862,0.959379652
2011,42,35,"Clinton County, Pennsylvania",39015,37766,443,50,155,0,103,498,39015,38592,423,0.967986672
2011,42,37,"Columbia County, Pennsylvania",67020,64372,1181,122,603,0,254,488,67020,65672,1348,0.960489406
2011,42,39,"Crawford County, Pennsylvania",89058,85577,1514,152,336,7,169,1303,89058,88187,871,0.960913113
2011,42,41,"Cumberland County, Pennsylvania",233726,213511,7254,337,6243,65,1616,4700,233726,227527,6199,0.913509836
2011,42,43,"Dauphin County, Pennsylvania",266576,197096,46819,289,7994,91,6140,8147,266576,248669,17907,0.739361383
2011,42,45,"Delaware County, Pennsylvania",557648,409619,107857,422,25919,76,4495,9260,557648,541817,15831,0.7345476
2011,42,47,"Elk County, Pennsylvania",32233,31811,181,40,97,8,22,74,32233,32050,183,0.986907827
2011,42,49,"Erie County, Pennsylvania",279824,248483,19100,529,3178,57,2398,6079,279824,270688,9136,0.887997456
2011,42,51,"Fayette County, Pennsylvania",137803,128788,5684,266,455,0,294,2316,137803,136722,1081,0.934580524
2011,42,53,"Forest County, Pennsylvania",7600,6216,1094,14,0,0,73,203,7600,7283,317,0.817894737
2011,42,55,"Franklin County, Pennsylvania",148239,138864,5017,297,1368,0,882,1811,148239,142171,6068,0.936757533
2011,42,57,"Fulton County, Pennsylvania",14858,14525,146,31,24,0,32,100,14858,14734,124,0.977587831
2011,42,59,"Greene County, Pennsylvania",38895,36839,1304,162,55,0,193,342,38895,38368,527,0.947139735
2011,42,61,"Huntingdon County, Pennsylvania",45898,42588,2321,45,201,8,130,605,45898,45204,694,0.927883568
2011,42,63,"Indiana County, Pennsylvania",88997,84426,2288,175,837,31,462,778,88997,88028,969,0.948638718
2011,42,65,"Jefferson County, Pennsylvania",45173,44447,164,65,89,4,61,343,45173,44884,289,0.983928453
2011,42,67,"Juniata County, Pennsylvania",24439,23813,112,39,89,13,133,240,24439,23885,554,0.974385204
2011,42,69,"Lackawanna County, Pennsylvania",214057,199881,5462,224,3229,91,2310,2860,214057,204263,9794,0.933774649
2011,42,71,"Lancaster County, Pennsylvania",515817,465292,18490,784,9834,183,12520,8714,515817,472700,43117,0.902048595
2011,42,73,"Lawrence County, Pennsylvania",91341,85806,3439,66,326,12,224,1468,91341,90386,955,0.939402897
2011,42,75,"Lebanon County, Pennsylvania",132550,119069,2403,133,1334,0,6505,3106,132550,120924,11626,0.898294983
2011,42,77,"Lehigh County, Pennsylvania",347197,283176,20890,653,10216,61,23922,8279,347197,284556,62641,0.815606126
2011,42,79,"Luzerne County, Pennsylvania",319897,296052,10982,387,3025,51,5773,3627,319897,300450,19447,0.925460383
2011,42,81,"Lycoming County, Pennsylvania",116335,108050,5105,191,667,57,261,2004,116335,114792,1543,0.928783255
2011,42,83,"McKean County, Pennsylvania",43642,41673,1074,96,207,0,219,373,43642,42879,763,0.954882911
2011,42,85,"Mercer County, Pennsylvania",116939,107388,6372,183,824,20,342,1810,116939,115665,1274,0.918324939
2011,42,87,"Mifflin County, Pennsylvania",46671,45694,290,45,133,0,28,481,46671,46129,542,0.97906623
2011,42,89,"Monroe County, Pennsylvania",169050,133979,22297,234,3487,67,4452,4534,169050,147553,21497,0.792540668
2011,42,91,"Montgomery County, Pennsylvania",794921,656710,67627,617,49796,193,6285,13693,794921,762604,32317,0.826132408
2011,42,93,"Montour County, Pennsylvania",18193,17362,276,13,317,0,79,146,18193,17890,303,0.954323091
2011,42,95,"Northampton County, Pennsylvania",296323,258374,14245,510,7151,65,9374,6604,296323,266307,30016,0.871933667
2011,42,97,"Northumberland County, Pennsylvania",94321,90082,2090,150,274,46,899,780,94321,92169,2152,0.955057728
2011,42,99,"Perry County, Pennsylvania",45785,44575,317,62,109,2,303,417,45785,45208,577,0.973572131
2011,42,101,"Philadelphia County, Pennsylvania",1514456,628564,660995,4010,94985,316,92015,33571,1514456,1332976,181480,0.415042761
2011,42,103,"Pike County, Pennsylvania",57242,51244,2976,48,463,73,1204,1234,57242,52250,4992,0.895216799
2011,42,105,"Potter County, Pennsylvania",17487,17128,112,38,39,2,45,123,17487,17323,164,0.979470464
2011,42,107,"Schuylkill County, Pennsylvania",148195,140832,3992,99,816,4,988,1464,148195,144338,3857,0.950315463
2011,42,109,"Snyder County, Pennsylvania",39597,38473,368,54,230,45,146,281,39597,38960,637,0.971614011
2011,42,111,"Somerset County, Pennsylvania",77946,75231,1703,73,230,0,136,573,77946,77131,815,0.965168193
2011,42,113,"Sullivan County, Pennsylvania",6469,6275,79,59,24,0,26,6,6469,6427,42,0.970010821
2011,42,115,"Susquehanna County, Pennsylvania",43311,42575,184,111,85,0,23,333,43311,42758,553,0.983006626
2011,42,117,"Tioga County, Pennsylvania",41850,40799,309,66,165,14,47,450,41850,41417,433,0.974886499
2011,42,119,"Union County, Pennsylvania",44872,39200,3337,118,554,34,920,709,44872,42566,2306,0.873596006
2011,42,121,"Venango County, Pennsylvania",55106,53533,582,41,203,13,38,696,55106,54591,515,0.971455014
2011,42,123,"Warren County, Pennsylvania",41771,40994,161,95,145,13,59,304,41771,41461,310,0.981398578
2011,42,125,"Washington County, Pennsylvania",207451,195914,6899,167,1301,0,387,2783,207451,205112,2339,0.944386867
2011,42,127,"Wayne County, Pennsylvania",52477,49843,1384,147,219,0,226,658,52477,50711,1766,0.949806582
2011,42,129,"Westmoreland County, Pennsylvania",365438,348894,7880,370,2671,54,802,4767,365438,362286,3152,0.954728299
2011,42,131,"Wyoming County, Pennsylvania",28333,27648,219,32,95,2,82,255,28333,27922,411,0.975823245
2011,42,133,"York County, Pennsylvania",431967,385119,22784,610,5479,54,9080,8841,431967,408872,23095,0.891547271
2012,42,1,"Adams County, Pennsylvania",101352,93884,1607,134,744,0,3384,1599,101352,95271,6081,0.926316205
2012,42,3,"Allegheny County, Pennsylvania",1224772,998821,159897,1443,34487,394,4698,25032,1224772,1205285,19487,0.815515867
2012,42,5,"Armstrong County, Pennsylvania",68942,67494,635,25,142,0,189,457,68942,68549,393,0.978996838
2012,42,7,"Beaver County, Pennsylvania",170614,155603,10317,144,857,14,350,3329,170614,168575,2039,0.912017771
2012,42,9,"Bedford County, Pennsylvania",49680,48747,295,75,127,13,72,351,49680,49219,461,0.981219807
2012,42,11,"Berks County, Pennsylvania",411094,348705,19523,850,5436,124,27587,8869,411094,343836,67258,0.848236656
2012,42,13,"Blair County, Pennsylvania",127133,122432,2242,113,907,0,185,1254,127133,125873,1260,0.963022976
2012,42,15,"Bradford County, Pennsylvania",62628,61089,344,62,398,2,150,583,62628,61880,748,0.975426327
2012,42,17,"Bucks County, Pennsylvania",625485,562737,22785,540,24607,138,5546,9132,625485,598717,26768,0.899681048
2012,42,19,"Butler County, Pennsylvania",183946,177829,2111,107,1954,8,373,1564,183946,181961,1985,0.966745675
2012,42,21,"Cambria County, Pennsylvania",143305,134809,5062,114,773,82,570,1895,143305,141246,2059,0.940713862
2012,42,23,"Cameron County, Pennsylvania",5058,4972,31,4,10,0,0,41,5058,5035,23,0.982997232
2012,42,25,"Carbon County, Pennsylvania",65101,62472,872,177,335,0,346,899,65101,62905,2196,0.959616596
2012,42,27,"Centre County, Pennsylvania",153758,137411,4735,397,8075,36,1092,2012,153758,149969,3789,0.893683581
2012,42,29,"Chester County, Pennsylvania",499548,436742,30005,329,19198,110,4761,8403,499548,467399,32149,0.874274344
2012,42,31,"Clarion County, Pennsylvania",39991,38852,503,16,210,0,146,264,39991,39734,257,0.971518592
2012,42,33,"Clearfield County, Pennsylvania",81668,78262,1765,103,468,0,332,738,81668,79755,1913,0.958294558
2012,42,35,"Clinton County, Pennsylvania",39261,37942,591,58,164,9,66,431,39261,38821,440,0.96640432
2012,42,37,"Columbia County, Pennsylvania",66984,64330,1143,82,647,0,203,579,66984,65584,1400,0.960378598
2012,42,39,"Crawford County, Pennsylvania",88492,84946,1551,121,363,15,136,1360,88492,87632,860,0.959928581
2012,42,41,"Cumberland County, Pennsylvania",235314,214006,7324,372,6571,58,1794,5189,235314,228807,6507,0.909448652
2012,42,43,"Dauphin County, Pennsylvania",267891,197274,47186,408,8387,51,5950,8635,267891,249063,18828,0.736396519
2012,42,45,"Delaware County, Pennsylvania",558874,407100,110537,409,26802,85,4066,9875,558874,542314,16560,0.728428948
2012,42,47,"Elk County, Pennsylvania",31981,31438,178,48,122,0,101,94,31981,31792,189,0.983021169
2012,42,49,"Erie County, Pennsylvania",280181,247864,19659,728,3198,17,2482,6233,280181,270669,9512,0.884656704
2012,42,51,"Fayette County, Pennsylvania",136914,127766,5837,204,512,18,216,2361,136914,135803,1111,0.933184335
2012,42,53,"Forest County, Pennsylvania",7664,6095,1245,63,0,0,98,163,7664,7338,326,0.795276618
2012,42,55,"Franklin County, Pennsylvania",149554,139798,5232,326,1401,0,1043,1754,149554,143131,6423,0.934766038
2012,42,57,"Fulton County, Pennsylvania",14829,14465,182,40,21,0,22,99,14829,14701,128,0.975453503
2012,42,59,"Greene County, Pennsylvania",38614,35586,2082,100,89,3,161,593,38614,37943,671,0.921582846
2012,42,61,"Huntingdon County, Pennsylvania",45931,42616,2405,32,179,0,153,546,45931,45189,742,0.927826522
2012,42,63,"Indiana County, Pennsylvania",88648,84033,2271,141,830,33,409,931,88648,87664,984,0.947940168
2012,42,65,"Jefferson County, Pennsylvania",45051,44293,145,60,86,1,62,404,45051,44756,295,0.983174624
2012,42,67,"Juniata County, Pennsylvania",24664,24109,177,40,93,0,65,180,24664,24051,613,0.977497567
2012,42,69,"Lackawanna County, Pennsylvania",214353,200321,5385,274,3516,75,1823,2959,214353,203807,10546,0.934537888
2012,42,71,"Lancaster County, Pennsylvania",519913,467604,18411,847,10051,154,13064,9782,519913,474736,45177,0.899388936
2012,42,73,"Lawrence County, Pennsylvania",90885,85239,3584,68,327,17,238,1412,90885,89947,938,0.937877538
2012,42,75,"Lebanon County, Pennsylvania",133578,119364,2544,131,1347,0,6898,3294,133578,121086,12492,0.893590262
2012,42,77,"Lehigh County, Pennsylvania",350165,284775,22225,807,10465,51,23177,8665,350165,284091,66074,0.813259463
2012,42,79,"Luzerne County, Pennsylvania",320555,294883,11509,490,3047,58,6932,3636,320555,298876,21679,0.919913899
2012,42,81,"Lycoming County, Pennsylvania",116447,107893,5103,221,770,36,311,2113,116447,114852,1595,0.926541688
2012,42,83,"McKean County, Pennsylvania",43451,41417,1044,109,217,0,229,435,43451,42682,769,0.953188649
2012,42,85,"Mercer County, Pennsylvania",116474,106816,6397,115,821,23,358,1944,116474,115214,1260,0.917080207
2012,42,87,"Mifflin County, Pennsylvania",46694,45674,315,31,137,0,30,507,46694,46161,533,0.978155652
2012,42,89,"Monroe County, Pennsylvania",169346,133808,22000,233,3313,80,4521,5391,169346,147008,22338,0.790145619
2012,42,91,"Montgomery County, Pennsylvania",799886,657641,69139,884,51172,207,5806,15037,799886,766111,33775,0.822168409
2012,42,93,"Montour County, Pennsylvania",18243,17365,278,16,355,0,89,140,18243,17906,337,0.951871951
2012,42,95,"Northampton County, Pennsylvania",297519,259544,14598,532,7459,42,8252,7092,297519,266114,31405,0.872361093
2012,42,97,"Northumberland County, Pennsylvania",94441,90454,2227,171,341,10,462,776,94441,92157,2284,0.957783166
2012,42,99,"Perry County, Pennsylvania",45791,44552,314,44,87,1,292,501,45791,45189,602,0.972942281
2012,42,101,"Philadelphia County, Pennsylvania",1525811,631799,662657,4473,96995,1594,90949,37344,1525811,1337750,188061,0.41407422
2012,42,103,"Pike County, Pennsylvania",57437,51583,2929,55,415,93,1002,1360,57437,52249,5188,0.898079635
2012,42,105,"Potter County, Pennsylvania",17466,17133,83,24,53,2,22,149,17466,17289,177,0.980934387
2012,42,107,"Schuylkill County, Pennsylvania",147935,140308,3997,72,870,0,1017,1671,147935,143829,4106,0.948443573
2012,42,109,"Snyder County, Pennsylvania",39620,38467,408,50,263,24,195,213,39620,38953,667,0.970898536
2012,42,111,"Somerset County, Pennsylvania",77638,74769,1789,88,233,0,141,618,77638,76801,837,0.963046446
2012,42,113,"Sullivan County, Pennsylvania",6453,6138,126,91,17,19,35,27,6453,6367,86,0.951185495
2012,42,115,"Susquehanna County, Pennsylvania",43171,42400,226,99,84,0,22,340,43171,42593,578,0.982140789
2012,42,117,"Tioga County, Pennsylvania",42081,40955,357,67,187,0,46,469,42081,41631,450,0.973242081
2012,42,119,"Union County, Pennsylvania",44944,39161,3275,106,536,55,946,865,44944,42568,2376,0.871328765
2012,42,121,"Venango County, Pennsylvania",54865,53240,436,39,182,8,23,937,54865,54371,494,0.970381846
2012,42,123,"Warren County, Pennsylvania",41613,40795,199,69,174,3,66,307,41613,41294,319,0.980342681
2012,42,125,"Washington County, Pennsylvania",207916,196156,6681,94,1399,0,434,3152,207916,205522,2394,0.943438696
2012,42,127,"Wayne County, Pennsylvania",52299,49484,1537,117,282,11,254,614,52299,50484,1815,0.946174879
2012,42,129,"Westmoreland County, Pennsylvania",364877,347766,8447,331,2775,0,731,4827,364877,361625,3252,0.953104745
2012,42,131,"Wyoming County, Pennsylvania",28221,27503,219,40,113,1,76,269,28221,27782,439,0.974557953
2012,42,133,"York County, Pennsylvania",434579,386289,23231,594,5430,46,9087,9902,434579,410178,24401,0.888880963
2013,42,1,"Adams County, Pennsylvania",101496,94086,1575,183,755,0,3253,1644,101496,95195,6301,0.926992197
2013,42,3,"Allegheny County, Pennsylvania",1226933,998456,159750,1515,36286,352,4749,25825,1226933,1206575,20358,0.813782008
2013,42,5,"Armstrong County, Pennsylvania",68614,67150,656,36,121,0,176,475,68614,68203,411,0.978663247
2013,42,7,"Beaver County, Pennsylvania",170382,155255,10110,122,892,13,383,3607,170382,168240,2142,0.911217147
2013,42,9,"Bedford County, Pennsylvania",49490,48519,298,67,134,10,53,409,49490,49008,482,0.980379875
2013,42,11,"Berks County, Pennsylvania",412078,346342,19731,1087,5432,226,28671,10589,412078,342057,70021,0.840476803
2013,42,13,"Blair County, Pennsylvania",126940,122136,2283,96,940,0,178,1307,126940,125648,1292,0.962155349
2013,42,15,"Bradford County, Pennsylvania",62624,61131,352,34,368,7,71,661,62624,61824,800,0.9761593
2013,42,17,"Bucks County, Pennsylvania",625977,561169,23113,720,25340,154,5860,9621,625977,598140,27837,0.89646904
2013,42,19,"Butler County, Pennsylvania",184535,178204,2075,177,2044,15,368,1652,184535,182427,2108,0.965692145
2013,42,21,"Cambria County, Pennsylvania",142448,133776,5065,124,721,59,500,2203,142448,140318,2130,0.939121644
2013,42,23,"Cameron County, Pennsylvania",5000,4907,38,4,8,0,0,43,5000,4972,28,0.9814
2013,42,25,"Carbon County, Pennsylvania",65074,62410,952,105,295,0,533,779,65074,62766,2308,0.959061991
2013,42,27,"Centre County, Pennsylvania",154460,137980,4860,340,8001,71,808,2400,154460,150542,3918,0.89330571
2013,42,29,"Chester County, Pennsylvania",503075,438698,29898,448,20359,76,4457,9139,503075,469602,33473,0.872032997
2013,42,31,"Clarion County, Pennsylvania",39720,38552,487,24,208,0,146,303,39720,39461,259,0.970594159
2013,42,33,"Clearfield County, Pennsylvania",81536,78077,1812,104,499,0,300,744,81536,79512,2024,0.957577021
2013,42,35,"Clinton County, Pennsylvania",39501,38071,555,30,152,11,78,604,39501,39030,471,0.963798385
2013,42,37,"Columbia County, Pennsylvania",67021,64331,1270,82,701,0,155,482,67021,65539,1482,0.959863326
2013,42,39,"Crawford County, Pennsylvania",88173,84687,1540,110,358,15,147,1316,88173,87267,906,0.960464088
2013,42,41,"Cumberland County, Pennsylvania",237449,214719,7737,269,7145,71,2037,5471,237449,230465,6984,0.904274181
2013,42,43,"Dauphin County, Pennsylvania",269035,196403,47590,452,8739,78,6859,8914,269035,249285,19750,0.730027692
2013,42,45,"Delaware County, Pennsylvania",559771,404244,113046,577,27002,51,4507,10344,559771,542359,17412,0.722159597
2013,42,47,"Elk County, Pennsylvania",31799,31256,185,46,162,0,87,63,31799,31599,200,0.982923991
2013,42,49,"Erie County, Pennsylvania",280518,247774,19674,688,3513,26,2403,6440,280518,270650,9868,0.883273088
2013,42,51,"Fayette County, Pennsylvania",136145,126802,5713,168,472,36,295,2659,136145,134964,1181,0.931374637
2013,42,53,"Forest County, Pennsylvania",7696,5888,1466,46,26,0,153,117,7696,7266,430,0.765072765
2013,42,55,"Franklin County, Pennsylvania",150594,140494,5320,353,1374,19,1184,1850,150594,143814,6780,0.932932255
2013,42,57,"Fulton County, Pennsylvania",14779,14391,194,40,20,8,20,106,14779,14641,138,0.973746532
2013,42,59,"Greene County, Pennsylvania",38362,35438,2016,110,145,3,127,523,38362,37880,482,0.923778739
2013,42,61,"Huntingdon County, Pennsylvania",45874,42530,2433,27,214,5,144,521,45874,45115,759,0.927104678
2013,42,63,"Indiana County, Pennsylvania",88404,83817,2228,124,953,33,321,928,88404,87349,1055,0.948113208
2013,42,65,"Jefferson County, Pennsylvania",45015,44201,156,81,80,2,67,428,45015,44709,306,0.981917139
2013,42,67,"Juniata County, Pennsylvania",24737,24079,211,44,93,0,127,183,24737,24081,656,0.97340017
2013,42,69,"Lackawanna County, Pennsylvania",214275,199677,5925,299,3913,49,1570,2842,214275,202979,11296,0.931872594
2013,42,71,"Lancaster County, Pennsylvania",523306,468324,19704,941,10278,130,14160,9769,523306,476227,47079,0.894933366
2013,42,73,"Lawrence County, Pennsylvania",90374,84514,3624,72,283,21,335,1525,90374,89394,980,0.935158342
2013,42,75,"Lebanon County, Pennsylvania",134411,119607,2398,160,1455,0,7387,3404,134411,121115,13296,0.889860205
2013,42,77,"Lehigh County, Pennsylvania",352068,284482,22716,711,10848,0,23997,9314,352068,283121,68947,0.808031403
2013,42,79,"Luzerne County, Pennsylvania",320827,292789,11939,675,3045,49,7657,4673,320827,296998,23829,0.912607106
2013,42,81,"Lycoming County, Pennsylvania",116604,107755,5585,196,711,30,400,1927,116604,114893,1711,0.924110665
2013,42,83,"McKean County, Pennsylvania",43294,41204,1105,139,211,0,201,434,43294,42487,807,0.951725412
2013,42,85,"Mercer County, Pennsylvania",116059,106201,6724,107,839,22,475,1691,116059,114731,1328,0.915060443
2013,42,87,"Mifflin County, Pennsylvania",46698,45602,328,43,169,8,79,469,46698,46140,558,0.976530044
2013,42,89,"Monroe County, Pennsylvania",168947,133639,22583,383,3608,73,3869,4792,168947,146028,22919,0.791011382
2013,42,91,"Montgomery County, Pennsylvania",804621,658994,70875,733,52843,162,5187,15827,804621,769337,35284,0.819011684
2013,42,93,"Montour County, Pennsylvania",18379,17443,301,14,413,0,91,117,18379,18015,364,0.949072311
2013,42,95,"Northampton County, Pennsylvania",298439,258936,15088,782,7813,37,8343,7440,298439,265739,32700,0.867634592
2013,42,97,"Northumberland County, Pennsylvania",94444,90335,2312,166,353,8,434,836,94444,92022,2422,0.956492736
2013,42,99,"Perry County, Pennsylvania",45808,44560,337,38,111,1,245,516,45808,45163,645,0.972755851
2013,42,101,"Philadelphia County, Pennsylvania",1536704,637842,665332,4433,99962,1359,88827,38949,1536704,1341990,194714,0.415071478
2013,42,103,"Pike County, Pennsylvania",57179,51138,3008,32,514,15,1079,1393,57179,51859,5320,0.894349324
2013,42,105,"Potter County, Pennsylvania",17487,17126,69,26,54,3,38,171,17487,17299,188,0.979356093
2013,42,107,"Schuylkill County, Pennsylvania",147700,139914,4062,106,836,24,1019,1739,147700,143268,4432,0.947285037
2013,42,109,"Snyder County, Pennsylvania",39711,38543,404,59,266,6,172,261,39711,38997,714,0.970587495
2013,42,111,"Somerset County, Pennsylvania",77341,74307,1813,94,199,0,193,735,77341,76455,886,0.96077113
2013,42,113,"Sullivan County, Pennsylvania",6419,6231,96,5,12,18,39,18,6419,6327,92,0.970711949
2013,42,115,"Susquehanna County, Pennsylvania",42948,42094,254,94,94,0,76,336,42948,42327,621,0.980115488
2013,42,117,"Tioga County, Pennsylvania",42267,41170,342,69,196,4,26,460,42267,41768,499,0.974045946
2013,42,119,"Union County, Pennsylvania",44932,39375,3287,137,537,67,765,764,44932,42503,2429,0.876324223
2013,42,121,"Venango County, Pennsylvania",54590,52897,423,51,213,2,27,977,54590,54064,526,0.968986994
2013,42,123,"Warren County, Pennsylvania",41429,40557,192,64,164,0,87,365,41429,41092,337,0.978951942
2013,42,125,"Washington County, Pennsylvania",208047,196038,6509,70,1487,0,482,3461,208047,205473,2574,0.942277466
2013,42,127,"Wayne County, Pennsylvania",52212,49342,1715,79,290,10,295,481,52212,50304,1908,0.945031793
2013,42,129,"Westmoreland County, Pennsylvania",364090,346635,8538,417,2850,23,662,4965,364090,360633,3457,0.952058557
2013,42,131,"Wyoming County, Pennsylvania",28177,27441,204,32,121,0,81,298,28177,27711,466,0.973879405
2013,42,133,"York County, Pennsylvania",436339,386748,23618,598,5727,48,9325,10275,436339,410718,25621,0.886347542
2014,42,1,"Adams County, Pennsylvania",101566,93835,1526,148,710,0,3340,2007,101566,95132,6434,0.923882008
2014,42,3,"Allegheny County, Pennsylvania",1229172,996737,159671,1682,38048,308,4901,27825,1229172,1207828,21344,0.810901159
2014,42,5,"Armstrong County, Pennsylvania",68343,66840,657,21,130,0,179,516,68343,67916,427,0.978007989
2014,42,7,"Beaver County, Pennsylvania",170124,154687,10276,151,933,19,491,3567,170124,167874,2250,0.909260304
2014,42,9,"Bedford County, Pennsylvania",49332,48310,325,96,120,0,67,414,49332,48835,497,0.979283224
2014,42,11,"Berks County, Pennsylvania",413016,346306,20084,1752,5649,188,24501,14536,413016,340309,72707,0.838480834
2014,42,13,"Blair County, Pennsylvania",126708,121835,2041,67,1016,0,144,1605,126708,125358,1350,0.961541497
2014,42,15,"Bradford County, Pennsylvania",62510,60929,323,61,389,6,121,681,62510,61673,837,0.974708047
2014,42,17,"Bucks County, Pennsylvania",626205,559457,23611,803,25974,46,5781,10533,626205,597352,28853,0.893408708
2014,42,19,"Butler County, Pennsylvania",185034,178464,2191,157,2001,52,315,1854,185034,182802,2232,0.964493012
2014,42,21,"Cambria County, Pennsylvania",140835,132205,4927,127,731,32,497,2316,140835,138717,2118,0.938722619
2014,42,23,"Cameron County, Pennsylvania",4939,4850,29,13,10,0,0,37,4939,4909,30,0.981980158
2014,42,25,"Carbon County, Pennsylvania",64874,62321,851,118,320,0,379,885,64874,62452,2422,0.960646792
2014,42,27,"Centre County, Pennsylvania",156240,138722,5524,314,8523,65,615,2477,156240,152090,4150,0.887877624
2014,42,29,"Chester County, Pennsylvania",506422,438969,30441,454,21528,67,5456,9507,506422,471880,34542,0.86680476
2014,42,31,"Clarion County, Pennsylvania",39437,38259,443,51,221,10,100,353,39437,39165,272,0.970129574
2014,42,33,"Clearfield County, Pennsylvania",81472,77842,1881,98,436,0,275,940,81472,79305,2167,0.955444815
2014,42,35,"Clinton County, Pennsylvania",39611,38161,607,31,195,10,62,545,39611,39112,499,0.963394007
2014,42,37,"Columbia County, Pennsylvania",67089,64049,1300,82,769,18,330,541,67089,65512,1577,0.954687057
2014,42,39,"Crawford County, Pennsylvania",87801,84279,1597,51,363,8,138,1365,87801,86835,966,0.959886562
2014,42,41,"Cumberland County, Pennsylvania",239420,215249,8022,223,7488,55,2552,5831,239420,232025,7395,0.899043522
2014,42,43,"Dauphin County, Pennsylvania",269946,195993,48237,498,9147,85,7135,8851,269946,249266,20680,0.726045209
2014,42,45,"Delaware County, Pennsylvania",560775,401730,114783,661,27939,70,4868,10724,560775,542502,18273,0.716383576
2014,42,47,"Elk County, Pennsylvania",31584,31045,195,67,118,0,66,93,31584,31373,211,0.982934397
2014,42,49,"Erie County, Pennsylvania",280132,246195,19892,761,3800,58,2580,6846,280132,269946,10186,0.87885354
2014,42,51,"Fayette County, Pennsylvania",135376,125855,5430,123,194,228,349,3197,135376,134117,1259,0.929669956
2014,42,53,"Forest County, Pennsylvania",7649,5430,1775,58,49,0,164,173,7649,7215,434,0.709896719
2014,42,55,"Franklin County, Pennsylvania",151517,141071,5604,376,1368,17,1192,1889,151517,144415,7102,0.931057241
2014,42,57,"Fulton County, Pennsylvania",14747,14338,205,36,22,8,35,103,14747,14599,148,0.972265546
2014,42,59,"Greene County, Pennsylvania",38171,35245,2052,173,73,3,121,504,38171,37675,496,0.923344948
2014,42,61,"Huntingdon County, Pennsylvania",45950,42559,2439,22,214,3,163,550,45950,45160,790,0.926202394
2014,42,63,"Indiana County, Pennsylvania",88301,83466,2226,201,993,44,359,1012,88301,87185,1116,0.945244108
2014,42,65,"Jefferson County, Pennsylvania",44935,44071,202,92,96,5,62,407,44935,44615,320,0.980772227
2014,42,67,"Juniata County, Pennsylvania",24793,24016,208,44,101,0,240,184,24793,24101,692,0.968660509
2014,42,69,"Lackawanna County, Pennsylvania",214023,199025,6241,307,4185,52,1552,2661,214023,202002,12021,0.929923419
2014,42,71,"Lancaster County, Pennsylvania",526839,468217,20803,938,10695,29,16153,10004,526839,477855,48984,0.888728815
2014,42,73,"Lawrence County, Pennsylvania",89859,83876,3662,62,302,8,431,1518,89859,88853,1006,0.93341791
2014,42,75,"Lebanon County, Pennsylvania",135184,119698,2550,168,1430,0,8138,3200,135184,121074,14110,0.885445023
2014,42,77,"Lehigh County, Pennsylvania",354537,283138,23075,800,10951,9,26304,10260,354537,282553,71984,0.798613403
2014,42,79,"Luzerne County, Pennsylvania",320392,291506,12063,944,3192,122,7595,4970,320392,294763,25629,0.909841694
2014,42,81,"Lycoming County, Pennsylvania",116676,107551,5522,148,687,32,607,2129,116676,114779,1897,0.921791971
2014,42,83,"McKean County, Pennsylvania",43024,40866,1036,115,212,0,235,560,43024,42195,829,0.949841949
2014,42,85,"Mercer County, Pennsylvania",115739,105827,6640,80,817,10,459,1906,115739,114371,1368,0.914359032
2014,42,87,"Mifflin County, Pennsylvania",46705,45553,331,28,206,7,73,507,46705,46121,584,0.975334547
2014,42,89,"Monroe County, Pennsylvania",168342,132910,22960,612,3428,85,3962,4385,168342,144932,23410,0.789523708
2014,42,91,"Montgomery County, Pennsylvania",809372,658510,71761,777,54828,113,6515,16868,809372,772782,36590,0.813606104
2014,42,93,"Montour County, Pennsylvania",18475,17489,303,11,487,0,39,146,18475,18083,392,0.946630582
2014,42,95,"Northampton County, Pennsylvania",299225,258567,15394,914,8084,50,7669,8547,299225,265443,33782,0.864122316
2014,42,97,"Northumberland County, Pennsylvania",94294,89921,2426,169,296,60,476,946,94294,91689,2605,0.953623772
2014,42,99,"Perry County, Pennsylvania",45788,44477,297,47,160,2,226,579,45788,45097,691,0.971368044
2014,42,101,"Philadelphia County, Pennsylvania",1546920,642945,665750,5289,103400,1538,87388,40610,1546920,1345345,201575,0.415629121
2014,42,103,"Pike County, Pennsylvania",56883,50800,3065,64,732,16,849,1357,56883,51415,5468,0.893061196
2014,42,105,"Potter County, Pennsylvania",17451,17076,89,27,52,3,46,158,17451,17260,191,0.97851126
2014,42,107,"Schuylkill County, Pennsylvania",147146,138936,4156,138,859,31,1209,1817,147146,142453,4693,0.944205075
2014,42,109,"Snyder County, Pennsylvania",39922,38706,360,25,278,5,199,349,39922,39136,786,0.969540604
2014,42,111,"Somerset County, Pennsylvania",77011,73765,1924,118,215,7,312,670,77011,76067,944,0.957850177
2014,42,113,"Sullivan County, Pennsylvania",6400,6070,166,20,36,33,12,63,6400,6322,78,0.9484375
2014,42,115,"Susquehanna County, Pennsylvania",42708,41833,233,108,100,0,110,324,42708,42037,671,0.979512035
2014,42,117,"Tioga County, Pennsylvania",42358,41199,252,72,218,5,26,586,42358,41832,526,0.97263799
2014,42,119,"Union County, Pennsylvania",44955,39409,3295,168,540,11,674,858,44955,42475,2480,0.876632188
2014,42,121,"Venango County, Pennsylvania",54265,52530,459,40,214,1,77,944,54265,53723,542,0.968027274
2014,42,123,"Warren County, Pennsylvania",41218,40291,257,108,167,0,72,323,41218,40864,354,0.977509826
2014,42,125,"Washington County, Pennsylvania",208157,195764,6580,82,1685,0,468,3578,208157,205413,2744,0.940463208
2014,42,127,"Wayne County, Pennsylvania",51967,48993,1783,95,291,10,275,520,51967,49975,1992,0.942771374
2014,42,129,"Westmoreland County, Pennsylvania",362587,344938,8518,488,3194,28,549,4872,362587,358970,3617,0.951324785
2014,42,131,"Wyoming County, Pennsylvania",28229,27482,187,10,135,0,81,334,28229,27753,476,0.973537851
2014,42,133,"York County, Pennsylvania",438052,388492,24005,367,5991,68,8788,10341,438052,411285,26767,0.886862747
2015,42,1,"Adams County, Pennsylvania",101767,93927,1576,96,740,0,3409,2019,101767,95154,6613,0.922961274
2015,42,3,"Allegheny County, Pennsylvania",1231145,994913,160131,1558,40317,249,4986,28991,1231145,1208608,22537,0.808120083
2015,42,5,"Armstrong County, Pennsylvania",67979,66452,636,12,126,0,152,601,67979,67534,445,0.977537181
2015,42,7,"Beaver County, Pennsylvania",169785,154413,10289,150,981,8,403,3541,169785,167445,2340,0.909461967
2015,42,9,"Bedford County, Pennsylvania",49086,47966,279,104,111,0,150,476,49086,48570,516,0.977182903
2015,42,11,"Berks County, Pennsylvania",413965,346412,20612,2712,5830,194,20891,17314,413965,338556,75409,0.836814707
2015,42,13,"Blair County, Pennsylvania",126448,121304,2016,64,900,0,270,1894,126448,125044,1404,0.959319246
2015,42,15,"Bradford County, Pennsylvania",62228,60559,335,95,388,12,166,673,62228,61345,883,0.973179276
2015,42,17,"Bucks County, Pennsylvania",626583,557637,24180,859,27263,23,6043,10578,626583,596875,29708,0.889965096
2015,42,19,"Butler County, Pennsylvania",185689,178867,2161,133,2005,54,252,2217,185689,183335,2354,0.963261152
2015,42,21,"Cambria County, Pennsylvania",139381,130808,4749,100,691,37,425,2571,139381,137232,2149,0.938492334
2015,42,23,"Cameron County, Pennsylvania",4869,4771,30,12,6,0,6,44,4869,4835,34,0.979872664
2015,42,25,"Carbon County, Pennsylvania",64634,62097,986,83,305,0,292,871,64634,62108,2526,0.960748213
2015,42,27,"Centre County, Pennsylvania",157823,139477,6063,298,8758,62,790,2375,157823,153506,4317,0.883755853
2015,42,29,"Chester County, Pennsylvania",509797,440588,30146,533,22803,102,5646,9979,509797,474218,35579,0.864242041
2015,42,31,"Clarion County, Pennsylvania",39454,38221,467,55,243,13,98,357,39454,39172,282,0.968748416
2015,42,33,"Clearfield County, Pennsylvania",81343,77458,1996,140,421,0,300,1028,81343,79093,2250,0.952239283
2015,42,35,"Clinton County, Pennsylvania",39614,38114,594,70,209,13,55,559,39614,39086,528,0.962134599
2015,42,37,"Columbia County, Pennsylvania",66912,63863,1256,103,794,12,322,562,66912,65268,1644,0.954432688
2015,42,39,"Crawford County, Pennsylvania",87343,83669,1628,57,438,7,183,1361,87343,86326,1017,0.957935954
2015,42,41,"Cumberland County, Pennsylvania",241427,216409,8240,202,8117,11,2638,5810,241427,233583,7844,0.896374473
2015,42,43,"Dauphin County, Pennsylvania",271094,195450,48800,565,9569,74,7842,8794,271094,249497,21597,0.720967635
2015,42,45,"Delaware County, Pennsylvania",561683,398489,116644,736,28444,89,5620,11661,561683,542610,19073,0.709455333
2015,42,47,"Elk County, Pennsylvania",31370,30784,159,71,132,0,82,142,31370,31147,223,0.981319732
2015,42,49,"Erie County, Pennsylvania",279858,244945,19777,788,3983,91,2445,7829,279858,269286,10572,0.875247447
2015,42,51,"Fayette County, Pennsylvania",134851,125308,5563,115,265,259,364,2977,134851,133501,1350,0.929233005
2015,42,53,"Forest County, Pennsylvania",7581,5006,2071,39,52,0,210,203,7581,7094,487,0.660335048
2015,42,55,"Franklin County, Pennsylvania",152285,141544,5811,369,1567,31,1141,1822,152285,144885,7400,0.929467774
2015,42,57,"Fulton County, Pennsylvania",14694,14255,210,35,21,13,45,115,14694,14537,157,0.97012386
2015,42,59,"Greene County, Pennsylvania",37938,34985,1924,68,83,3,208,667,37938,37081,857,0.922162476
2015,42,61,"Huntingdon County, Pennsylvania",45906,42302,2426,27,210,5,189,747,45906,45090,816,0.921491744
2015,42,63,"Indiana County, Pennsylvania",87895,83054,2205,166,983,27,277,1183,87895,86745,1150,0.944922919
2015,42,65,"Jefferson County, Pennsylvania",44756,43872,236,97,114,32,48,357,44756,44415,341,0.980248458
2015,42,67,"Juniata County, Pennsylvania",24829,24013,188,18,98,0,317,195,24829,24104,725,0.967135205
2015,42,69,"Lackawanna County, Pennsylvania",213459,197873,6588,264,4519,13,1435,2767,213459,200795,12664,0.926983636
2015,42,71,"Lancaster County, Pennsylvania",530216,469520,21375,751,10836,31,16890,10813,530216,479451,50765,0.885525899
2015,42,73,"Lawrence County, Pennsylvania",89162,83098,3387,49,372,7,489,1760,89162,88115,1047,0.931988964
2015,42,75,"Lebanon County, Pennsylvania",135776,119662,2700,123,1564,48,8646,3033,135776,120825,14951,0.881319232
2015,42,77,"Lehigh County, Pennsylvania",356756,282920,23299,675,11308,82,27951,10521,356756,281587,75169,0.793035016
2015,42,79,"Luzerne County, Pennsylvania",320095,287634,12608,914,3442,89,9955,5453,320095,292457,27638,0.898589481
2015,42,81,"Lycoming County, Pennsylvania",116656,107142,5640,218,779,17,757,2103,116656,114625,2031,0.918443972
2015,42,83,"McKean County, Pennsylvania",42884,40637,1017,114,209,0,262,645,42884,42023,861,0.947602836
2015,42,85,"Mercer County, Pennsylvania",115320,105372,6548,82,809,0,485,2024,115320,113839,1481,0.913735692
2015,42,87,"Mifflin County, Pennsylvania",46675,45428,336,18,225,40,95,533,46675,46066,609,0.973283342
2015,42,89,"Monroe County, Pennsylvania",167881,131113,22856,520,3712,74,4517,5089,167881,143972,23909,0.780987723
2015,42,91,"Montgomery County, Pennsylvania",812970,656037,72107,835,57141,204,8913,17733,812970,775393,37577,0.806963357
2015,42,93,"Montour County, Pennsylvania",18508,17463,311,3,537,0,23,171,18508,18064,444,0.94353793
2015,42,95,"Northampton County, Pennsylvania",299616,259095,15105,1019,8238,47,7191,8921,299616,264576,35040,0.864756889
2015,42,97,"Northumberland County, Pennsylvania",94006,89531,2684,220,326,58,349,838,94006,91274,2732,0.952396656
2015,42,99,"Perry County, Pennsylvania",45677,44406,394,48,141,2,148,538,45677,44944,733,0.97217418
2015,42,101,"Philadelphia County, Pennsylvania",1555072,648032,664911,5326,106753,1874,86668,41508,1555072,1347351,207721,0.416721541
2015,42,103,"Pike County, Pennsylvania",56632,50641,3325,103,870,15,688,990,56632,51050,5582,0.894211753
2015,42,105,"Potter County, Pennsylvania",17377,16987,100,35,60,3,47,145,17377,17184,193,0.97755654
2015,42,107,"Schuylkill County, Pennsylvania",146360,137921,4041,172,732,35,1469,1990,146360,141358,5002,0.942340803
2015,42,109,"Snyder County, Pennsylvania",40046,38769,405,30,274,6,189,373,40046,39224,822,0.968111672
2015,42,111,"Somerset County, Pennsylvania",76617,73304,2023,65,233,4,315,673,76617,75624,993,0.956758944
2015,42,113,"Sullivan County, Pennsylvania",6381,6041,157,16,31,31,33,72,6381,6269,112,0.946716816
2015,42,115,"Susquehanna County, Pennsylvania",42369,41464,231,80,117,17,128,332,42369,41667,702,0.978640043
2015,42,117,"Tioga County, Pennsylvania",42284,41064,304,51,225,16,31,593,42284,41733,551,0.971147479
2015,42,119,"Union County, Pennsylvania",44958,39518,3166,195,562,12,650,855,44958,42432,2526,0.878998176
2015,42,121,"Venango County, Pennsylvania",53906,52192,479,35,209,2,78,911,53906,53344,562,0.968203911
2015,42,123,"Warren County, Pennsylvania",40962,40083,202,58,200,0,36,383,40962,40579,383,0.978541087
2015,42,125,"Washington County, Pennsylvania",208226,195642,6137,152,1777,25,471,4022,208226,205291,2935,0.939565664
2015,42,127,"Wayne County, Pennsylvania",51642,48498,1812,108,278,9,306,631,51642,49568,2074,0.939119321
2015,42,129,"Westmoreland County, Pennsylvania",361251,343203,8537,410,3037,29,550,5485,361251,357482,3769,0.950040277
2015,42,131,"Wyoming County, Pennsylvania",28147,27378,205,16,123,0,77,348,28147,27648,499,0.972679149
2015,42,133,"York County, Pennsylvania",439660,390542,25769,406,5989,68,6963,9923,439660,411326,28334,0.888281854
2016,42,1,"Adams County, Pennsylvania",101759,93855,1465,71,669,0,3561,2138,101759,95038,6721,0.922326281
2016,42,3,"Allegheny County, Pennsylvania",1230360,992002,159592,1435,41764,299,5083,30185,1230360,1207105,23255,0.80626971
2016,42,5,"Armstrong County, Pennsylvania",67512,66101,634,14,182,0,40,541,67512,67056,456,0.979100012
2016,42,7,"Beaver County, Pennsylvania",169205,153775,10273,78,804,33,532,3710,169205,166796,2409,0.908808841
2016,42,9,"Bedford County, Pennsylvania",48852,47729,263,97,111,0,134,518,48852,48307,545,0.9770122
2016,42,11,"Berks County, Pennsylvania",414097,346269,20009,3550,5733,160,17449,20927,414097,336151,77946,0.836202629
2016,42,13,"Blair County, Pennsylvania",125917,120688,2018,27,933,48,338,1865,125917,124487,1430,0.958472645
2016,42,15,"Bradford County, Pennsylvania",61808,60019,351,64,403,9,232,730,61808,60922,886,0.971055527
2016,42,17,"Bucks County, Pennsylvania",626220,556082,24226,909,27680,25,6069,11229,626220,595821,30399,0.887997828
2016,42,19,"Butler County, Pennsylvania",185974,178887,2038,144,1919,55,421,2510,185974,183534,2440,0.961892523
2016,42,21,"Cambria County, Pennsylvania",137762,129288,4592,71,659,58,395,2699,137762,135660,2102,0.938488117
2016,42,23,"Cameron County, Pennsylvania",4807,4702,29,7,11,0,5,53,4807,4768,39,0.978156855
2016,42,25,"Carbon County, Pennsylvania",64330,61831,1161,102,301,0,207,728,64330,61714,2616,0.961153428
2016,42,27,"Centre County, Pennsylvania",159178,140074,6043,249,9234,70,837,2671,159178,154788,4390,0.879983415
2016,42,29,"Chester County, Pennsylvania",512028,441027,29907,624,23718,123,5827,10802,512028,475867,36161,0.861333755
2016,42,31,"Clarion County, Pennsylvania",38939,37669,462,52,239,13,124,380,38939,38638,301,0.967384884
2016,42,33,"Clearfield County, Pennsylvania",81170,77296,2026,138,429,0,282,999,81170,78861,2309,0.952273007
2016,42,35,"Clinton County, Pennsylvania",39536,38030,645,54,241,15,105,446,39536,38999,537,0.961908134
2016,42,37,"Columbia County, Pennsylvania",66772,63555,1231,107,773,22,444,640,66772,65087,1685,0.951821123
2016,42,39,"Crawford County, Pennsylvania",87027,83395,1646,39,414,17,174,1342,87027,86010,1017,0.958265826
2016,42,41,"Cumberland County, Pennsylvania",243838,217203,8668,183,9019,13,2990,5762,243838,235556,8282,0.890767641
2016,42,43,"Dauphin County, Pennsylvania",271962,195198,49840,634,10281,63,7263,8683,271962,249547,22415,0.717739978
2016,42,45,"Delaware County, Pennsylvania",562316,395791,118089,832,29581,104,5839,12080,562316,542788,19528,0.703858684
2016,42,47,"Elk County, Pennsylvania",31111,30499,155,69,141,0,83,164,31111,30888,223,0.980328501
2016,42,49,"Erie County, Pennsylvania",279133,243823,19863,772,4307,102,2421,7845,279133,268289,10844,0.873501163
2016,42,51,"Fayette County, Pennsylvania",134229,124542,5450,80,230,322,371,3234,134229,132844,1385,0.927832287
2016,42,53,"Forest County, Pennsylvania",7493,4653,2371,34,43,0,235,157,7493,6928,565,0.620979581
2016,42,55,"Franklin County, Pennsylvania",152707,142099,5867,307,1581,47,876,1930,152707,144983,7724,0.930533636
2016,42,57,"Fulton County, Pennsylvania",14653,14233,226,33,32,14,1,114,14653,14495,158,0.971336928
2016,42,59,"Greene County, Pennsylvania",37669,35066,1650,21,108,3,134,687,37669,37133,536,0.930898086
2016,42,61,"Huntingdon County, Pennsylvania",45844,42153,2501,22,226,8,191,743,45844,44991,853,0.919487828
2016,42,63,"Indiana County, Pennsylvania",87491,82716,2136,182,999,35,279,1144,87491,86385,1106,0.945422958
2016,42,65,"Jefferson County, Pennsylvania",44575,43697,284,104,109,23,48,310,44575,44212,363,0.98030286
2016,42,67,"Juniata County, Pennsylvania",24811,23993,234,9,117,0,295,163,24811,24045,766,0.967030752
2016,42,69,"Lackawanna County, Pennsylvania",213006,197017,6337,215,4889,22,1173,3353,213006,199544,13462,0.924936387
2016,42,71,"Lancaster County, Pennsylvania",533110,472127,22015,918,10986,24,15877,11163,533110,481027,52083,0.885608974
2016,42,73,"Lawrence County, Pennsylvania",88528,82545,3366,47,407,0,454,1709,88528,87425,1103,0.932416862
2016,42,75,"Lebanon County, Pennsylvania",136950,120440,2828,118,1658,42,8908,2956,136950,120943,16007,0.879445053
2016,42,77,"Lehigh County, Pennsylvania",358792,282360,24174,701,11680,134,29356,10387,358792,280474,78318,0.786974069
2016,42,79,"Luzerne County, Pennsylvania",318917,285749,12798,882,3480,77,10254,5677,318917,289120,29797,0.895998018
2016,42,81,"Lycoming County, Pennsylvania",116313,106874,5645,185,782,9,686,2132,116313,114238,2075,0.91884828
2016,42,83,"McKean County, Pennsylvania",42609,40254,1102,90,210,19,249,685,42609,41722,887,0.944729987
2016,42,85,"Mercer County, Pennsylvania",114598,104771,6558,80,766,3,368,2052,114598,113084,1514,0.914248067
2016,42,87,"Mifflin County, Pennsylvania",46585,45239,301,25,235,34,181,570,46585,45952,633,0.971106579
2016,42,89,"Monroe County, Pennsylvania",167126,129349,23320,539,3563,84,5077,5194,167126,142652,24474,0.773960964
2016,42,91,"Montgomery County, Pennsylvania",815876,655493,72312,895,58140,213,9691,19132,815876,777276,38600,0.803422334
2016,42,93,"Montour County, Pennsylvania",18404,17358,334,6,573,0,9,124,18404,17963,441,0.943164529
2016,42,95,"Northampton County, Pennsylvania",300520,259549,15282,1132,8132,53,6790,9582,300520,264226,36294,0.863666312
2016,42,97,"Northumberland County, Pennsylvania",93590,89072,2668,257,332,73,331,857,93590,90738,2852,0.951725612
2016,42,99,"Perry County, Pennsylvania",45647,44455,408,66,153,0,74,491,45647,44878,769,0.973886564
2016,42,101,"Philadelphia County, Pennsylvania",1559938,643570,668573,5734,107669,1663,89089,43640,1559938,1345168,214770,0.412561268
2016,42,103,"Pike County, Pennsylvania",56210,50416,3259,102,793,35,484,1121,56210,50553,5657,0.896922256
2016,42,105,"Potter County, Pennsylvania",17239,16807,93,28,62,0,65,184,17239,17032,207,0.974940542
2016,42,107,"Schuylkill County, Pennsylvania",145503,136781,4038,226,752,38,1662,2006,145503,140284,5219,0.940056219
2016,42,109,"Snyder County, Pennsylvania",40246,38891,394,36,300,0,234,391,40246,39382,864,0.966332058
2016,42,111,"Somerset County, Pennsylvania",76201,72755,2074,74,245,15,308,730,76201,75180,1021,0.954777496
2016,42,113,"Sullivan County, Pennsylvania",6302,5951,156,24,21,31,36,83,6302,6193,109,0.944303396
2016,42,115,"Susquehanna County, Pennsylvania",41832,40887,235,60,150,15,150,335,41832,41119,713,0.977409639
2016,42,117,"Tioga County, Pennsylvania",42031,40821,222,62,231,16,118,561,42031,41508,523,0.971211725
2016,42,119,"Union County, Pennsylvania",45178,39673,3132,188,692,14,627,852,45178,42606,2572,0.878148656
2016,42,121,"Venango County, Pennsylvania",53460,51796,445,29,183,0,69,938,53460,52893,567,0.968873924
2016,42,123,"Warren County, Pennsylvania",40649,39766,204,34,217,0,31,397,40649,40243,406,0.978277448
2016,42,125,"Washington County, Pennsylvania",208269,195449,5987,184,1926,23,557,4143,208269,205136,3133,0.938444992
2016,42,127,"Wayne County, Pennsylvania",51307,48155,1823,109,313,8,259,640,51307,49227,2080,0.938565888
2016,42,129,"Westmoreland County, Pennsylvania",359377,341205,8673,324,3243,40,732,5160,359377,355552,3825,0.949434716
2016,42,131,"Wyoming County, Pennsylvania",27975,27239,249,17,115,0,67,288,27975,27477,498,0.973690795
2016,42,133,"York County, Pennsylvania",440604,391989,25613,446,6090,97,6263,10106,440604,411305,29299,0.889662826
2017,42,1,"Adams County, Pennsylvania",101589,93849,1469,52,727,0,3223,2269,101589,94698,6891,0.923810649
2017,42,3,"Allegheny County, Pennsylvania",1229605,987932,158779,1417,43520,335,4949,32673,1229605,1205529,24076,0.803454768
2017,42,5,"Armstrong County, Pennsylvania",66737,65307,637,8,160,0,51,574,66737,66265,472,0.978572606
2017,42,7,"Beaver County, Pennsylvania",168161,152373,10016,120,793,71,638,4150,168161,165675,2486,0.906113784
2017,42,9,"Bedford County, Pennsylvania",48891,47728,217,61,118,0,137,630,48891,48334,557,0.976212391
2017,42,11,"Berks County, Pennsylvania",415500,344016,21089,3676,5848,118,16967,23786,415500,334102,81398,0.827956679
2017,42,13,"Blair County, Pennsylvania",124736,119348,1862,26,872,45,429,2154,124736,123269,1467,0.956804772
2017,42,15,"Bradford County, Pennsylvania",61546,59678,362,39,365,14,260,828,61546,60665,881,0.969648718
2017,42,17,"Bucks County, Pennsylvania",626486,554141,24757,1081,28758,22,6496,11231,626486,595088,31398,0.884522559
2017,42,19,"Butler County, Pennsylvania",185984,178768,1739,116,2142,66,358,2795,185984,183391,2593,0.961200964
2017,42,21,"Cambria County, Pennsylvania",135871,127405,4521,61,675,22,390,2797,135871,133775,2096,0.937690898
2017,42,23,"Cameron County, Pennsylvania",4754,4625,55,10,21,0,7,36,4754,4715,39,0.972864956
2017,42,25,"Carbon County, Pennsylvania",63987,61552,1165,20,288,7,229,726,63987,61260,2727,0.961945395
2017,42,27,"Centre County, Pennsylvania",160646,140986,6397,206,9661,70,799,2527,160646,156087,4559,0.877619113
2017,42,29,"Chester County, Pennsylvania",514652,441502,30201,638,25105,116,6154,10936,514652,477388,37264,0.857865121
2017,42,31,"Clarion County, Pennsylvania",38747,37509,446,72,211,16,51,442,38747,38436,311,0.968049139
2017,42,33,"Clearfield County, Pennsylvania",80539,76678,2211,157,464,0,216,813,80539,78209,2330,0.952060492
2017,42,35,"Clinton County, Pennsylvania",39321,37849,594,55,277,4,95,447,39321,38761,560,0.962564533
2017,42,37,"Columbia County, Pennsylvania",66615,63341,1220,84,777,20,497,676,66615,64893,1722,0.95085191
2017,42,39,"Crawford County, Pennsylvania",86847,83110,1682,44,360,26,261,1364,86847,85801,1046,0.956970304
2017,42,41,"Cumberland County, Pennsylvania",245801,218227,9105,239,9723,11,2826,5670,245801,237103,8698,0.887819822
2017,42,43,"Dauphin County, Pennsylvania",273329,195064,51184,540,10697,67,7012,8765,273329,250014,23315,0.713660095
2017,42,45,"Delaware County, Pennsylvania",563384,392912,119269,749,30739,159,6445,13111,563384,543285,20099,0.697414197
2017,42,47,"Elk County, Pennsylvania",30781,30230,157,72,137,0,11,174,30781,30548,233,0.982099347
2017,42,49,"Erie County, Pennsylvania",277794,242063,19850,734,4487,59,2601,8000,277794,266642,11152,0.871375912
2017,42,51,"Fayette County, Pennsylvania",133160,123482,5299,66,270,292,359,3392,133160,131718,1442,0.927320517
2017,42,53,"Forest County, Pennsylvania",7388,4617,2362,23,53,0,202,131,7388,6872,516,0.624932323
2017,42,55,"Franklin County, Pennsylvania",153003,142343,6033,300,1526,60,827,1914,153003,144940,8063,0.930328164
2017,42,57,"Fulton County, Pennsylvania",14631,14191,234,37,34,16,11,108,14631,14457,174,0.969926868
2017,42,59,"Greene County, Pennsylvania",37338,35186,1270,36,131,0,93,622,37338,36787,551,0.942364347
2017,42,61,"Huntingdon County, Pennsylvania",45686,41966,2446,30,235,9,171,829,45686,44837,849,0.918574618
2017,42,63,"Indiana County, Pennsylvania",86551,81886,2001,181,941,11,170,1361,86551,85453,1098,0.946101143
2017,42,65,"Jefferson County, Pennsylvania",44258,43390,265,109,114,14,9,357,44258,43890,368,0.980387727
2017,42,67,"Juniata County, Pennsylvania",24448,23656,266,4,82,0,268,172,24448,23654,794,0.967604712
2017,42,69,"Lackawanna County, Pennsylvania",211960,195401,6100,180,5393,28,1289,3569,211960,197784,14176,0.921876769
2017,42,71,"Lancaster County, Pennsylvania",536494,475145,22900,826,11493,53,15070,11007,536494,482702,53792,0.885648302
2017,42,73,"Lawrence County, Pennsylvania",88231,82074,3151,55,400,0,559,1992,88231,87080,1151,0.930217271
2017,42,75,"Lebanon County, Pennsylvania",137616,120081,3021,123,1805,82,9574,2930,137616,120821,16795,0.872580223
2017,42,77,"Lehigh County, Pennsylvania",360774,283607,24878,822,11971,112,28282,11102,360774,278669,82105,0.786107092
2017,42,79,"Luzerne County, Pennsylvania",318222,283692,13687,750,3783,75,10536,5699,318222,286034,32188,0.891490846
2017,42,81,"Lycoming County, Pennsylvania",115398,106211,5711,173,704,12,523,2064,115398,113194,2204,0.920388568
2017,42,83,"McKean County, Pennsylvania",42070,39798,1111,62,183,17,252,647,42070,41187,883,0.945994771
2017,42,85,"Mercer County, Pennsylvania",113623,103680,6567,103,749,4,490,2030,113623,112040,1583,0.912491309
2017,42,87,"Mifflin County, Pennsylvania",46452,45107,306,39,262,43,137,558,46452,45782,670,0.97104538
2017,42,89,"Monroe County, Pennsylvania",167306,128746,23629,720,3788,31,5254,5138,167306,142326,24980,0.769524106
2017,42,91,"Montgomery County, Pennsylvania",818677,653904,73771,838,60112,197,10302,19553,818677,778706,39971,0.798732589
2017,42,93,"Montour County, Pennsylvania",18302,17274,329,2,566,0,14,117,18302,17837,465,0.943831275
2017,42,95,"Northampton County, Pennsylvania",300941,259314,16204,1100,8328,53,6303,9639,300941,263598,37343,0.861677206
2017,42,97,"Northumberland County, Pennsylvania",93038,88534,2529,268,323,95,389,900,93038,90098,2940,0.951589673
2017,42,99,"Perry County, Pennsylvania",45878,44591,416,86,166,0,131,488,45878,45069,809,0.971947339
2017,42,101,"Philadelphia County, Pennsylvania",1569657,652204,668123,5641,111487,831,87384,43987,1569657,1347880,221777,0.415507337
2017,42,103,"Pike County, Pennsylvania",55687,49540,3382,69,817,19,838,1022,55687,49930,5757,0.889615171
2017,42,105,"Potter County, Pennsylvania",17070,16607,63,38,56,0,40,266,17070,16859,211,0.972876391
2017,42,107,"Schuylkill County, Pennsylvania",144287,135378,4052,244,717,31,1705,2160,144287,138751,5536,0.938255006
2017,42,109,"Snyder County, Pennsylvania",40570,39197,361,24,297,0,217,474,40570,39686,884,0.966157259
2017,42,111,"Somerset County, Pennsylvania",75619,72098,2080,50,292,30,327,742,75619,74542,1077,0.953437628
2017,42,113,"Sullivan County, Pennsylvania",6192,5818,158,32,28,0,46,110,6192,6082,110,0.939599483
2017,42,115,"Susquehanna County, Pennsylvania",41716,40699,262,84,160,22,173,316,41716,41020,696,0.975620865
2017,42,117,"Tioga County, Pennsylvania",41550,40349,238,50,224,15,114,560,41550,41033,517,0.971095066
2017,42,119,"Union County, Pennsylvania",45056,39384,2990,245,783,14,839,801,45056,42495,2561,0.874112216
2017,42,121,"Venango County, Pennsylvania",52880,51252,484,22,196,0,80,846,52880,52306,574,0.969213313
2017,42,123,"Warren County, Pennsylvania",40345,39488,185,47,209,0,33,383,40345,39937,408,0.97875821
2017,42,125,"Washington County, Pennsylvania",207661,194604,6286,236,2010,22,500,4003,207661,204403,3258,0.937123485
2017,42,127,"Wayne County, Pennsylvania",51656,48572,1764,143,301,0,193,683,51656,49512,2144,0.940297352
2017,42,129,"Westmoreland County, Pennsylvania",356835,338659,8432,317,3093,54,556,5724,356835,352932,3903,0.949063293
2017,42,131,"Wyoming County, Pennsylvania",27760,26991,188,22,101,0,75,383,27760,27263,497,0.972298271
2017,42,133,"York County, Pennsylvania",442216,393265,25093,521,6417,175,5778,10967,442216,411573,30643,0.889305226
2018,42,1,"Adams County, Pennsylvania",102023,94449,1479,67,705,0,2991,2332,102023,94978,7045,0.925761838
2018,42,3,"Allegheny County, Pennsylvania",1225561,981847,157891,1354,44791,334,5670,33674,1225561,1200636,24925,0.801140865
2018,42,5,"Armstrong County, Pennsylvania",66331,64771,591,19,193,0,53,704,66331,65839,492,0.976481585
2018,42,7,"Beaver County, Pennsylvania",166896,150877,9844,180,858,78,713,4346,166896,164355,2541,0.904018071
2018,42,9,"Bedford County, Pennsylvania",48611,47439,262,54,187,0,115,554,48611,48036,575,0.975890231
2018,42,11,"Berks County, Pennsylvania",416642,344336,21739,2983,5867,39,18350,23328,416642,331894,84748,0.826455326
2018,42,13,"Blair County, Pennsylvania",123842,118279,2008,42,866,55,462,2130,123842,122334,1508,0.95507986
2018,42,15,"Bradford County, Pennsylvania",61304,59418,270,39,415,6,236,920,61304,60424,880,0.969235286
2018,42,17,"Bucks County, Pennsylvania",626370,551303,25066,1032,29423,139,7321,12086,626370,594132,32238,0.880155499
2018,42,19,"Butler County, Pennsylvania",186566,178940,1754,80,2353,46,399,2994,186566,183881,2685,0.959124385
2018,42,21,"Cambria County, Pennsylvania",134550,125997,4479,72,640,40,479,2843,134550,132425,2125,0.936432553
2018,42,23,"Cameron County, Pennsylvania",4686,4527,5,20,38,0,7,89,4686,4645,41,0.966069142
2018,42,25,"Carbon County, Pennsylvania",63931,61489,1269,23,323,8,117,702,63931,61046,2885,0.961802568
2018,42,27,"Centre County, Pennsylvania",161443,141282,6396,154,10245,49,934,2383,161443,156763,4680,0.875120011
2018,42,29,"Chester County, Pennsylvania",517156,441326,30706,557,26777,120,6601,11069,517156,479298,37858,0.85337113
2018,42,31,"Clarion County, Pennsylvania",38827,37487,426,83,207,24,66,534,38827,38493,334,0.965487934
2018,42,33,"Clearfield County, Pennsylvania",80216,76181,2249,181,397,0,164,1044,80216,77875,2341,0.949698315
2018,42,35,"Clinton County, Pennsylvania",39074,37595,637,80,298,11,72,381,39074,38497,577,0.962148743
2018,42,37,"Columbia County, Pennsylvania",66220,62838,1221,82,740,26,609,704,66220,64453,1767,0.948927816
2018,42,39,"Crawford County, Pennsylvania",86164,82348,1561,38,401,31,256,1529,86164,85080,1084,0.955712362
2018,42,41,"Cumberland County, Pennsylvania",247433,218340,9402,312,10078,55,2984,6262,247433,238215,9218,0.882420696
2018,42,43,"Dauphin County, Pennsylvania",274515,194998,52691,662,11431,79,6213,8441,274515,250075,24440,0.710336411
2018,42,45,"Delaware County, Pennsylvania",563527,391240,120783,968,31210,198,5430,13698,563527,542830,20697,0.694270195
2018,42,47,"Elk County, Pennsylvania",30608,30000,167,76,160,0,26,179,30608,30367,241,0.980135912
2018,42,49,"Erie County, Pennsylvania",275972,239451,20071,657,4586,68,2957,8182,275972,264605,11367,0.867664111
2018,42,51,"Fayette County, Pennsylvania",132289,122463,5192,48,434,346,425,3381,132289,130786,1503,0.925723227
2018,42,53,"Forest County, Pennsylvania",7351,4753,2205,23,23,0,135,212,7351,6885,466,0.646578697
2018,42,55,"Franklin County, Pennsylvania",153751,142843,5882,223,1265,16,692,2830,153751,145397,8354,0.92905412
2018,42,57,"Fulton County, Pennsylvania",14506,13980,309,36,43,0,14,124,14506,14430,76,0.963739142
2018,42,59,"Greene County, Pennsylvania",37144,34983,1217,34,124,8,110,668,37144,36582,562,0.941821021
2018,42,61,"Huntingdon County, Pennsylvania",45421,41637,2485,52,240,7,214,786,45421,44563,858,0.916690518
2018,42,63,"Indiana County, Pennsylvania",85755,81170,1938,210,839,15,241,1342,85755,84648,1107,0.94653373
2018,42,65,"Jefferson County, Pennsylvania",44084,43169,235,78,127,21,47,407,44084,43701,383,0.97924417
2018,42,67,"Juniata County, Pennsylvania",24562,23744,256,0,123,0,276,163,24562,23690,872,0.966696523
2018,42,69,"Lackawanna County, Pennsylvania",211454,193707,6005,127,5598,48,1614,4355,211454,196383,15071,0.916071581
2018,42,71,"Lancaster County, Pennsylvania",538347,476443,23028,875,11691,94,14778,11438,538347,483134,55213,0.885010969
2018,42,73,"Lawrence County, Pennsylvania",87382,81402,3207,84,425,0,319,1945,87382,86182,1200,0.931564853
2018,42,75,"Lebanon County, Pennsylvania",138674,120787,3335,91,1937,59,10046,2419,138674,121132,17542,0.871014033
2018,42,77,"Lehigh County, Pennsylvania",362613,284590,25293,1148,12165,127,26767,12523,362613,277167,85446,0.784831211
2018,42,79,"Luzerne County, Pennsylvania",317884,281858,14667,661,3926,181,10577,6014,317884,282809,35075,0.886669351
2018,42,81,"Lycoming County, Pennsylvania",114859,105534,5518,180,811,18,632,2166,114859,112581,2278,0.918813502
2018,42,83,"McKean County, Pennsylvania",41806,39500,1040,28,186,15,328,709,41806,40933,873,0.944840454
2018,42,85,"Mercer County, Pennsylvania",112630,102752,6386,123,776,4,335,2254,112630,111009,1621,0.912296901
2018,42,87,"Mifflin County, Pennsylvania",46362,44917,367,73,88,26,229,662,46362,45666,696,0.968832233
2018,42,89,"Monroe County, Pennsylvania",167586,128602,24147,576,4041,61,5177,4982,167586,141756,25830,0.767379137
2018,42,91,"Montgomery County, Pennsylvania",821301,652245,74569,1044,61405,265,11030,20743,821301,780139,41162,0.794160728
2018,42,93,"Montour County, Pennsylvania",18294,16911,323,6,866,0,17,171,18294,18123,171,0.924401443
2018,42,95,"Northampton County, Pennsylvania",301778,259902,16649,850,8295,114,5510,10458,301778,263061,38717,0.861235743
2018,42,97,"Northumberland County, Pennsylvania",92325,87514,2469,253,315,76,483,1215,92325,89319,3006,0.947890604
2018,42,99,"Perry County, Pennsylvania",45924,44567,429,88,182,0,165,493,45924,45070,854,0.97045118
2018,42,101,"Philadelphia County, Pennsylvania",1575522,648890,666047,5843,112651,769,93651,47671,1575522,1347811,227711,0.41185715
2018,42,103,"Pike County, Pennsylvania",55498,49429,3438,71,844,30,711,975,55498,49587,5911,0.890644708
2018,42,105,"Potter County, Pennsylvania",16937,16480,68,39,58,0,38,254,16937,16719,218,0.973017654
2018,42,107,"Schuylkill County, Pennsylvania",143555,134386,4322,303,736,15,1692,2101,143555,137685,5870,0.93612901
2018,42,109,"Snyder County, Pennsylvania",40466,39044,415,12,275,0,234,486,40466,39562,904,0.964859388
2018,42,111,"Somerset County, Pennsylvania",74949,71364,1941,60,297,24,349,914,74949,73845,1104,0.952167474
2018,42,113,"Sullivan County, Pennsylvania",6177,5809,192,16,26,6,50,78,6177,6043,134,0.940424154
2018,42,115,"Susquehanna County, Pennsylvania",41340,40307,300,35,138,19,164,377,41340,40642,698,0.975012095
2018,42,117,"Tioga County, Pennsylvania",41226,40026,273,45,233,11,101,537,41226,40706,520,0.970892155
2018,42,119,"Union County, Pennsylvania",45114,39188,2882,323,746,26,1038,911,45114,42471,2643,0.86864388
2018,42,121,"Venango County, Pennsylvania",52376,50691,434,12,191,0,131,917,52376,51809,567,0.967828777
2018,42,123,"Warren County, Pennsylvania",40035,39110,191,51,211,0,79,393,40035,39615,420,0.976895217
2018,42,125,"Washington County, Pennsylvania",207547,194228,6455,192,2023,37,489,4123,207547,204130,3417,0.935826584
2018,42,127,"Wayne County, Pennsylvania",51536,48418,1668,116,313,9,164,848,51536,49316,2220,0.939498603
2018,42,129,"Westmoreland County, Pennsylvania",354751,336272,8530,320,3243,56,712,5618,354751,350696,4055,0.947909942
2018,42,131,"Wyoming County, Pennsylvania",27588,26827,255,23,63,0,49,371,27588,27080,508,0.972415543
2018,42,133,"York County, Pennsylvania",444014,394242,25790,660,6730,198,5656,10738,444014,411986,32028,0.887904435
2019,42,1,"Adams County, Pennsylvania",102470,95038,1468,129,732,0,2740,2363,102470,95203,7267,0.927471455
2019,42,3,"Allegheny County, Pennsylvania",1221744,976172,157060,1368,45389,362,6088,35305,1221744,1195967,25777,0.798998808
2019,42,5,"Armstrong County, Pennsylvania",65867,64325,548,26,201,0,34,733,65867,65358,509,0.976589187
2019,42,7,"Beaver County, Pennsylvania",165833,149833,9648,147,880,93,624,4608,165833,163172,2661,0.903517394
2019,42,9,"Bedford County, Pennsylvania",48337,47175,310,72,191,0,105,484,48337,47748,589,0.975960444
2019,42,11,"Berks County, Pennsylvania",418025,344474,22697,2474,5850,63,23405,19062,418025,330111,87914,0.824051193
2019,42,13,"Blair County, Pennsylvania",123157,117570,2053,158,756,60,426,2134,123157,121595,1562,0.954635141
2019,42,15,"Bradford County, Pennsylvania",60963,58934,337,30,437,100,317,808,60963,60062,901,0.966717517
2019,42,17,"Bucks County, Pennsylvania",626806,548891,25325,1065,30282,107,8339,12797,626806,593467,33339,0.875695191
2019,42,19,"Butler County, Pennsylvania",186899,179098,1821,83,2336,25,394,3142,186899,184109,2790,0.958260879
2019,42,21,"Cambria County, Pennsylvania",133009,124399,4618,66,579,38,488,2821,133009,130835,2174,0.935267538
2019,42,23,"Cameron County, Pennsylvania",4611,4449,4,2,39,0,9,108,4611,4560,51,0.964866623
2019,42,25,"Carbon County, Pennsylvania",63887,61135,1485,126,360,8,238,535,63887,60852,3035,0.956923944
2019,42,27,"Centre County, Pennsylvania",161960,141849,6173,107,9923,52,922,2934,161960,157183,4777,0.875827365
2019,42,29,"Chester County, Pennsylvania",519560,440431,30438,594,28448,126,7577,11946,519560,481038,38522,0.847699977
2019,42,31,"Clarion County, Pennsylvania",38715,37325,527,53,231,21,24,534,38715,38342,373,0.964096603
2019,42,33,"Clearfield County, Pennsylvania",79908,75643,2302,192,401,0,224,1146,79908,77545,2363,0.94662612
2019,42,35,"Clinton County, Pennsylvania",38915,37447,696,102,323,11,83,253,38915,38325,590,0.962276757
2019,42,37,"Columbia County, Pennsylvania",65715,62515,1177,78,735,20,460,730,65715,63905,1810,0.951304877
2019,42,39,"Crawford County, Pennsylvania",85665,81795,1384,33,485,23,248,1697,85665,84546,1119,0.954824024
2019,42,41,"Cumberland County, Pennsylvania",249328,218742,9884,347,10631,52,2962,6710,249328,239513,9815,0.877326253
2019,42,43,"Dauphin County, Pennsylvania",275632,193282,53826,719,12073,78,7074,8580,275632,250175,25457,0.701232078
2019,42,45,"Delaware County, Pennsylvania",564554,388106,121802,1167,32094,222,6515,14648,564554,543082,21472,0.687455939
2019,42,47,"Elk County, Pennsylvania",30340,29663,268,42,153,28,21,165,30340,30093,247,0.977686223
2019,42,49,"Erie County, Pennsylvania",273835,236779,19663,721,4538,63,3350,8721,273835,262303,11532,0.864677634
2019,42,51,"Fayette County, Pennsylvania",131302,121435,5502,55,474,81,615,3140,131302,129691,1611,0.92485263
2019,42,53,"Forest County, Pennsylvania",7313,5095,1893,9,8,0,115,193,7313,6908,405,0.696704499
2019,42,55,"Franklin County, Pennsylvania",154147,142470,5774,388,1296,22,977,3220,154147,145453,8694,0.924247634
2019,42,57,"Fulton County, Pennsylvania",14506,14009,221,42,38,0,35,161,14506,14332,174,0.965738315
2019,42,59,"Greene County, Pennsylvania",36870,34669,1152,11,132,7,104,795,36870,36307,563,0.94030377
2019,42,61,"Huntingdon County, Pennsylvania",45369,41519,2548,75,269,7,200,751,45369,44473,896,0.915140294
2019,42,63,"Indiana County, Pennsylvania",85032,80516,1955,56,840,16,259,1390,85032,83931,1101,0.946890582
2019,42,65,"Jefferson County, Pennsylvania",43846,42903,231,44,121,19,67,461,43846,43443,403,0.978492907
2019,42,67,"Juniata County, Pennsylvania",24624,23882,270,0,97,0,210,165,24624,23683,941,0.969866797
2019,42,69,"Lackawanna County, Pennsylvania",210652,191885,5898,108,5921,87,1978,4775,210652,194807,15845,0.910909937
2019,42,71,"Lancaster County, Pennsylvania",540999,478516,22580,823,11863,132,13655,13430,540999,484284,56715,0.884504408
2019,42,73,"Lawrence County, Pennsylvania",86727,80717,3153,77,403,0,276,2101,86727,85466,1261,0.930702088
2019,42,75,"Lebanon County, Pennsylvania",139729,121005,3449,132,1989,65,10134,2955,139729,121401,18328,0.865997753
2019,42,77,"Lehigh County, Pennsylvania",365052,289545,26932,1030,12220,178,22460,12687,365052,275685,89367,0.793160974
2019,42,79,"Luzerne County, Pennsylvania",317663,278303,16212,626,3968,176,11920,6458,317663,279873,37790,0.876095107
2019,42,81,"Lycoming County, Pennsylvania",114330,105254,5665,221,809,25,351,2005,114330,112040,2290,0.920615761
2019,42,83,"McKean County, Pennsylvania",41401,39132,1048,63,212,21,309,616,41401,40533,868,0.945194561
2019,42,85,"Mercer County, Pennsylvania",111518,101788,6358,115,822,3,275,2157,111518,109848,1670,0.912749511
2019,42,87,"Mifflin County, Pennsylvania",46276,44839,248,92,153,29,232,683,46276,45552,724,0.968947186
2019,42,89,"Monroe County, Pennsylvania",168032,128246,24704,573,4096,51,5088,5274,168032,141331,26701,0.763223672
2019,42,91,"Montgomery County, Pennsylvania",823823,651356,75690,1046,62636,329,11293,21473,823823,781473,42350,0.790650419
2019,42,93,"Montour County, Pennsylvania",18259,17145,328,11,632,0,14,129,18259,17755,504,0.938988992
2019,42,95,"Northampton County, Pennsylvania",302809,259055,17264,643,8497,114,6749,10487,302809,262721,40088,0.855506276
2019,42,97,"Northumberland County, Pennsylvania",91761,86804,2457,389,379,35,457,1240,91761,88569,3192,0.945979229
2019,42,99,"Perry County, Pennsylvania",46053,44605,438,107,162,11,186,544,46053,45114,939,0.968557966
2019,42,101,"Philadelphia County, Pennsylvania",1579075,642060,665333,5754,114315,784,102480,48349,1579075,1347217,231858,0.406605133
2019,42,103,"Pike County, Pennsylvania",55453,49074,3526,58,661,38,766,1330,55453,49401,6052,0.884965647
2019,42,105,"Potter County, Pennsylvania",16806,16346,67,37,59,0,44,253,16806,16577,229,0.972628823
2019,42,107,"Schuylkill County, Pennsylvania",142674,133647,4538,308,703,11,1464,2003,142674,136390,6284,0.936729888
2019,42,109,"Snyder County, Pennsylvania",40483,39022,425,30,275,0,221,510,40483,39616,867,0.963910777
2019,42,111,"Somerset County, Pennsylvania",74361,70757,1913,67,251,5,295,1073,74361,73246,1115,0.951533734
2019,42,113,"Sullivan County, Pennsylvania",6135,5866,150,7,5,2,65,40,6135,6023,112,0.956153219
2019,42,115,"Susquehanna County, Pennsylvania",40970,39944,275,13,157,16,131,434,40970,40266,704,0.974957286
2019,42,117,"Tioga County, Pennsylvania",40944,39659,297,31,231,13,153,560,40944,40426,518,0.96861567
2019,42,119,"Union County, Pennsylvania",45111,39190,2898,241,754,4,1022,1002,45111,42457,2654,0.868745982
2019,42,121,"Venango County, Pennsylvania",51818,50080,407,17,195,0,146,973,51818,51251,567,0.966459531
2019,42,123,"Warren County, Pennsylvania",39756,38843,192,45,191,0,63,422,39756,39324,432,0.977034913
2019,42,125,"Washington County, Pennsylvania",207212,193929,6498,142,1971,81,421,4170,207212,203672,3540,0.93589657
2019,42,127,"Wayne County, Pennsylvania",51422,48194,1639,121,304,9,179,976,51422,49125,2297,0.937225312
2019,42,129,"Westmoreland County, Pennsylvania",352590,333734,8330,209,3257,37,882,6141,352590,348403,4187,0.946521456
2019,42,131,"Wyoming County, Pennsylvania",27327,26534,297,36,60,0,31,369,27327,26814,513,0.970981081
2019,42,133,"York County, Pennsylvania",445565,393960,26395,938,6831,238,6188,11015,445565,412344,33221,0.884180759
